LA No.,LA Name,LAEstab (at Apr 19),School Name (at Apr 19),Eligible Pupils,Total Allocation,October/February payment,April payment
201,City of London,2013614,Sir John Casss Foundation Primary School,209,18090,10553,7537
202,Camden,2021101,Camden Primary Pupil Referral Unit,20,16200,9450,6750
202,Camden,2022019,Argyle Primary School,284,18840,10990,7850
202,Camden,2022036,Beckford Primary School,346,19460,11352,8108
202,Camden,2022065,Brecknock Primary School,312,19120,11153,7967
202,Camden,2022078,Brookfield Primary School,346,19460,11352,8108
202,Camden,2022095,Carlton Primary School,266,18660,10885,7775
202,Camden,2022184,Edith Neville Primary School,163,17630,10284,7346
202,Camden,2022219,Fleet Primary School,175,17750,10354,7396
202,Camden,2022290,Hawley Primary School,113,17130,9993,7137
202,Camden,2022436,Netley Primary School & Centre for Autism,334,19340,11282,8058
202,Camden,2022438,New End Primary School,325,19250,11229,8021
202,Camden,2022475,Primrose Hill School,351,19510,11381,8129
202,Camden,2022502,Rhyl Primary School,324,19240,11223,8017
202,Camden,2022507,Richard Cobden Primary School,331,19310,11264,8046
202,Camden,2022603,Torriano Primary School,349,19490,11369,8121
202,Camden,2022775,Gospel Oak Primary School,358,19580,11422,8158
202,Camden,2022797,Fitzjohns Primary School,175,17750,10354,7396
202,Camden,2022841,Eleanor Palmer Primary School,180,17800,10383,7417
202,Camden,2022842,Christopher Hatton Primary School,176,17760,10360,7400
202,Camden,2022843,Kingsgate Primary School,530,21300,12425,8875
202,Camden,2023323,Christ Church Primary School Hampstead,164,17640,10290,7350
202,Camden,2023327,Christ Church School,172,17720,10337,7383
202,Camden,2023340,Emmanuel Church of England Primary School,210,18100,10558,7542
202,Camden,2023352,Hampstead Parochial Church of England Primary School,199,17990,10494,7496
202,Camden,2023359,Holy Trinity CofE Primary School NW3,156,17560,10243,7317
202,Camden,2023361,Holy Trinity and Saint Silas CofE Primary School NW1,178,17780,10372,7408
202,Camden,2023370,Kentish Town Church of England Primary School,180,17800,10383,7417
202,Camden,2023391,Rosary Roman Catholic Primary School,252,18520,10803,7717
202,Camden,2023398,St Albans Church of England Primary School,161,17610,10273,7337
202,Camden,2023400,St Aloysius Catholic Primary School,275,18750,10938,7812
202,Camden,2023429,St Dominics Catholic Primary School,194,17940,10465,7475
202,Camden,2023441,St George the Martyr Church of England Primary School,172,17720,10337,7383
202,Camden,2023482,St Josephs Catholic Primary School,158,17580,10255,7325
202,Camden,2023517,St Marys Kilburn Church of England Primary School,172,17720,10337,7383
202,Camden,2023521,St Mary and St Pancras Church of England Primary School,173,17730,10343,7387
202,Camden,2023546,St Michaels Church of England Primary School,157,17570,10249,7321
202,Camden,2023560,St Patricks Catholic Primary School,169,17690,10319,7371
202,Camden,2023568,St Pauls Church of England Primary School,178,17780,10372,7408
202,Camden,2023649,St Eugene de Mazenod Roman Catholic Primary School,172,17720,10337,7383
202,Camden,2023655,Our Lady Roman Catholic Primary School,169,17690,10319,7371
202,Camden,2027008,Frank Barnes School for Deaf Children,26,16260,9485,6775
202,Camden,2027205,Swiss Cottage School - Development & Research Centre,91,16910,9864,7046
202,Camden,2025950,Childrens Hospital School at Gt Ormond Street and UCH,49,16490,9619,6871
202,Camden,2027201,Royal Free Hospital Childrens School,52,16520,9637,6883
203,Greenwich,2032028,Bannockburn Primary School,682,22820,13312,9508
203,Greenwich,2032071,Morden Mount Primary School,325,19250,11229,8021
203,Greenwich,2032106,Cherry Orchard Primary School,180,17800,10383,7417
203,Greenwich,2032174,Ealdham Primary School,344,19440,11340,8100
203,Greenwich,2032228,Fossdene Primary School,308,19080,11130,7950
203,Greenwich,2032242,Gallions Mount Primary School,328,19280,11247,8033
203,Greenwich,2032258,Gordon Primary School,351,19510,11381,8129
203,Greenwich,2032271,Haimo Primary School,263,18630,10868,7762
203,Greenwich,2032299,Henwick Primary School,337,19370,11299,8071
203,Greenwich,2032325,Invicta Primary School,452,20520,11970,8550
203,Greenwich,2032353,Kidbrooke Park Primary School,329,19290,11253,8037
203,Greenwich,2032410,Meridian Primary School,178,17780,10372,7408
203,Greenwich,2032471,Plumcroft Primary School,601,22010,12839,9171
203,Greenwich,2032552,Sherington Primary School,359,19590,11428,8162
203,Greenwich,2032598,Thorntree Primary School,175,17750,10354,7396
203,Greenwich,2032662,Wyborne Primary School,333,19330,11276,8054
203,Greenwich,2032798,Montbelle Primary School,355,19550,11404,8146
203,Greenwich,2032801,Boxgrove Primary School,347,19470,11358,8112
203,Greenwich,2032813,De Lucy Primary School,463,20630,12034,8596
203,Greenwich,2032851,Wingfield Primary School,255,18550,10821,7729
203,Greenwich,2032877,Cardwell Primary School,346,19460,11352,8108
203,Greenwich,2032900,Heronsgate Primary School,679,22790,13294,9496
203,Greenwich,2032901,Linton Mead Primary School,310,19100,11142,7958
203,Greenwich,2032915,Greenslade Primary School,176,17760,10360,7400
203,Greenwich,2032916,Mulgrave Primary School,326,19260,11235,8025
203,Greenwich,2032917,Charlton Manor Primary School,345,19450,11346,8104
203,Greenwich,2032918,Middle Park Primary School,333,19330,11276,8054
203,Greenwich,2032921,James Wolfe Primary School and Centre for the Deaf,578,21780,12705,9075
203,Greenwich,2032922,Alexander McLeod Primary School,507,21070,12291,8779
203,Greenwich,2032924,Conway Primary School,347,19470,11358,8112
203,Greenwich,2032925,Eglinton Primary School,339,19390,11311,8079
203,Greenwich,2033322,Christ Church Church of England Primary School,156,17560,10243,7317
203,Greenwich,2033331,Christ Church Church of England Primary School Shooters Hill,183,17830,10401,7429
203,Greenwich,2033338,Eltham Church of England Primary School,299,18990,11078,7912
203,Greenwich,2033382,Our Lady of Grace Catholic Primary School,212,18120,10570,7550
203,Greenwich,2033481,St Josephs Catholic Primary School,172,17720,10337,7383
203,Greenwich,2033500,St Margarets Church of England Primary School,237,18370,10716,7654
203,Greenwich,2033526,Saint Mary Magdalene Church of England All Through School,468,20680,12063,8617
203,Greenwich,2033561,St Patricks Catholic Primary School,272,18720,10920,7800
203,Greenwich,2033577,St Alfege with St Peters Church of England Primary School,177,17770,10366,7404
203,Greenwich,2033585,St Peters Catholic Primary School,181,17810,10389,7421
203,Greenwich,2033604,St Thomas More Catholic Primary School,175,17750,10354,7396
203,Greenwich,2033632,St Thomas A Becket Roman Catholic Primary School,305,19050,11113,7937
203,Greenwich,2033657,Holy Family Catholic Primary School,158,17580,10255,7325
203,Greenwich,2033662,Notre Dame Catholic Primary School,174,17740,10348,7392
203,Greenwich,2033666,St Margaret Clitherow Catholic Primary School,167,17670,10308,7362
203,Greenwich,2033668,Bishop John Robinson Church of England Primary School,173,17730,10343,7387
203,Greenwich,2033670,Discovery Primary School,503,21030,12268,8762
203,Greenwich,2035200,Hawksmoor School,538,21380,12472,8908
203,Greenwich,2037200,Waterside School,27,16270,9491,6779
204,Hackney,2041103,New Regents College,7,7000,4083,2917
204,Hackney,2042048,Berger Primary School,354,19540,11398,8142
204,Hackney,2042120,Colvestone Primary School,165,17650,10296,7354
204,Hackney,2042150,Daubeney Primary School,492,20920,12203,8717
204,Hackney,2042155,De Beauvoir Primary School,253,18530,10809,7721
204,Hackney,2042238,Gainsborough Primary School,297,18970,11066,7904
204,Hackney,2042376,Lauriston School,342,19420,11328,8092
204,Hackney,2042388,London Fields Primary School,359,19590,11428,8162
204,Hackney,2042421,Millfields Community School,529,21290,12419,8871
204,Hackney,2042431,Morningside Primary School,352,19520,11387,8133
204,Hackney,2042450,Orchard Primary School,445,20450,11929,8521
204,Hackney,2042487,Queensbridge Primary School,414,20140,11748,8392
204,Hackney,2042489,Randal Cremer Primary School,312,19120,11153,7967
204,Hackney,2042532,Princess May Primary School,314,19140,11165,7975
204,Hackney,2042533,Rushmore Primary School,355,19550,11404,8146
204,Hackney,2042534,Gayhurst Community School,443,20430,11918,8512
204,Hackney,2042539,Sebright School,332,19320,11270,8050
204,Hackney,2042545,Shacklewell Primary School,346,19460,11352,8108
204,Hackney,2042564,Southwold Primary School,317,19170,11183,7987
204,Hackney,2042592,Thomas Fairchild Community School,333,19330,11276,8054
204,Hackney,2042615,Tyssen Community Primary School,340,19400,11317,8083
204,Hackney,2042636,Shoreditch Park Primary School,322,19220,11212,8008
204,Hackney,2042654,Woodberry Down Community Primary School,461,20610,12023,8587
204,Hackney,2042779,Kingsmead Primary School,179,17790,10378,7412
204,Hackney,2042795,Sir Thomas Abney School,313,19130,11159,7971
204,Hackney,2042856,Grasmere Primary School,176,17760,10360,7400
204,Hackney,2042859,Jubilee Primary School,349,19490,11369,8121
204,Hackney,2042860,Nightingale Primary School,174,17740,10348,7392
204,Hackney,2042861,Baden-Powell School,177,17770,10366,7404
204,Hackney,2042862,Harrington Hill Primary School,321,19210,11206,8004
204,Hackney,2042863,Holmleigh Primary School,166,17660,10302,7358
204,Hackney,2042864,Grazebrook Primary School,354,19540,11398,8142
204,Hackney,2042865,Parkwood Primary School,172,17720,10337,7383
204,Hackney,2042872,Benthal Primary School,339,19390,11311,8079
204,Hackney,2042896,Mandeville Primary School,301,19010,11089,7921
204,Hackney,2042897,William Patten Primary School,358,19580,11422,8158
204,Hackney,2042898,Hoxton Garden Primary,246,18460,10768,7692
204,Hackney,2042899,Betty Layward Primary School,346,19460,11352,8108
204,Hackney,2042900,St. Dominics Catholic Primary School,337,19370,11299,8071
204,Hackney,2043000,St John and St James CofE Primary School,208,18080,10547,7533
204,Hackney,2043358,Holy Trinity Church of England Primary School,175,17750,10354,7396
204,Hackney,2043371,Our Lady and St Joseph Catholic Primary School,174,17740,10348,7392
204,Hackney,2043458,St John the Baptist Voluntary Aided Church of England Primary School,261,18610,10856,7754
204,Hackney,2043543,St Matthias Church of England Primary School,211,18110,10564,7546
204,Hackney,2043553,St Monicas Roman Catholic Primary School,164,17640,10290,7350
204,Hackney,2043572,St Pauls with St Michaels Primary School,173,17730,10343,7387
204,Hackney,2043616,St John of Jerusalem Church of England Primary School,163,17630,10284,7346
204,Hackney,2043618,St Marys Church of England Primary School Stoke Newington,170,17700,10325,7375
204,Hackney,2043659,St Scholasticas Catholic Primary School,170,17700,10325,7375
204,Hackney,2043663,Simon Marks Jewish Primary School,103,17030,9934,7096
204,Hackney,2043666,Springfield Community Primary School,167,17670,10308,7362
204,Hackney,2047161,The Garden School,63,16630,9701,6929
204,Hackney,2047171,Ickburgh School,44,16440,9590,6850
205,Hammersmith and Fulham,2052002,Addison Primary School,289,18890,11019,7871
205,Hammersmith and Fulham,2052026,Avonmore Primary School,172,17720,10337,7383
205,Hammersmith and Fulham,2052061,Brackenbury Primary School,362,19620,11445,8175
205,Hammersmith and Fulham,2052134,Miles Coverdale Primary School,182,17820,10395,7425
205,Hammersmith and Fulham,2052223,Flora Gardens Primary School,156,17560,10243,7317
205,Hammersmith and Fulham,2052350,Kenmont Primary School,165,17650,10296,7354
205,Hammersmith and Fulham,2052408,Melcombe Primary School,297,18970,11066,7904
205,Hammersmith and Fulham,2052444,Old Oak Primary School,274,18740,10932,7808
205,Hammersmith and Fulham,2052555,Sir John Lillie Primary School,252,18520,10803,7717
205,Hammersmith and Fulham,2052632,Wendell Park Primary School,318,19180,11188,7992
205,Hammersmith and Fulham,2052660,Wormholt Park Primary School,354,19540,11398,8142
205,Hammersmith and Fulham,2053300,All Saints CofE Primary School,175,17750,10354,7396
205,Hammersmith and Fulham,2053354,Holy Cross RC School,479,20790,12128,8662
205,Hammersmith and Fulham,2053368,John Betts Primary School,206,18060,10535,7525
205,Hammersmith and Fulham,2053378,St Augustines RC Primary School,180,17800,10383,7417
205,Hammersmith and Fulham,2053463,St Johns Walham Green Church of England Primary School,305,19050,11113,7937
205,Hammersmith and Fulham,2053529,St Marys Catholic Primary School,174,17740,10348,7392
205,Hammersmith and Fulham,2053566,St Pauls CofE Primary School,175,17750,10354,7396
205,Hammersmith and Fulham,2053578,St Peters Primary School,175,17750,10354,7396
205,Hammersmith and Fulham,2053600,St Stephens CofE Primary School,298,18980,11072,7908
205,Hammersmith and Fulham,2053602,Good Shepherd RC Primary School,197,17970,10483,7487
205,Hammersmith and Fulham,2053645,St John XXIII Catholic Primary School,212,18120,10570,7550
205,Hammersmith and Fulham,2053648,St Thomas of Canterbury Catholic Primary School,251,18510,10798,7712
205,Hammersmith and Fulham,2053649,Larmenier & Sacred Heart Catholic Primary School,355,19550,11404,8146
205,Hammersmith and Fulham,2053650,Normand Croft Community School for Early Years and Primary Education,135,17350,10121,7229
205,Hammersmith and Fulham,2057014,Queensmill School,108,17080,9963,7117
205,Hammersmith and Fulham,2057203,Jack Tizard School,24,16240,9473,6767
206,Islington,2061101,New River College Primary,19,16190,9444,6746
206,Islington,2061110,New River College Medical,1,1000,583,417
206,Islington,2062015,Ambler Primary School and Childrens Centre,293,18930,11043,7887
206,Islington,2062128,Copenhagen Primary School,153,17530,10226,7304
206,Islington,2062166,Drayton Park Primary School,238,18380,10722,7658
206,Islington,2062170,Duncombe Primary School,350,19500,11375,8125
206,Islington,2062251,Gillespie Primary School,176,17760,10360,7400
206,Islington,2062261,Grafton Primary School,365,19650,11463,8187
206,Islington,2062279,Hanover Primary School,261,18610,10856,7754
206,Islington,2062282,Hargrave Park Primary School,226,18260,10652,7608
206,Islington,2062379,Laycock Primary School,343,19430,11334,8096
206,Islington,2062429,Moreland Primary School,176,17760,10360,7400
206,Islington,2062455,Pakeman Primary School,250,18500,10792,7708
206,Islington,2062515,Robert Blair School,149,17490,10203,7287
206,Islington,2062596,Thornhill Primary School,338,19380,11305,8075
206,Islington,2062624,Vittoria Primary School,165,17650,10296,7354
206,Islington,2062646,Winton Primary School,177,17770,10366,7404
206,Islington,2062666,Yerbury Primary School,357,19570,11416,8154
206,Islington,2062803,Tufnell Park Primary School,260,18600,10850,7750
206,Islington,2062805,Highbury Quadrant Primary School,284,18840,10990,7850
206,Islington,2062809,Ashmount Primary School,351,19510,11381,8129
206,Islington,2062850,Prior Weston Primary School and Childrens Centre,345,19450,11346,8104
206,Islington,2062852,Montem Primary School,318,19180,11188,7992
206,Islington,2062853,Newington Green Primary School,326,19260,11235,8025
206,Islington,2062854,Canonbury Primary School,351,19510,11381,8129
206,Islington,2062855,Hugh Myddelton Primary School,349,19490,11369,8121
206,Islington,2062856,Pooles Park Primary School,285,18850,10996,7854
206,Islington,2062857,Rotherfield Primary School,324,19240,11223,8017
206,Islington,2063384,Sacred Heart Catholic Primary School,346,19460,11352,8108
206,Islington,2063456,St John Evangelist RC Primary School,229,18290,10669,7621
206,Islington,2063465,St Johns Upper Holloway CofE Primary School,163,17630,10284,7346
206,Islington,2063471,St Johns Highbury Vale CofE Primary School,179,17790,10378,7412
206,Islington,2063483,St Josephs Catholic Primary School,348,19480,11363,8117
206,Islington,2063488,St Jude and St Pauls CofE Primary School,172,17720,10337,7383
206,Islington,2063495,St Lukes CofE Primary School,180,17800,10383,7417
206,Islington,2063501,St Marks CofE Primary School,176,17760,10360,7400
206,Islington,2063527,St Marys CofE Primary School,175,17750,10354,7396
206,Islington,2063575,St Peter and St Paul RC Primary School,165,17650,10296,7354
206,Islington,2063606,St Andrews (Barnsbury) Church of England Primary School,179,17790,10378,7412
206,Islington,2063631,St Joan of Arc RC Primary School,349,19490,11369,8121
206,Islington,2063633,Christ The King RC Primary School,285,18850,10996,7854
206,Islington,2063643,Blessed Sacrament RC Primary School,166,17660,10302,7358
206,Islington,2067030,Richard Cloudesley School,25,16250,9479,6771
206,Islington,2067146,Samuel Rhodes MLD School,20,16200,9450,6750
207,Kensington and Chelsea,2072021,Ashburnham Community School,172,17720,10337,7383
207,Kensington and Chelsea,2072030,Barlby Primary School,293,18930,11043,7887
207,Kensington and Chelsea,2072050,Bevington Primary School,258,18580,10838,7742
207,Kensington and Chelsea,2072060,Bousfield Primary School,347,19470,11358,8112
207,Kensington and Chelsea,2072121,Colville Primary School,310,19100,11142,7958
207,Kensington and Chelsea,2072229,Fox Primary School,303,19030,11101,7929
207,Kensington and Chelsea,2072399,Marlborough Primary School,294,18940,11048,7892
207,Kensington and Chelsea,2072452,Oxford Gardens Primary School,311,19110,11148,7962
207,Kensington and Chelsea,2072456,Park Walk Primary School,166,17660,10302,7358
207,Kensington and Chelsea,2072538,Avondale Park Primary School,314,19140,11165,7975
207,Kensington and Chelsea,2072594,Thomas Jones Primary School,180,17800,10383,7417
207,Kensington and Chelsea,2073321,Christ Church CofE Primary School,178,17780,10372,7408
207,Kensington and Chelsea,2073356,Holy Trinity CofE Primary School,170,17700,10325,7375
207,Kensington and Chelsea,2073379,Oratory Roman Catholic Primary School,180,17800,10383,7417
207,Kensington and Chelsea,2073402,St Thomas CofE Primary School,181,17810,10389,7421
207,Kensington and Chelsea,2073417,St Barnabas and St Philips CofE Primary School,176,17760,10360,7400
207,Kensington and Chelsea,2073437,Saint Francis of Assisi Catholic Primary School,190,17900,10442,7458
207,Kensington and Chelsea,2073455,St Clement and St James CofE Primary School,158,17580,10255,7325
207,Kensington and Chelsea,2073477,St Josephs Catholic Primary School,173,17730,10343,7387
207,Kensington and Chelsea,2073504,St Mary Abbots CofE Primary School,179,17790,10378,7412
207,Kensington and Chelsea,2073541,St Cuthbert with St Matthias CofE Primary School,143,17430,10168,7262
207,Kensington and Chelsea,2073542,Saint Marys Catholic Primary School,252,18520,10803,7717
207,Kensington and Chelsea,2073613,Servite RC Primary School,178,17780,10372,7408
207,Kensington and Chelsea,2075200,Our Lady of Victories RC Primary School,179,17790,10378,7412
207,Kensington and Chelsea,2075201,St Charles Catholic Primary School,251,18510,10798,7712
207,Kensington and Chelsea,2077165,Chelsea  Community Hospital  School,39,16390,9561,6829
208,Lambeth,2082022,Ashmole Primary School,169,17690,10319,7371
208,Lambeth,2082115,Clapham Manor Primary School,356,19560,11410,8150
208,Lambeth,2082265,Granton Primary School,468,20680,12063,8617
208,Lambeth,2082292,Heathbrook Primary School,279,18790,10961,7829
208,Lambeth,2082295,Henry Cavendish Primary School,699,22990,13411,9579
208,Lambeth,2082331,Jessop Primary School,294,18940,11048,7892
208,Lambeth,2082359,Kingswood Primary School,693,22930,13376,9554
208,Lambeth,2082371,Lark Hall Primary School (Including Lark Hall Centre for Pupils with Autism),326,19260,11235,8025
208,Lambeth,2082459,Paxton Primary School,254,18540,10815,7725
208,Lambeth,2082504,Richard Atkins Primary School,282,18820,10978,7842
208,Lambeth,2082575,Sudbourne Primary School,267,18670,10891,7779
208,Lambeth,2082578,Sunnyhill Primary School,458,20580,12005,8575
208,Lambeth,2082591,Telferscot Primary School,348,19480,11363,8117
208,Lambeth,2082617,Vauxhall Primary School,167,17670,10308,7362
208,Lambeth,2082626,Walnut Tree Walk Primary School,196,17960,10477,7483
208,Lambeth,2082657,Woodmansterne School,504,21040,12273,8767
208,Lambeth,2082664,Wyvil Primary School and Centres for Children With Speech and Language Impairment and Autism,402,20020,11678,8342
208,Lambeth,2082783,Crown Lane Primary School,349,19490,11369,8121
208,Lambeth,2082785,Fenstanton Primary School,473,20730,12093,8637
208,Lambeth,2082794,Elm Wood School,310,19100,11142,7958
208,Lambeth,2082808,Allen Edwards Primary School,312,19120,11153,7967
208,Lambeth,2082836,Glenbrook Primary School,226,18260,10652,7608
208,Lambeth,2082868,Herbert Morrison Primary School,160,17600,10267,7333
208,Lambeth,2082895,Streatham Wells Primary School,180,17800,10383,7417
208,Lambeth,2082897,Bonneville Primary School,298,18980,11072,7908
208,Lambeth,2082898,Hill Mead Primary School,356,19560,11410,8150
208,Lambeth,2082900,Hitherfield Primary School,513,21130,12326,8804
208,Lambeth,2082901,Henry Fawcett Primary School,296,18960,11060,7900
208,Lambeth,2082902,Stockwell Primary School,482,20820,12145,8675
208,Lambeth,2082903,Kings Avenue School,306,19060,11118,7942
208,Lambeth,2082905,Loughborough Primary School,322,19220,11212,8008
208,Lambeth,2083000,Jubilee Primary School,314,19140,11165,7975
208,Lambeth,2083307,Archbishop Sumner Church of England Primary School,296,18960,11060,7900
208,Lambeth,2083324,Christ Church Primary SW9,143,17430,10168,7262
208,Lambeth,2083375,Macaulay Church of England Primary School,160,17600,10267,7333
208,Lambeth,2083403,St Andrews Church of England Primary School,173,17730,10343,7387
208,Lambeth,2083457,St John the Divine Church of England Primary School,139,17390,10144,7246
208,Lambeth,2083466,St Johns Angell Town Church of England Primary School,166,17660,10302,7358
208,Lambeth,2083491,St Judes Church of England Primary School,165,17650,10296,7354
208,Lambeth,2083502,St Marks Church of England Primary School,171,17710,10331,7379
208,Lambeth,2083589,St Saviours Church of England Primary School,167,17670,10308,7362
208,Lambeth,2083596,St Stephens Church of England Primary School,163,17630,10284,7346
208,Lambeth,2083621,Holy Trinity Church of England Primary School,290,18900,11025,7875
208,Lambeth,2083641,St Helens Catholic School,223,18230,10634,7596
208,Lambeth,2083642,The Orchard School,165,17650,10296,7354
208,Lambeth,2083643,Iqra Primary School,177,17770,10366,7404
208,Lambeth,2085200,St Bernadette Catholic Junior School,236,18360,10710,7650
208,Lambeth,2085201,St Annes Catholic Primary School,338,19380,11305,8075
208,Lambeth,2085203,St Bedes Catholic Infant School,114,17140,9998,7142
208,Lambeth,2085204,St Andrews Catholic Primary School,382,19820,11562,8258
208,Lambeth,2085205,Immanuel and St Andrew Church of England Primary School,335,19350,11288,8062
208,Lambeth,2085206,Reay Primary School,179,17790,10378,7412
208,Lambeth,2085208,St Marys Roman Catholic Primary School,262,18620,10862,7758
208,Lambeth,2085209,Julians School,683,22830,13318,9512
208,Lambeth,2085950,Turney Primary and Secondary Special School,58,16580,9672,6908
208,Lambeth,2087115,Elm Court School,3,3000,1750,1250
208,Lambeth,2087194,The Livity School,75,16750,9771,6979
209,Lewisham,2092000,Adamsrill Primary School,442,20420,11912,8508
209,Lewisham,2092002,St Winifreds RC Primary School,330,19300,11258,8042
209,Lewisham,2092023,Athelney Primary School,360,19600,11433,8167
209,Lewisham,2092029,Baring Primary School,175,17750,10354,7396
209,Lewisham,2092068,Beecroft Garden Primary,353,19530,11393,8137
209,Lewisham,2092127,Coopers Lane Primary School,525,21250,12396,8854
209,Lewisham,2092148,Dalmain Primary School,344,19440,11340,8100
209,Lewisham,2092158,Deptford Park Primary School,491,20910,12198,8712
209,Lewisham,2092163,Downderry Primary School,380,19800,11550,8250
209,Lewisham,2092187,Edmund Waller Primary School,365,19650,11463,8187
209,Lewisham,2092197,Elfrida Primary School,405,20050,11696,8354
209,Lewisham,2092225,Forster Park Primary School,406,20060,11702,8358
209,Lewisham,2092259,Gordonbrock Primary School,530,21300,12425,8875
209,Lewisham,2092267,Grinling Gibbons Primary School,228,18280,10663,7617
209,Lewisham,2092289,Haseltine Primary School,427,20270,11824,8446
209,Lewisham,2092304,Brindishe Green School,554,21540,12565,8975
209,Lewisham,2092307,Holbeach Primary School,384,19840,11573,8267
209,Lewisham,2092342,John Stainer Community Primary School,304,19040,11107,7933
209,Lewisham,2092347,Kelvin Grove Primary School,512,21120,12320,8800
209,Lewisham,2092349,Kender Primary School,340,19400,11317,8083
209,Lewisham,2092374,Launcelot Primary School,365,19650,11463,8187
209,Lewisham,2092381,Brindishe Manor School,353,19530,11393,8137
209,Lewisham,2092390,Lucas Vale Primary School,355,19550,11404,8146
209,Lewisham,2092403,Marvels Lane Primary School,320,19200,11200,8000
209,Lewisham,2092491,Rangefield Primary School,365,19650,11463,8187
209,Lewisham,2092493,Rathfern Primary School,411,20110,11731,8379
209,Lewisham,2092529,Rushey Green Primary School,484,20840,12157,8683
209,Lewisham,2092536,Sandhurst Primary School,553,21530,12559,8971
209,Lewisham,2092570,Stillness Junior School,331,19310,11264,8046
209,Lewisham,2092571,Stillness Infant School,178,17780,10372,7408
209,Lewisham,2092606,Torridon Infant School,548,21480,12530,8950
209,Lewisham,2092782,John Ball Primary School,475,20750,12104,8646
209,Lewisham,2092811,Fairlawn Primary School,384,19840,11573,8267
209,Lewisham,2092815,Eliot Bank Primary School,400,20000,11667,8333
209,Lewisham,2092818,Sir Francis Drake Primary School,177,17770,10366,7404
209,Lewisham,2092869,Myatt Garden Primary School,382,19820,11562,8258
209,Lewisham,2092870,Horniman Primary School,225,18250,10646,7604
209,Lewisham,2092871,Perrymount Primary School,169,17690,10319,7371
209,Lewisham,2092878,Ashmead Primary School,203,18030,10518,7512
209,Lewisham,2092887,Brindishe Lee School,206,18060,10535,7525
209,Lewisham,2092911,Kilmorie Primary School,504,21040,12273,8767
209,Lewisham,2093301,All Saints Church of England Primary School,202,18020,10512,7508
209,Lewisham,2093315,St Mary Magdalens Catholic Primary School,156,17560,10243,7317
209,Lewisham,2093344,Good Shepherd RC School,200,18000,10500,7500
209,Lewisham,2093360,Holy Trinity Church of England Primary School,156,17560,10243,7317
209,Lewisham,2093374,St Margarets Lee CofE Primary School,181,17810,10389,7421
209,Lewisham,2093416,St Augustines Catholic Primary School and Nursery,173,17730,10343,7387
209,Lewisham,2093420,St Bartholomewss Church of England Primary School,313,19130,11159,7971
209,Lewisham,2093454,St Jamess Hatcham Church of England Primary School,161,17610,10273,7337
209,Lewisham,2093472,St John Baptist Southend Church of England Primary School,179,17790,10378,7412
209,Lewisham,2093478,St Josephs Catholic Primary School,239,18390,10728,7662
209,Lewisham,2093518,St Marys Lewisham Church of England Primary School,161,17610,10273,7337
209,Lewisham,2093548,St Michaels Church of England Primary School,186,17860,10418,7442
209,Lewisham,2093588,Our Lady and St Philip Neri Roman Catholic Primary School,248,18480,10780,7700
209,Lewisham,2093594,St Saviours Catholic Primary School,172,17720,10337,7383
209,Lewisham,2093597,St Stephens Church of England Primary School,200,18000,10500,7500
209,Lewisham,2093650,St William of York Catholic Primary School,201,18010,10506,7504
209,Lewisham,2093661,Holy Cross Catholic Primary School,179,17790,10378,7412
209,Lewisham,2094323,Prendergast Ladywell School,154,17540,10232,7308
209,Lewisham,2094636,Trinity Church of England School Lewisham,228,18280,10663,7617
209,Lewisham,2095201,Prendergast Vale School,206,18060,10535,7525
209,Lewisham,2097038,Brent Knoll School,56,16560,9660,6900
209,Lewisham,2097141,New Woodlands School,12,12000,7000,5000
209,Lewisham,2097182,Watergate School,96,16960,9893,7067
209,Lewisham,2097183,Drumbeat School and ASD Service,64,16640,9707,6933
210,Southwark,2102003,Albion Primary School,292,18920,11037,7883
210,Southwark,2102038,Bellenden Primary School,203,18030,10518,7512
210,Southwark,2102085,Camelot Primary School,398,19980,11655,8325
210,Southwark,2102100,Charles Dickens Primary School,342,19420,11328,8092
210,Southwark,2102116,Cobourg Primary School,340,19400,11317,8083
210,Southwark,2102123,Comber Grove School,247,18470,10774,7696
210,Southwark,2102138,Crampton School,163,17630,10284,7346
210,Southwark,2102142,Crawford Primary School,429,20290,11836,8454
210,Southwark,2102161,Dog Kennel Hill School,352,19520,11387,8133
210,Southwark,2102257,Goodrich Community Primary School,497,20970,12233,8737
210,Southwark,2102263,Grange Primary School,318,19180,11188,7992
210,Southwark,2102293,Heber Primary School,337,19370,11299,8071
210,Southwark,2102308,Hollydale Primary School,191,17910,10448,7462
210,Southwark,2102323,Ilderton Primary School,332,19320,11270,8050
210,Southwark,2102328,Ivydale Primary School,410,20100,11725,8375
210,Southwark,2102339,John Ruskin Primary School and Language Classes,361,19610,11439,8171
210,Southwark,2102351,Keyworth Primary School,319,19190,11194,7996
210,Southwark,2102365,Dulwich Wood Primary School,246,18460,10768,7692
210,Southwark,2102392,Lyndhurst Primary School,344,19440,11340,8100
210,Southwark,2102411,Michael Faraday School,325,19250,11229,8021
210,Southwark,2102514,Riverside Primary School,253,18530,10809,7721
210,Southwark,2102516,Robert Browning Primary School,269,18690,10903,7787
210,Southwark,2102526,Rotherhithe Primary School,383,19830,11568,8262
210,Southwark,2102560,Snowsfields Primary School,169,17690,10319,7371
210,Southwark,2102562,Southwark Park Primary School,348,19480,11363,8117
210,Southwark,2102607,Tower Bridge Primary School,162,17620,10278,7342
210,Southwark,2102609,Townsend Primary School,158,17580,10255,7325
210,Southwark,2102621,Victory Primary School,137,17370,10133,7237
210,Southwark,2102848,Phoenix Primary School,457,20570,11999,8571
210,Southwark,2102852,Pilgrims Way Primary School,177,17770,10366,7404
210,Southwark,2102853,Alfred Salter Primary School,332,19320,11270,8050
210,Southwark,2102855,Oliver Goldsmith Primary School,347,19470,11358,8112
210,Southwark,2102856,Bessemer Grange Primary School,496,20960,12227,8733
210,Southwark,2102858,Brunswick Park Primary School,371,19710,11498,8212
210,Southwark,2103313,Boutcher Church of England Primary School,178,17780,10372,7408
210,Southwark,2103337,Dulwich Village Church of England Infants School,172,17720,10337,7383
210,Southwark,2103341,English Martyrs Roman Catholic Primary School,296,18960,11060,7900
210,Southwark,2103399,St James the Great Roman Catholic Primary School,169,17690,10319,7371
210,Southwark,2103435,St Francis RC Primary School,343,19430,11334,8096
210,Southwark,2103445,St Georges Church of England Primary School,126,17260,10068,7192
210,Southwark,2103447,St Georges Cathedral Catholic Primary School,221,18210,10623,7587
210,Southwark,2103452,St James Church of England Primary School,432,20320,11853,8467
210,Southwark,2103460,St Johns and St Clements Church of England Primary School,375,19750,11521,8229
210,Southwark,2103468,St Johns Walworth Church of England Primary School,162,17620,10278,7342
210,Southwark,2103475,St Josephs Roman Catholic Primary School,267,18670,10891,7779
210,Southwark,2103476,St Josephs Catholic Primary School,166,17660,10302,7358
210,Southwark,2103484,Saint Josephs Catholic Primary School the Borough,180,17800,10383,7417
210,Southwark,2103492,St Judes Church of England Primary School,89,16890,9853,7037
210,Southwark,2103508,St Mary Magdalene Church of England Primary School,189,17890,10436,7454
210,Southwark,2103516,Peter Hills with St Marys and St Pauls CofE Primary School,163,17630,10284,7346
210,Southwark,2103586,St Peters Church of England Primary School,169,17690,10319,7371
210,Southwark,2103593,The Cathedral School of St Saviour and St Mary Overy,170,17700,10325,7375
210,Southwark,2103669,St Johns Roman Catholic Primary School,174,17740,10348,7392
210,Southwark,2103670,Rye Oak Primary School,291,18910,11031,7879
210,Southwark,2105200,St Francesca Cabrini Primary School,300,19000,11083,7917
210,Southwark,2105201,St Anthonys Catholic Primary School,327,19270,11241,8029
210,Southwark,2105203,St Josephs Catholic Junior School,237,18370,10716,7654
210,Southwark,2105204,St Josephs Catholic Infants School,100,17000,9917,7083
210,Southwark,2105205,Friars Primary Foundation School,172,17720,10337,7383
210,Southwark,2105207,Charlotte Sharman Primary School,266,18660,10885,7775
210,Southwark,2107126,Haymerle School,69,16690,9736,6954
210,Southwark,2107167,Beormund Primary School,36,16360,9543,6817
210,Southwark,2107174,Tuke School,3,3000,1750,1250
210,Southwark,2107186,Cherry Garden School,44,16440,9590,6850
210,Southwark,2107066,Evelina Hospital School,29,16290,9503,6787
210,Southwark,2107073,Bethlem and Maudsley Hospital School,6,6000,3500,2500
211,Tower Hamlets,2111100,London East Alternative Provision,1,1000,583,417
211,Tower Hamlets,2112002,St Mary and St Michael Primary School,336,19360,11293,8067
211,Tower Hamlets,2112003,St Elizabeth Catholic Primary School,321,19210,11206,8004
211,Tower Hamlets,2112004,Lansbury Lawrence Primary School,356,19560,11410,8150
211,Tower Hamlets,2112005,Malmesbury Primary School,417,20170,11766,8404
211,Tower Hamlets,2112006,Our Lady and St Joseph Catholic Primary School,327,19270,11241,8029
211,Tower Hamlets,2112043,Ben Jonson Primary School,525,21250,12396,8854
211,Tower Hamlets,2112056,Bonner Primary School,649,22490,13119,9371
211,Tower Hamlets,2112059,Old Palace Primary School,355,19550,11404,8146
211,Tower Hamlets,2112091,Canon Barnett Primary School,218,18180,10605,7575
211,Tower Hamlets,2112097,Cayley Primary School,429,20290,11836,8454
211,Tower Hamlets,2112099,Blue Gate Fields Junior School,343,19430,11334,8096
211,Tower Hamlets,2112110,Chisenhale Primary School,264,18640,10873,7767
211,Tower Hamlets,2112118,Columbia Primary School,351,19510,11381,8129
211,Tower Hamlets,2112144,Cubitt Town Junior School,371,19710,11498,8212
211,Tower Hamlets,2112147,Cyril Jackson Primary School,356,19560,11410,8150
211,Tower Hamlets,2112254,Globe Primary School,284,18840,10990,7850
211,Tower Hamlets,2112270,Hague Primary School,160,17600,10267,7333
211,Tower Hamlets,2112281,Harbinger Primary School,247,18470,10774,7696
211,Tower Hamlets,2112341,John Scurr Primary School,328,19280,11247,8033
211,Tower Hamlets,2112377,Lawdale Junior School,256,18560,10827,7733
211,Tower Hamlets,2112378,Elizabeth Selby Infants School,134,17340,10115,7225
211,Tower Hamlets,2112397,Marion Richardson Primary School,355,19550,11404,8146
211,Tower Hamlets,2112402,Marner Primary School,531,21310,12431,8879
211,Tower Hamlets,2112406,Mayflower Primary School,297,18970,11066,7904
211,Tower Hamlets,2112432,Mowlem Primary School,157,17570,10249,7321
211,Tower Hamlets,2112441,Blue Gate Fields Infants School,175,17750,10354,7396
211,Tower Hamlets,2112446,Olga Primary School,206,18060,10535,7525
211,Tower Hamlets,2112499,Redlands Primary School,354,19540,11398,8142
211,Tower Hamlets,2112533,Manorfield Primary School,528,21280,12413,8867
211,Tower Hamlets,2112569,Stewart Headlam Primary School,295,18950,11054,7896
211,Tower Hamlets,2112623,Virginia Primary School,175,17750,10354,7396
211,Tower Hamlets,2112631,Wellington Primary School,357,19570,11416,8154
211,Tower Hamlets,2112658,Woolmore Primary School,355,19550,11404,8146
211,Tower Hamlets,2112828,Thomas Buxton Primary School,328,19280,11247,8033
211,Tower Hamlets,2112857,Seven Mills Primary School,178,17780,10372,7408
211,Tower Hamlets,2112893,Cubitt Town Infants School,179,17790,10378,7412
211,Tower Hamlets,2112908,Osmani Primary School,323,19230,11218,8012
211,Tower Hamlets,2112909,Shapla Primary School,154,17540,10232,7308
211,Tower Hamlets,2112910,Hermitage Primary School,231,18310,10681,7629
211,Tower Hamlets,2112912,Bangabandhu Primary School,348,19480,11363,8117
211,Tower Hamlets,2112916,Halley Primary School,171,17710,10331,7379
211,Tower Hamlets,2112917,Bigland Green Primary School,348,19480,11363,8117
211,Tower Hamlets,2112918,Kobi Nazrul Primary School,164,17640,10290,7350
211,Tower Hamlets,2112919,Smithy Street School,338,19380,11305,8075
211,Tower Hamlets,2112921,William Davis Primary School,140,17400,10150,7250
211,Tower Hamlets,2112922,Arnhem Wharf Primary School,528,21280,12413,8867
211,Tower Hamlets,2112999,Harry Gosling Primary School,327,19270,11241,8029
211,Tower Hamlets,2113332,Christ Church CofE School,132,17320,10103,7217
211,Tower Hamlets,2113346,Guardian Angels Catholic Primary School,170,17700,10325,7375
211,Tower Hamlets,2113350,Stepney Greencoat Church of England Primary School,161,17610,10273,7337
211,Tower Hamlets,2113397,St Agnes RC Primary School,170,17700,10325,7375
211,Tower Hamlets,2113411,St Annes Catholic Primary School,217,18170,10599,7571
211,Tower Hamlets,2113431,St Edmunds Catholic School,162,17620,10278,7342
211,Tower Hamlets,2113462,St Johns Church of England Primary School,159,17590,10261,7329
211,Tower Hamlets,2113497,St Lukes Church of England Primary School,306,19060,11118,7942
211,Tower Hamlets,2113540,St Matthias Church of England Primary School,145,17450,10179,7271
211,Tower Hamlets,2113563,St Paul with St Luke CofE Primary School,158,17580,10255,7325
211,Tower Hamlets,2113574,St Pauls Whitechapel Church of England Primary School,171,17710,10331,7379
211,Tower Hamlets,2113581,St Peters London Docks CofE Primary School,162,17620,10278,7342
211,Tower Hamlets,2113592,St Saviours Church of England Primary School,178,17780,10372,7408
211,Tower Hamlets,2113619,English Martyrs Roman Catholic Primary School,163,17630,10284,7346
211,Tower Hamlets,2117084,Bowden House School,1,1000,583,417
211,Tower Hamlets,2117095,Phoenix School,138,17380,10138,7242
211,Tower Hamlets,2117169,Stephen Hawking School,78,16780,9788,6992
211,Tower Hamlets,2117170,The Cherry Trees School,21,16210,9456,6754
212,Wandsworth,2121102,Victoria Drive Primary Pupil Referral Unit,3,3000,1750,1250
212,Wandsworth,2122004,Alderbrook Primary School,277,18770,10949,7821
212,Wandsworth,2122005,Gatton (VA) Primary School,417,20170,11766,8404
212,Wandsworth,2122010,Allfarthing Primary School,304,19040,11107,7933
212,Wandsworth,2122034,Beatrix Potter Primary School,322,19220,11212,8008
212,Wandsworth,2122064,Brandlehow Primary School,283,18830,10984,7846
212,Wandsworth,2122067,Broadwater Primary School,291,18910,11031,7879
212,Wandsworth,2122180,Earlsfield Primary School,360,19600,11433,8167
212,Wandsworth,2122211,Falconbrook Primary School,215,18150,10588,7562
212,Wandsworth,2122217,Fircroft Primary School,303,19030,11101,7929
212,Wandsworth,2122237,Furzedown Primary School,342,19420,11328,8092
212,Wandsworth,2122314,Hotham Primary School,323,19230,11218,8012
212,Wandsworth,2122334,John Burns Primary School,164,17640,10290,7350
212,Wandsworth,2122467,Penwortham Primary School,514,21140,12332,8808
212,Wandsworth,2122495,Ravenstone Primary School,304,19040,11107,7933
212,Wandsworth,2122511,Riversdale Primary School,269,18690,10903,7787
212,Wandsworth,2122541,Sellincourt Primary School,299,18990,11078,7912
212,Wandsworth,2122545,Shaftesbury Park Primary School,275,18750,10938,7812
212,Wandsworth,2122558,Smallwood Primary School and Language Unit,305,19050,11113,7937
212,Wandsworth,2122584,Swaffield Primary School,347,19470,11358,8112
212,Wandsworth,2122633,West Hill Primary School,256,18560,10827,7733
212,Wandsworth,2122774,Sheringdale Primary School,262,18620,10862,7758
212,Wandsworth,2122780,Southmead Primary School,326,19260,11235,8025
212,Wandsworth,2122781,Granard Primary School,386,19860,11585,8275
212,Wandsworth,2122786,Heathmere Primary School,240,18400,10733,7667
212,Wandsworth,2122807,Ronald Ross Primary School,176,17760,10360,7400
212,Wandsworth,2123304,All Saints CofE Primary School Putney,175,17750,10354,7396
212,Wandsworth,2123320,Christ Church CofE Primary School,145,17450,10179,7271
212,Wandsworth,2123376,Holy Ghost Catholic Primary School,178,17780,10372,7408
212,Wandsworth,2123387,Our Lady of Victories Catholic Primary School,179,17790,10378,7412
212,Wandsworth,2123390,Roehampton CofE Primary School,167,17670,10308,7362
212,Wandsworth,2123408,St Annes CofE Primary School,132,17320,10103,7217
212,Wandsworth,2123422,St Boniface RC Primary School,278,18780,10955,7825
212,Wandsworth,2123434,St Faiths CofE Primary School,146,17460,10185,7275
212,Wandsworth,2123444,St Georges CofE Primary School,178,17780,10372,7408
212,Wandsworth,2123486,St Josephs RC Primary School,174,17740,10348,7392
212,Wandsworth,2123524,St Marys CofE Primary School,179,17790,10378,7412
212,Wandsworth,2123525,Trinity St Marys CofE Primary School,106,17060,9952,7108
212,Wandsworth,2123528,St Marys RC Voluntary Aided Primary School,153,17530,10226,7304
212,Wandsworth,2123550,St Michaels CofE Primary School,346,19460,11352,8108
212,Wandsworth,2123629,Sacred Heart Catholic Primary School Roehampton,347,19470,11358,8112
212,Wandsworth,2123636,Our Lady Queen of Heaven RC School,181,17810,10389,7421
212,Wandsworth,2123644,St Anselms Catholic Primary School,179,17790,10378,7412
212,Wandsworth,2123645,Sacred Heart Catholic Primary School Battersea,339,19390,11311,8079
212,Wandsworth,2125201,Hillbrook School,544,21440,12507,8933
212,Wandsworth,2125203,Honeywell Infant School,180,17800,10383,7417
212,Wandsworth,2125204,Honeywell Junior School,360,19600,11433,8167
212,Wandsworth,2125205,Albemarle Primary School,250,18500,10792,7708
212,Wandsworth,2127068,Oak Lodge School,1,1000,583,417
212,Wandsworth,2127077,Bradstow School,8,8000,4667,3333
212,Wandsworth,2127123,Greenmead School,50,16500,9625,6875
212,Wandsworth,2127183,Paddock School,95,16950,9888,7062
213,Westminster,2132032,Barrow Hill Junior School,223,18230,10634,7596
213,Westminster,2132189,Edward Wilson Primary School,299,18990,11078,7912
213,Westminster,2132208,Essendine Primary School,333,19330,11276,8054
213,Westminster,2132778,George Eliot Primary School,341,19410,11323,8087
213,Westminster,2132799,Hallfield Primary School,327,19270,11241,8029
213,Westminster,2132816,Robinsfield Infant School,107,17070,9958,7112
213,Westminster,2132844,Queens Park Primary School,248,18480,10780,7700
213,Westminster,2133306,All Souls CofE Primary School,149,17490,10203,7287
213,Westminster,2133316,Burdett-Coutts and Townshend Foundation CofE Primary School,204,18040,10523,7517
213,Westminster,2133351,Hampden Gurney CofE Primary School,174,17740,10348,7392
213,Westminster,2133381,Our Lady of Dolours RC Primary School,189,17890,10436,7454
213,Westminster,2133414,St Augustines CofE Primary School,174,17740,10348,7392
213,Westminster,2133418,St Barnabas CofE Primary School,103,17030,9934,7096
213,Westminster,2133424,St Clement Danes CofE Primary School,169,17690,10319,7371
213,Westminster,2133432,St Edwards Catholic Primary School,270,18700,10908,7792
213,Westminster,2133440,St Gabriels CofE Primary School,170,17700,10325,7375
213,Westminster,2133446,St Georges Hanover Square CofE Primary School,164,17640,10290,7350
213,Westminster,2133451,Soho Parish CofE Primary School,151,17510,10214,7296
213,Westminster,2133453,St James & St John Church of England Primary School,132,17320,10103,7217
213,Westminster,2133473,St Josephs RC Primary School,214,18140,10582,7558
213,Westminster,2133496,St Lukes CofE Primary School,173,17730,10343,7387
213,Westminster,2133511,St Mary Magdalene CofE Primary School,172,17720,10337,7383
213,Westminster,2133520,St Marys Bryanston Square CofE School,160,17600,10267,7333
213,Westminster,2133532,St. Mary of the Angels Catholic Primary School,225,18250,10646,7604
213,Westminster,2133539,St Matthews School Westminster,161,17610,10273,7337
213,Westminster,2133580,St Peters CofE School,174,17740,10348,7392
213,Westminster,2133582,St Peters Eaton Square CofE Primary School,248,18480,10780,7700
213,Westminster,2133590,St Saviours CofE Primary School,168,17680,10313,7367
213,Westminster,2133598,St Stephens CofE Primary School,146,17460,10185,7275
213,Westminster,2133610,St Vincents Catholic Primary School,176,17760,10360,7400
213,Westminster,2133611,St Vincent de Paul RC Primary School,165,17650,10296,7354
213,Westminster,2133623,Westminster Cathedral RC Primary School,172,17720,10337,7383
213,Westminster,2133653,Christ Church Bentinck CofE Primary School,157,17570,10249,7321
213,Westminster,2137042,College Park School,47,16470,9608,6862
213,Westminster,2137184,Queen Elizabeth II Jubilee School,42,16420,9578,6842
301,Barking and Dagenham,3012005,Dorothy Barley Infants School,221,18210,10623,7587
301,Barking and Dagenham,3012009,Manor Junior School,541,21410,12489,8921
301,Barking and Dagenham,3012010,Manor Infants School/Manor Longbridge,840,24400,14233,10167
301,Barking and Dagenham,3012013,Northbury Primary School,703,23030,13434,9596
301,Barking and Dagenham,3012015,Ripple Primary School,861,24610,14356,10254
301,Barking and Dagenham,3012024,Beam Primary School,503,21030,12268,8762
301,Barking and Dagenham,3012030,Furze Infants School,278,18780,10955,7825
301,Barking and Dagenham,3012033,Grafton Primary School,708,23080,13463,9617
301,Barking and Dagenham,3012042,Marks Gate Infants School,175,17750,10354,7396
301,Barking and Dagenham,3012043,Marsh Green Primary School,318,19180,11188,7992
301,Barking and Dagenham,3012047,Rush Green Primary School,649,22490,13119,9371
301,Barking and Dagenham,3012052,The Leys Primary School,321,19210,11206,8004
301,Barking and Dagenham,3012055,Warren Junior School,471,20710,12081,8629
301,Barking and Dagenham,3012056,Thomas Arnold Primary School,360,19600,11433,8167
301,Barking and Dagenham,3012059,Valence Primary School,942,25420,14828,10592
301,Barking and Dagenham,3012060,Village Infants School,175,17750,10354,7396
301,Barking and Dagenham,3012061,Marks Gate Junior School,338,19380,11305,8075
301,Barking and Dagenham,3012063,William Bellamy Primary School,867,24670,14391,10279
301,Barking and Dagenham,3012064,Parsloes Primary School,489,20890,12186,8704
301,Barking and Dagenham,3012065,Five Elms Primary School,398,19980,11655,8325
301,Barking and Dagenham,3012066,Henry Green Primary School,358,19580,11422,8158
301,Barking and Dagenham,3012067,Roding Primary School,980,25800,15050,10750
301,Barking and Dagenham,3012068,Becontree Primary School,389,19890,11603,8287
301,Barking and Dagenham,3012069,John Perry Primary School,497,20970,12233,8737
301,Barking and Dagenham,3012070,Richard Alibon Primary School with ARP for Cognitive and Learning Difficulties : SEN Base,542,21420,12495,8925
301,Barking and Dagenham,3012071,Monteagle Primary School,622,22220,12962,9258
301,Barking and Dagenham,3012072,Godwin Primary School,503,21030,12268,8762
301,Barking and Dagenham,3012073,Hunters Hall Primary School,517,21170,12349,8821
301,Barking and Dagenham,3012074,Southwood Primary School,520,21200,12367,8833
301,Barking and Dagenham,3012075,Gascoigne Primary School,976,25760,15027,10733
301,Barking and Dagenham,3013301,William Ford CofE Junior School,358,19580,11422,8158
301,Barking and Dagenham,3013500,St Josephs Catholic Primary School,286,18860,11002,7858
301,Barking and Dagenham,3013502,St Josephs Catholic Primary School,322,19220,11212,8008
301,Barking and Dagenham,3013503,St Peters Catholic Primary School,336,19360,11293,8067
301,Barking and Dagenham,3013505,The St Teresa Catholic Primary School,166,17660,10302,7358
301,Barking and Dagenham,3013506,St Vincents Catholic Primary School,180,17800,10383,7417
301,Barking and Dagenham,3013507,George Carey Church of England Primary School,543,21430,12501,8929
301,Barking and Dagenham,3014023,Eastbrook School,61,16610,9689,6921
301,Barking and Dagenham,3014024,Eastbury Community School,114,17140,9998,7142
301,Barking and Dagenham,3017005,Trinity School,98,16980,9905,7075
302,Barnet,3021100,Pavilion Study Centre,3,3000,1750,1250
302,Barnet,3022002,Barnfield Primary School,388,19880,11597,8283
302,Barnet,3022003,Bell Lane Primary School,333,19330,11276,8054
302,Barnet,3022007,Brookland Junior School,355,19550,11404,8146
302,Barnet,3022008,Brookland Infant and Nursery School,179,17790,10378,7412
302,Barnet,3022009,Brunswick Park Primary and Nursery School,356,19560,11410,8150
302,Barnet,3022010,Childs Hill School,281,18810,10973,7837
302,Barnet,3022011,Church Hill School,202,18020,10512,7508
302,Barnet,3022014,Colindale Primary School,568,21680,12647,9033
302,Barnet,3022015,Coppetts Wood Primary School,206,18060,10535,7525
302,Barnet,3022016,Courtland School,181,17810,10389,7421
302,Barnet,3022017,Cromer Road Primary School,350,19500,11375,8125
302,Barnet,3022019,Deansbrook Infant School,178,17780,10372,7408
302,Barnet,3022021,Dollis Infant School,161,17610,10273,7337
302,Barnet,3022023,Edgware Primary School,515,21150,12338,8812
302,Barnet,3022024,Fairway Primary School and Childrens Centre,208,18080,10547,7533
302,Barnet,3022025,Foulds School,271,18710,10914,7796
302,Barnet,3022026,Frith Manor Primary School,502,21020,12262,8758
302,Barnet,3022027,Garden Suburb Junior School,350,19500,11375,8125
302,Barnet,3022028,Garden Suburb Infant School,178,17780,10372,7408
302,Barnet,3022029,Goldbeaters Primary School,363,19630,11451,8179
302,Barnet,3022031,Hollickwood Primary School,169,17690,10319,7371
302,Barnet,3022032,Holly Park Primary School,391,19910,11614,8296
302,Barnet,3022036,Livingstone Primary and Nursery School,239,18390,10728,7662
302,Barnet,3022037,Manorside Primary School,268,18680,10897,7783
302,Barnet,3022042,Monkfrith Primary School,267,18670,10891,7779
302,Barnet,3022043,Moss Hall Junior School,443,20430,11918,8512
302,Barnet,3022044,Moss Hall Infant School,238,18380,10722,7658
302,Barnet,3022045,Northside Primary School,210,18100,10558,7542
302,Barnet,3022054,Woodridge Primary School,206,18060,10535,7525
302,Barnet,3022055,Tudor Primary School,198,17980,10488,7492
302,Barnet,3022057,Underhill School,467,20670,12058,8612
302,Barnet,3022060,Whitings Hill Primary School,358,19580,11422,8158
302,Barnet,3022067,Chalgrove Primary School,222,18220,10628,7592
302,Barnet,3022070,Sunnyfields Primary School,180,17800,10383,7417
302,Barnet,3022071,Queenswell Infant & Nursery School,173,17730,10343,7387
302,Barnet,3022072,Queenswell Junior School,344,19440,11340,8100
302,Barnet,3022073,Danegrove Primary School,563,21630,12618,9012
302,Barnet,3022076,Wessex Gardens Primary School,352,19520,11387,8133
302,Barnet,3022077,The Orion Primary School,690,22900,13358,9542
302,Barnet,3022078,Pardes House Primary School,269,18690,10903,7787
302,Barnet,3022079,Beis Yaakov Primary School,390,19900,11608,8292
302,Barnet,3023300,All Saints CofE Primary School NW2,172,17720,10337,7383
302,Barnet,3023302,Christ Church Primary School,179,17790,10378,7412
302,Barnet,3023304,Holy Trinity CofE Primary School,205,18050,10529,7521
302,Barnet,3023305,Monken Hadley CofE Primary School,123,17230,10051,7179
302,Barnet,3023307,St Johns CofE Junior Mixed and Infant School,181,17810,10389,7421
302,Barnet,3023309,St Johns CofE Primary School,179,17790,10378,7412
302,Barnet,3023311,St Marys CofE Primary School,359,19590,11428,8162
302,Barnet,3023312,St Marys CofE Primary School East Barnet,181,17810,10389,7421
302,Barnet,3023313,St Pauls CofE Primary School N11,171,17710,10331,7379
302,Barnet,3023314,St Pauls CofE Primary School NW7,182,17820,10395,7425
302,Barnet,3023315,St Andrews CofE Voluntary Aided Primary School Totteridge,175,17750,10354,7396
302,Barnet,3023316,Trent CofE Primary School,178,17780,10372,7408
302,Barnet,3023317,All Saints CofE Primary School N20,209,18090,10553,7537
302,Barnet,3023500,The Annunciation Catholic Infant School,109,17090,9969,7121
302,Barnet,3023501,Our Lady of Lourdes RC School,179,17790,10378,7412
302,Barnet,3023502,St Agnes RC School,273,18730,10926,7804
302,Barnet,3023504,St Catherines RC School,389,19890,11603,8287
302,Barnet,3023506,St Vincents Catholic Primary School,276,18760,10943,7817
302,Barnet,3023507,St Theresas Catholic Primary School,205,18050,10529,7521
302,Barnet,3023509,St Josephs Catholic Primary School,424,20240,11807,8433
302,Barnet,3023510,Sacred Heart Roman Catholic Primary School,362,19620,11445,8175
302,Barnet,3023511,Blessed Dominic Catholic Primary School,340,19400,11317,8083
302,Barnet,3023512,Rosh Pinah Primary School,357,19570,11416,8154
302,Barnet,3023513,Menorah Primary School,329,19290,11253,8037
302,Barnet,3023514,The Annunciation RC Junior School,219,18190,10611,7579
302,Barnet,3023516,Hasmonean Primary School,180,17800,10383,7417
302,Barnet,3023518,Woodcroft Primary School,356,19560,11410,8150
302,Barnet,3023520,Akiva School,360,19600,11433,8167
302,Barnet,3023521,St Marys and St Johns CofE School,503,21030,12268,8762
302,Barnet,3023523,Martin Primary School,535,21350,12454,8896
302,Barnet,3023524,Beit Shvidler Primary School,169,17690,10319,7371
302,Barnet,3025200,Dollis Junior School,335,19350,11288,8062
302,Barnet,3025201,Osidge Primary School,343,19430,11334,8096
302,Barnet,3025948,Mathilda Marks-Kennedy Jewish Primary School,172,17720,10337,7383
302,Barnet,3025949,Menorah Foundation School,296,18960,11060,7900
302,Barnet,3027005,Northway School,91,16910,9864,7046
302,Barnet,3027009,Oakleigh School & Acorn Assessment Centre,69,16690,9736,6954
302,Barnet,3022053,Noam Primary School,122,11480,6697,4783
303,Bexley,3032001,Crook Log Primary School,347,19470,11358,8112
303,Bexley,3032002,Danson Primary School,502,21020,12262,8758
303,Bexley,3032008,Hook Lane Primary School,354,19540,11398,8142
303,Bexley,3032016,Upton Primary School,377,19770,11533,8237
303,Bexley,3032019,Orchard Primary School,179,17790,10378,7412
303,Bexley,3032042,Birkbeck Primary School,354,19540,11398,8142
303,Bexley,3032049,Longlands Primary School,263,18630,10868,7762
303,Bexley,3032056,Dulverton Primary School,354,19540,11398,8142
303,Bexley,3032059,Parkway Primary School,192,17920,10453,7467
303,Bexley,3032060,Belvedere Infant School,166,17660,10302,7358
303,Bexley,3033001,Fosters Primary School,356,19560,11410,8150
303,Bexley,3033500,St Stephens Catholic Primary School,360,19600,11433,8167
303,Bexley,3033501,Our Lady of the Rosary Catholic Primary School,358,19580,11422,8158
303,Bexley,3033502,St Josephs Catholic Primary School,176,17760,10360,7400
303,Bexley,3033503,St Fidelis Catholic Primary School,370,19700,11492,8208
303,Bexley,3033504,St Thomas More Catholic Primary School,360,19600,11433,8167
303,Bexley,3033505,St John Fisher Catholic Primary School,179,17790,10378,7412
303,Bexley,3033506,St Peter Chanel Catholic Primary School,166,17660,10302,7358
303,Bexley,3033510,Bishop Ridley Church of England VA Primary School,360,19600,11433,8167
304,Brent,3041105,Brent River College,7,7000,4083,2917
304,Brent,3042000,Anson Primary School,302,19020,11095,7925
304,Brent,3042003,Brentfield Primary School,503,21030,12268,8762
304,Brent,3042006,Byron Court Primary School,630,22300,13008,9292
304,Brent,3042007,Carlton Vale Infant School,78,16780,9788,6992
304,Brent,3042017,Harlesden Primary School,310,19100,11142,7958
304,Brent,3042018,Mount Stewart Junior School,383,19830,11568,8262
304,Brent,3042019,Mount Stewart Infant School,176,17760,10360,7400
304,Brent,3042020,Uxendon Manor Primary School,472,20720,12087,8633
304,Brent,3042024,Kingsbury Green Primary School,531,21310,12431,8879
304,Brent,3042028,Leopold Primary School,665,22650,13213,9437
304,Brent,3042031,Lyon Park Primary School,706,23060,13452,9608
304,Brent,3042033,Malorees Infant School,141,17410,10156,7254
304,Brent,3042034,Northview Junior and Infant School,177,17770,10366,7404
304,Brent,3042038,Park Lane Primary School,346,19460,11352,8108
304,Brent,3042039,Preston Park Primary School,646,22460,13102,9358
304,Brent,3042041,Roe Green Junior School,477,20770,12116,8654
304,Brent,3042042,Roe Green Infant School,354,19540,11398,8142
304,Brent,3042049,Barham Primary School,720,23200,13533,9667
304,Brent,3042053,Wykeham Primary School,418,20180,11772,8408
304,Brent,3042055,Elsley Primary School,453,20530,11976,8554
304,Brent,3042056,Donnington Primary School,171,17710,10331,7379
304,Brent,3042057,The Stonebridge School,476,20760,12110,8650
304,Brent,3042064,Newfield Primary School,294,18940,11048,7892
304,Brent,3042066,Mitchell Brook Primary School,520,21200,12367,8833
304,Brent,3042068,Chalkhill Primary School,412,20120,11737,8383
304,Brent,3042070,Salusbury Primary School,518,21180,12355,8825
304,Brent,3042071,Oliver Goldsmith Primary School,352,19520,11387,8133
304,Brent,3042073,Mora Primary School,350,19500,11375,8125
304,Brent,3042074,Fryent Primary School,608,22080,12880,9200
304,Brent,3043301,Christ Church CofE Primary School,164,17640,10290,7350
304,Brent,3043302,John Keble CofE Primary School,330,19300,11258,8042
304,Brent,3043303,Princess Frederica CofE Primary School,344,19440,11340,8100
304,Brent,3043308,St Marys CofE Primary School,226,18260,10652,7608
304,Brent,3043500,Our Lady of Grace Catholic Junior School,236,18360,10710,7650
304,Brent,3043501,St Joseph RC Junior School,276,18760,10943,7817
304,Brent,3043505,St Mary Magdalens Catholic Junior School,350,19500,11375,8125
304,Brent,3043506,St Robert Southwell RC Primary School,344,19440,11340,8100
304,Brent,3043507,Convent of Jesus and Mary RC Infant School,175,17750,10354,7396
304,Brent,3043508,Our Lady of Lourdes RC Primary School,168,17680,10313,7367
304,Brent,3043509,St Josephs RC Infant School,139,17390,10144,7246
304,Brent,3043510,Our Lady of Grace RC Infant and Nursery School,118,17180,10022,7158
304,Brent,3043511,St Margaret Clitherow RC Primary School,175,17750,10354,7396
304,Brent,3043601,Sinai Jewish Primary School,519,21190,12361,8829
304,Brent,3043602,St Marys RC Primary School,237,18370,10716,7654
304,Brent,3043603,Avigdor Hirsch Torah Temimah Primary School,162,17620,10278,7342
304,Brent,3043605,Wembley Primary School,715,23150,13504,9646
304,Brent,3045202,Malorees Junior School,230,18300,10675,7625
304,Brent,3045203,St Josephs Roman Catholic Primary School,406,20060,11702,8358
304,Brent,3045204,The Kilburn Park School Foundation,187,17870,10424,7446
304,Brent,3045949,Islamia Primary School,360,19600,11433,8167
304,Brent,3047005,Phoenix Arch School,43,16430,9584,6846
305,Bromley,3052022,Southborough Primary School,359,19590,11428,8162
305,Bromley,3052041,Downe Primary School,66,16660,9718,6942
305,Bromley,3052069,Edgebury Primary School,215,18150,10588,7562
305,Bromley,3052080,Poverest Primary School,286,18860,11002,7858
305,Bromley,3052082,Bickley Primary School,356,19560,11410,8150
305,Bromley,3057005,Marjorie McClure School,28,16280,9497,6783
305,Bromley,3057012,Riverside School,129,17290,10086,7204
306,Croydon,3061100,Saffron Valley Collegiate,5,5000,2917,2083
306,Croydon,3062003,Beulah Junior School,336,19360,11293,8067
306,Croydon,3062012,Elmwood Junior School,476,20760,12110,8650
306,Croydon,3062014,Elmwood Infant School,234,18340,10698,7642
306,Croydon,3062020,Howard Primary School,315,19150,11171,7979
306,Croydon,3062033,Purley Oaks Primary School,509,21090,12303,8787
306,Croydon,3062050,Winterbourne Junior Girls School,304,19040,11107,7933
306,Croydon,3062051,Winterbourne Nursery and Infants School,259,18590,10844,7746
306,Croydon,3062058,Kenley Primary School,190,17900,10442,7458
306,Croydon,3062062,Beaumont Primary School,183,17830,10401,7429
306,Croydon,3062065,Gresham Primary School,218,18180,10605,7575
306,Croydon,3062067,Smitham Primary School,351,19510,11381,8129
306,Croydon,3062068,The Hayes Primary School,351,19510,11381,8129
306,Croydon,3062083,Orchard Way Primary School,178,17780,10372,7408
306,Croydon,3062084,Forestdale Primary School,315,19150,11171,7979
306,Croydon,3062090,Heavers Farm Primary School,602,22020,12845,9175
306,Croydon,3062093,Downsview Primary and Nursery School,495,20950,12221,8729
306,Croydon,3062094,Park Hill Infant School,179,17790,10378,7412
306,Croydon,3062098,Greenvale Primary School,186,17860,10418,7442
306,Croydon,3062102,Rockmount Primary School,385,19850,11579,8271
306,Croydon,3062105,Norbury Manor Primary School,362,19620,11445,8175
306,Croydon,3062107,Ridgeway Primary School,536,21360,12460,8900
306,Croydon,3063000,All Saints CofE Primary School,290,18900,11025,7875
306,Croydon,3063003,St Johns CofE Primary School,216,18160,10593,7567
306,Croydon,3063006,The Minster Junior School,411,20110,11731,8379
306,Croydon,3063007,The Minster Nursery and Infant School,217,18170,10599,7571
306,Croydon,3063300,Coulsdon CofE Primary School,179,17790,10378,7412
306,Croydon,3063301,Christ Church CofE Primary School (Purley),329,19290,11253,8037
306,Croydon,3063401,St Josephs RC Junior School,219,18190,10611,7579
306,Croydon,3063404,Margaret Roper Catholic Primary School,212,18120,10570,7550
306,Croydon,3063408,Regina Coeli Catholic Primary School,360,19600,11433,8167
306,Croydon,3063412,St Josephs RC Infant School,112,17120,9987,7133
306,Croydon,3063418,Woodcote Primary School,571,21710,12664,9046
306,Croydon,3065200,Selsdon Primary and Nursery School,467,20670,12058,8612
306,Croydon,3067001,St Giles School,62,16620,9695,6925
306,Croydon,3067005,St Nicholas School,122,17220,10045,7175
306,Croydon,3067006,Red Gates School,116,17160,10010,7150
307,Ealing,3071104,Ealing Primary Centre,6,6000,3500,2500
307,Ealing,3072000,Holy Family Catholic Primary School,327,19270,11241,8029
307,Ealing,3072005,Berrymede Junior School,374,19740,11515,8225
307,Ealing,3072006,Berrymede Infant School,141,17410,10156,7254
307,Ealing,3072022,East Acton Primary School,249,18490,10786,7704
307,Ealing,3072033,Oldfield Primary School,339,19390,11311,8079
307,Ealing,3072046,North Ealing Primary School,536,21360,12460,8900
307,Ealing,3072058,St Johns Primary School,347,19470,11358,8112
307,Ealing,3072059,St Marks Primary School,378,19780,11538,8242
307,Ealing,3072067,West Twyford Primary School,306,19060,11118,7942
307,Ealing,3072071,West Acton Primary School,535,21350,12454,8896
307,Ealing,3072076,Mayfield Primary School,302,19020,11095,7925
307,Ealing,3072083,Beaconsfield Primary and Nursery School,234,18340,10698,7642
307,Ealing,3072088,Coston Primary School,328,19280,11247,8033
307,Ealing,3072092,Downe Manor Primary School,347,19470,11358,8112
307,Ealing,3072094,Drayton Green Primary School,291,18910,11031,7879
307,Ealing,3072115,North Primary School,355,19550,11404,8146
307,Ealing,3072121,Ravenor Primary School,530,21300,12425,8875
307,Ealing,3072125,Selborne Primary School,475,20750,12104,8646
307,Ealing,3072150,Hambrough Primary School,352,19520,11387,8133
307,Ealing,3072151,Hobbayne Primary School,537,21370,12466,8904
307,Ealing,3072153,John Perryn Primary School,350,19500,11375,8125
307,Ealing,3072154,Southfield Primary School,378,19780,11538,8242
307,Ealing,3072161,Allenby Primary School,192,17920,10453,7467
307,Ealing,3072162,Blair Peach Primary School,355,19550,11404,8146
307,Ealing,3072163,Clifton Primary School,365,19650,11463,8187
307,Ealing,3072164,Dairy Meadow Primary School,348,19480,11363,8117
307,Ealing,3072165,Derwentwater Primary School,512,21120,12320,8800
307,Ealing,3072166,Durdans Park Primary School,353,19530,11393,8137
307,Ealing,3072167,Fielding Primary School,717,23170,13516,9654
307,Ealing,3072168,Gifford Primary School,711,23110,13481,9629
307,Ealing,3072169,Greenwood Primary School,482,20820,12145,8675
307,Ealing,3072170,Havelock Primary School and Nursery,325,19250,11229,8021
307,Ealing,3072171,Horsenden Primary School,707,23070,13458,9612
307,Ealing,3072172,Willow Tree Primary School,535,21350,12454,8896
307,Ealing,3072173,Lady Margaret Primary School,517,21170,12349,8821
307,Ealing,3072174,Little Ealing Primary School,523,21230,12384,8846
307,Ealing,3072175,Oaklands Primary School,411,20110,11731,8379
307,Ealing,3072176,Perivale Primary School,352,19520,11387,8133
307,Ealing,3072177,Stanhope Primary School,422,20220,11795,8425
307,Ealing,3072178,Viking Primary School,177,17770,10366,7404
307,Ealing,3072179,Wolf Fields Primary School,311,19110,11148,7962
307,Ealing,3072180,Featherstone Primary and Nursery School,529,21290,12419,8871
307,Ealing,3072181,Three Bridges Primary School,346,19460,11352,8108
307,Ealing,3072182,Montpelier Primary School,532,21320,12437,8883
307,Ealing,3072183,Tudor Primary School,342,19420,11328,8092
307,Ealing,3072186,Vicars Green Primary School,329,19290,11253,8037
307,Ealing,3072187,Grange Primary School,681,22810,13306,9504
307,Ealing,3073500,Mount Carmel Catholic Primary School,359,19590,11428,8162
307,Ealing,3073503,Our Lady of the Visitation Catholic Primary School,360,19600,11433,8167
307,Ealing,3073504,St John Fisher Catholic Primary School,343,19430,11334,8096
307,Ealing,3073505,St Anselms Catholic Primary School,178,17780,10372,7408
307,Ealing,3073506,St Gregorys Catholic Primary School,524,21240,12390,8850
307,Ealing,3073507,St Josephs Catholic Primary School,495,20950,12221,8729
307,Ealing,3073508,St Raphaels Catholic Primary School,513,21130,12326,8804
307,Ealing,3073509,St Vincents Catholic Primary School,388,19880,11597,8283
307,Ealing,3073510,Edward Betham Church of England Primary School,359,19590,11428,8162
307,Ealing,3073511,Petts Hill Primary School,170,17700,10325,7375
307,Ealing,3073512,Khalsa Primary School,349,19490,11369,8121
307,Ealing,3073513,Christ the Saviour Church of England Primary School,687,22870,13341,9529
307,Ealing,3075201,Wood End Infant School,168,17680,10313,7367
307,Ealing,3077007,Castlebar School,151,17510,10214,7296
307,Ealing,3077010,Mandeville School,109,17090,9969,7121
307,Ealing,3077012,John Chilton School,37,16370,9549,6821
307,Ealing,3077013,Springhallow School,51,16510,9631,6879
308,Enfield,3082009,Capel Manor Primary School,348,19480,11363,8117
308,Enfield,3082011,Carterhatch Infant School,177,17770,10366,7404
308,Enfield,3082012,Chase Side Primary School,358,19580,11422,8158
308,Enfield,3082025,Eldon Primary School,879,24790,14461,10329
308,Enfield,3082028,Firs Farm Primary School,538,21380,12472,8908
308,Enfield,3082032,Garfield Primary School,365,19650,11463,8187
308,Enfield,3082033,George Spicer Primary School,632,22320,13020,9300
308,Enfield,3082036,Hadley Wood Primary School,182,17820,10395,7425
308,Enfield,3082039,Hazelwood Junior School,390,19900,11608,8292
308,Enfield,3082040,Hazelwood Infant School,180,17800,10383,7417
308,Enfield,3082042,Honilands Primary School,497,20970,12233,8737
308,Enfield,3082048,Merryhills Primary School,538,21380,12472,8908
308,Enfield,3082053,Prince of Wales Primary School,504,21040,12273,8767
308,Enfield,3082055,The Raglan Junior School,478,20780,12122,8658
308,Enfield,3082056,Raglan Infant School,241,18410,10739,7671
308,Enfield,3082061,Suffolks Primary School,333,19330,11276,8054
308,Enfield,3082062,Tottenhall Infant School,171,17710,10331,7379
308,Enfield,3082074,Southbury Primary School,346,19460,11352,8108
308,Enfield,3082082,De Bohun Primary School,321,19210,11206,8004
308,Enfield,3082084,Bush Hill Park Primary School,460,20600,12017,8583
308,Enfield,3082085,Eversley Primary School,540,21400,12483,8917
308,Enfield,3082089,West Grove Primary School,353,19530,11393,8137
308,Enfield,3082090,Oakthorpe Primary School,472,20720,12087,8633
308,Enfield,3082092,Highfield Primary School,501,21010,12256,8754
308,Enfield,3082094,Starks Field Primary School,321,19210,11206,8004
308,Enfield,3083302,St Michael at Bowes CofE Junior School,335,19350,11288,8062
308,Enfield,3083303,St Johns CofE Primary School,83,16830,9818,7012
308,Enfield,3083304,Forty Hill CofE Primary School,178,17780,10372,7408
308,Enfield,3083307,St Andrews CofE Primary School,357,19570,11416,8154
308,Enfield,3083308,St Andrews Southgate Primary School (CE),179,17790,10378,7412
308,Enfield,3083309,Freezywater St Georges CofE Primary School,210,18100,10558,7542
308,Enfield,3083310,St John and St James CofE Primary School,331,19310,11264,8046
308,Enfield,3083311,St James CofE Primary School,173,17730,10343,7387
308,Enfield,3083312,St Michaels CofE Primary School,355,19550,11404,8146
308,Enfield,3083313,St Pauls CofE Primary School,359,19590,11428,8162
308,Enfield,3083500,St Marys Catholic Primary School,355,19550,11404,8146
308,Enfield,3083501,St Edmunds Catholic Primary School,374,19740,11515,8225
308,Enfield,3083502,St Georges Catholic Primary School,559,21590,12594,8996
308,Enfield,3083503,St Monicas RC Primary School,355,19550,11404,8146
308,Enfield,3083504,Our Lady of Lourdes Catholic Primary School,179,17790,10378,7412
308,Enfield,3083505,Latymer All Saints CofE Primary School,515,21150,12338,8812
308,Enfield,3085200,St Matthews CofE Primary School,176,17760,10360,7400
308,Enfield,3087002,West Lea School,49,16490,9619,6871
308,Enfield,3087005,Oaktree School,15,15000,8750,6250
308,Enfield,3087007,Waverley School,53,16530,9643,6887
308,Enfield,3087008,Russet House School,95,16950,9888,7062
309,Haringey,3091101,Haringey Tuition Centre,2,2000,1167,833
309,Haringey,3092002,Belmont Junior School,221,18210,10623,7587
309,Haringey,3092003,Belmont Infant School,113,17130,9993,7137
309,Haringey,3092004,Bounds Green Junior School,268,18680,10897,7783
309,Haringey,3092005,Bounds Green Infant School,150,17500,10208,7292
309,Haringey,3092008,Campsbourne Junior School,218,18180,10605,7575
309,Haringey,3092009,Campsbourne Infant School,112,17120,9987,7133
309,Haringey,3092015,The Devonshire Hill Nursery &  Primary School,340,19400,11317,8083
309,Haringey,3092020,Earlsmead Primary School,381,19810,11556,8254
309,Haringey,3092022,Highgate Primary School,363,19630,11451,8179
309,Haringey,3092025,Lancasterian Primary School,374,19740,11515,8225
309,Haringey,3092029,Coldfall Primary School,540,21400,12483,8917
309,Haringey,3092031,Tetherdown Primary School,355,19550,11404,8146
309,Haringey,3092041,Rokesly Junior School,354,19540,11398,8142
309,Haringey,3092042,Rokesly Infant & Nursery School,178,17780,10372,7408
309,Haringey,3092045,South Harringay Junior School,221,18210,10623,7587
309,Haringey,3092046,South Harringay Infant School,114,17140,9998,7142
309,Haringey,3092047,Stamford Hill Primary School,158,17580,10255,7325
309,Haringey,3092051,West Green Primary School,181,17810,10389,7421
309,Haringey,3092057,Tiverton Primary School,294,18940,11048,7892
309,Haringey,3092058,Coleridge Primary School,716,23160,13510,9650
309,Haringey,3092062,Welbourne Primary School,462,20620,12028,8592
309,Haringey,3092063,Lea Valley Primary School,360,19600,11433,8167
309,Haringey,3092065,Ferry Lane Primary School,154,17540,10232,7308
309,Haringey,3092072,Rhodes Avenue Primary School,542,21420,12495,8925
309,Haringey,3092075,Crowland Primary School,336,19360,11293,8067
309,Haringey,3092076,Weston Park Primary School,229,18290,10669,7621
309,Haringey,3092077,The Willow Primary School,357,19570,11416,8154
309,Haringey,3092078,Alexandra Primary School,348,19480,11363,8117
309,Haringey,3092079,Stroud Green Primary School,273,18730,10926,7804
309,Haringey,3092080,Earlham Primary School,315,19150,11171,7979
309,Haringey,3092082,Lordship Lane Primary School,512,21120,12320,8800
309,Haringey,3092083,Bruce Grove Primary School,335,19350,11288,8062
309,Haringey,3092084,Risley Avenue Primary School,532,21320,12437,8883
309,Haringey,3092085,Muswell Hill Primary School,360,19600,11433,8167
309,Haringey,3092088,Seven Sisters Primary School,307,19070,11124,7946
309,Haringey,3093000,St Aidans Voluntary Controlled Primary School,175,17750,10354,7396
309,Haringey,3093001,The Mulberry Primary School,533,21330,12443,8887
309,Haringey,3093302,St Michaels CofE Voluntary Aided Primary School,348,19480,11363,8117
309,Haringey,3093303,St James Church of England Primary School,227,18270,10658,7612
309,Haringey,3093306,St Marys CofE Primary School,451,20510,11964,8546
309,Haringey,3093500,Our Lady of Muswell Catholic Primary School,346,19460,11352,8108
309,Haringey,3093501,St Francis de Sales RC Junior School,346,19460,11352,8108
309,Haringey,3093502,St Ignatius RC Primary School,303,19030,11101,7929
309,Haringey,3093503,St Marys Priory RC Junior School,237,18370,10716,7654
309,Haringey,3093504,St Pauls RC Primary School,173,17730,10343,7387
309,Haringey,3093505,St Marys Priory RC Infant School,109,17090,9969,7121
309,Haringey,3093506,St Peter-in-Chains RC Infant School,105,17050,9946,7104
309,Haringey,3093507,St Francis de Sales RC Infant School,169,17690,10319,7371
309,Haringey,3093508,St Martin of Porres RC Primary School,168,17680,10313,7367
309,Haringey,3093509,St Gildas Catholic Junior School,217,18170,10599,7571
309,Haringey,3093510,St John Vianney RC Primary School,176,17760,10360,7400
309,Haringey,3093511,Chestnuts Primary School,358,19580,11422,8158
309,Haringey,3093512,North Harringay Primary School,345,19450,11346,8104
309,Haringey,3097000,Blanche Nevile School,18,16180,9438,6742
309,Haringey,3097001,Vale School,47,16470,9608,6862
309,Haringey,3097005,The Brook School,100,17000,9917,7083
310,Harrow,3101101,The Helix Education Centre,7,7000,4083,2917
310,Harrow,3102045,Newton Farm Nursery Infant and Junior School,270,18700,10908,7792
310,Harrow,3102050,Roxeth Primary School,387,19870,11591,8279
310,Harrow,3102051,Marlborough Primary School,576,21760,12693,9067
310,Harrow,3102052,Grimsdyke School,479,20790,12128,8662
310,Harrow,3102053,Camrose Primary With Nursery,319,19190,11194,7996
310,Harrow,3102055,Belmont School,475,20750,12104,8646
310,Harrow,3102059,Kenmore Park Junior School,402,20020,11678,8342
310,Harrow,3102060,Pinner Park Junior School,479,20790,12128,8662
310,Harrow,3102063,Stag Lane Junior School,382,19820,11562,8258
310,Harrow,3102066,Longfield Primary School,605,22050,12863,9187
310,Harrow,3102071,Grange Primary School,474,20740,12098,8642
310,Harrow,3102073,Cannon Lane Primary School,656,22560,13160,9400
310,Harrow,3102076,Pinner Park Infant and Nursery School,233,18330,10693,7637
310,Harrow,3102079,Stag Lane Infant and Nursery School,206,18060,10535,7525
310,Harrow,3102082,Elmgrove Primary School & Nursery,639,22390,13061,9329
310,Harrow,3102083,Kenmore Park Infant and Nursery School,206,18060,10535,7525
310,Harrow,3102084,Roxbourne Primary School,438,20380,11888,8492
310,Harrow,3102085,Stanburn Primary School,696,22960,13393,9567
310,Harrow,3102086,Weald Rise Primary School,460,20600,12017,8583
310,Harrow,3102087,West Lodge Primary School,555,21550,12571,8979
310,Harrow,3102096,Norbury School,500,21000,12250,8750
310,Harrow,3102097,Vaughan Primary School,488,20880,12180,8700
310,Harrow,3102098,Glebe Primary School,531,21310,12431,8879
310,Harrow,3102101,Whitchurch Primary School & Nursery,629,22290,13003,9287
310,Harrow,3103501,St Anselms Catholic Primary School,359,19590,11428,8162
310,Harrow,3103504,St Teresas Catholic Primary School and Nursery,354,19540,11398,8142
310,Harrow,3103505,St John Fisher Catholic Primary School,449,20490,11953,8537
310,Harrow,3103507,St Josephs Catholic Primary School,360,19600,11433,8167
310,Harrow,3103508,St Georges Primary School,361,19610,11439,8171
310,Harrow,3103511,St Johns CofE School Stanmore,354,19540,11398,8142
310,Harrow,3103512,Pinner Wood School,454,20540,11982,8558
310,Harrow,3103514,Cedars Manor School,489,20890,12186,8704
310,Harrow,3107006,Woodlands School,109,17090,9969,7121
311,Havering,3112003,The James Oglethorpe Primary School,285,18850,10996,7854
311,Havering,3112005,Harold Wood Primary School,471,20710,12081,8629
311,Havering,3112006,Ardleigh Green Junior School,361,19610,11439,8171
311,Havering,3112007,Ardleigh Green Infant School,180,17800,10383,7417
311,Havering,3112008,Elm Park Primary School,321,19210,11206,8004
311,Havering,3112014,Hylands Primary School,386,19860,11585,8275
311,Havering,3112017,Harold Court Primary School,353,19530,11393,8137
311,Havering,3112019,Langtons Infant School,146,17460,10185,7275
311,Havering,3112024,Suttons Primary School,235,18350,10704,7646
311,Havering,3112026,Whybridge Infant School,133,17330,10109,7221
311,Havering,3112038,Clockhouse Primary School,536,21360,12460,8900
311,Havering,3112041,Crownfield Junior School,338,19380,11305,8075
311,Havering,3112042,Crownfield Infant School,174,17740,10348,7392
311,Havering,3112055,Parklands Junior School,473,20730,12093,8637
311,Havering,3112056,Parklands Infant School,254,18540,10815,7725
311,Havering,3112061,Squirrels Heath Junior School,359,19590,11428,8162
311,Havering,3112062,Squirrels Heath Infant School,174,17740,10348,7392
311,Havering,3112069,Gidea Park Primary School,405,20050,11696,8354
311,Havering,3112070,Towers Infant School,180,17800,10383,7417
311,Havering,3112073,Parsonage Farm Primary School,504,21040,12273,8767
311,Havering,3112076,Towers Junior School,345,19450,11346,8104
311,Havering,3112078,Brady Primary School,175,17750,10354,7396
311,Havering,3112080,Scotts Primary School,271,18710,10914,7796
311,Havering,3112081,Broadford Primary School,414,20140,11748,8392
311,Havering,3112084,Newtons Primary School,319,19190,11194,7996
311,Havering,3112086,Nelmes Primary School,392,19920,11620,8300
311,Havering,3112087,Mead Primary School,528,21280,12413,8867
311,Havering,3112089,Rainham Village Primary School,360,19600,11433,8167
311,Havering,3112090,Hilldene Primary School,536,21360,12460,8900
311,Havering,3112092,The Mawney Foundation  School,351,19510,11381,8129
311,Havering,3112093,The R J Mitchell Primary School,241,18410,10739,7671
311,Havering,3112094,Engayne Primary School,537,21370,12466,8904
311,Havering,3112097,Crowlands Primary School,518,21180,12355,8825
311,Havering,3113301,St Edwards Church of England Voluntary Aided Primary School,520,21200,12367,8833
311,Havering,3113501,St Marys Catholic Primary School,360,19600,11433,8167
311,Havering,3113502,La Salette Catholic Primary School,174,17740,10348,7392
311,Havering,3113503,St Patricks Catholic Primary School,338,19380,11305,8075
311,Havering,3113504,St Ursulas Catholic Junior School,243,18430,10751,7679
311,Havering,3113505,St Ursulas Catholic Infant School,119,17190,10028,7162
311,Havering,3113506,St Josephs Catholic Primary School,363,19630,11451,8179
311,Havering,3113507,St Peters Catholic Primary School,238,18380,10722,7658
311,Havering,3113508,St Albans Catholic Primary School,177,17770,10366,7404
311,Havering,3113509,Branfil Primary School,472,20720,12087,8633
311,Havering,3117000,Corbets Tey School,53,16530,9643,6887
312,Hillingdon,3122003,Bourne Primary School,201,18010,10506,7504
312,Hillingdon,3122004,The Breakspear School,540,21400,12483,8917
312,Hillingdon,3122010,Colham Manor Primary School,508,21080,12297,8783
312,Hillingdon,3122012,Coteford Infant School,165,17650,10296,7354
312,Hillingdon,3122016,Deanesfield Primary School,524,21240,12390,8850
312,Hillingdon,3122018,Field End Junior School,405,20050,11696,8354
312,Hillingdon,3122019,Field End Infant School,238,18380,10722,7658
312,Hillingdon,3122020,Glebe Primary School,450,20500,11958,8542
312,Hillingdon,3122023,Harefield Junior School,277,18770,10949,7821
312,Hillingdon,3122024,Harefield Infant School,154,17540,10232,7308
312,Hillingdon,3122025,Harlyn Primary School,444,20440,11923,8517
312,Hillingdon,3122026,Harmondsworth Primary School,165,17650,10296,7354
312,Hillingdon,3122029,Heathrow Primary School,345,19450,11346,8104
312,Hillingdon,3122032,Lady Bankes Junior School,307,19070,11124,7946
312,Hillingdon,3122033,Lady Bankes Infant School,172,17720,10337,7383
312,Hillingdon,3122036,Minet Junior School,441,20410,11906,8504
312,Hillingdon,3122037,Minet Nursery and Infant School,220,18200,10617,7583
312,Hillingdon,3122038,Newnham Junior School,360,19600,11433,8167
312,Hillingdon,3122039,Newnham Infant and Nursery School,180,17800,10383,7417
312,Hillingdon,3122052,Whitehall Junior School,403,20030,11684,8346
312,Hillingdon,3122054,Whiteheath Junior School,353,19530,11393,8137
312,Hillingdon,3122059,Yeading Junior School,479,20790,12128,8662
312,Hillingdon,3122060,Yeading Infant and Nursery School,240,18400,10733,7667
312,Hillingdon,3122061,Hermitage Primary School,317,19170,11183,7987
312,Hillingdon,3122063,Highfield Primary School,337,19370,11299,8071
312,Hillingdon,3122064,Rabbsfarm Primary School,454,20540,11982,8558
312,Hillingdon,3122065,Warrender Primary School,179,17790,10378,7412
312,Hillingdon,3122069,Whitehall Infant School,218,18180,10605,7575
312,Hillingdon,3122074,Whiteheath Infant and Nursery School,179,17790,10378,7412
312,Hillingdon,3122076,Frithwood Primary School,350,19500,11375,8125
312,Hillingdon,3122080,Ruislip Gardens Primary School,354,19540,11398,8142
312,Hillingdon,3122084,Cherry Lane Primary School,524,21240,12390,8850
312,Hillingdon,3123300,Bishop Winnington-Ingram CofE Primary School,295,18950,11054,7896
312,Hillingdon,3123302,Holy Trinity CofE Primary School,173,17730,10343,7387
312,Hillingdon,3123307,Dr Tripletts CofE Primary School,352,19520,11387,8133
312,Hillingdon,3123400,St Swithun Wells Catholic Primary School,176,17760,10360,7400
312,Hillingdon,3123401,Botwell House Catholic Primary School,537,21370,12466,8904
312,Hillingdon,3123402,St Bernadette Catholic Primary School,349,19490,11369,8121
312,Hillingdon,3123403,St Catherine Catholic Primary School,177,17770,10366,7404
312,Hillingdon,3123404,St Marys Catholic Primary School,180,17800,10383,7417
312,Hillingdon,3123405,Sacred Heart Catholic Primary School,532,21320,12437,8883
312,Hillingdon,3125200,Oak Farm Infant School,175,17750,10354,7396
312,Hillingdon,3125201,Oak Farm Junior School,357,19570,11416,8154
312,Hillingdon,3125202,Grange Park Junior School,385,19850,11579,8271
312,Hillingdon,3125203,Grange Park Infant and Nursery School,230,18300,10675,7625
312,Hillingdon,3125204,Hillside Infant School,119,17190,10028,7162
312,Hillingdon,3125205,Hillside Junior School,235,18350,10704,7646
312,Hillingdon,3125208,St Andrews CofE Primary School,170,17700,10325,7375
312,Hillingdon,3125211,Hayes Park School,538,21380,12472,8908
312,Hillingdon,3127009,Hedgewood School,142,17420,10162,7258
313,Hounslow,3131100,The Woodbridge Park Education Service,13,13000,7583,5417
313,Hounslow,3132003,Belmont Primary School,356,19560,11410,8150
313,Hounslow,3132004,Cranford Primary School,503,21030,12268,8762
313,Hounslow,3132006,Cardinal Road Infant and Nursery School,178,17780,10372,7408
313,Hounslow,3132007,Cavendish Primary School,161,17610,10273,7337
313,Hounslow,3132014,Alexandra Primary School,552,21520,12553,8967
313,Hounslow,3132021,Feltham Hill Infant and Nursery School,246,18460,10768,7692
313,Hounslow,3132022,Grove Park Primary School,315,19150,11171,7979
313,Hounslow,3132024,Victoria Junior School,331,19310,11264,8046
313,Hounslow,3132031,Hounslow Heath Junior School,681,22810,13306,9504
313,Hounslow,3132032,Hounslow Heath Infant and Nursery School,415,20150,11754,8396
313,Hounslow,3132033,Hounslow Town Primary School,718,23180,13522,9658
313,Hounslow,3132034,Isleworth Town Primary School,647,22470,13108,9362
313,Hounslow,3132036,Lionel Primary School,507,21070,12291,8779
313,Hounslow,3132037,Marlborough Primary School,553,21530,12559,8971
313,Hounslow,3132039,Norwood Green Infant and Nursery School,240,18400,10733,7667
313,Hounslow,3132043,Sparrow Farm Infant and Nursery School,175,17750,10354,7396
313,Hounslow,3132044,Spring Grove Primary School,240,18400,10733,7667
313,Hounslow,3132045,Springwell Junior School,454,20540,11982,8558
313,Hounslow,3132046,Springwell Infant and Nursery School,237,18370,10716,7654
313,Hounslow,3132047,Strand-on-the-Green Junior School,354,19540,11398,8142
313,Hounslow,3132048,Strand-on-the-Green Infant and Nursery School,181,17810,10389,7421
313,Hounslow,3132050,Wellington Primary School,413,20130,11743,8387
313,Hounslow,3132051,Worple Primary School,173,17730,10343,7387
313,Hounslow,3132056,Sparrow Farm Junior School,290,18900,11025,7875
313,Hounslow,3132061,Ivybridge Primary School,253,18530,10809,7721
313,Hounslow,3132063,Edward Pauling Primary School,363,19630,11451,8179
313,Hounslow,3132064,The Smallberry Green Primary School,335,19350,11288,8062
313,Hounslow,3132071,Grove Road Primary School,180,17800,10383,7417
313,Hounslow,3132073,Beavers Community Primary School,564,21640,12623,9017
313,Hounslow,3132078,Crane Park Primary School,387,19870,11591,8279
313,Hounslow,3132079,Fairholme Primary School,478,20780,12122,8658
313,Hounslow,3132081,Green Dragon Primary School,374,19740,11515,8225
313,Hounslow,3132082,The William Hogarth Primary School,255,18550,10821,7729
313,Hounslow,3132083,Bedfont Primary School,521,21210,12373,8837
313,Hounslow,3133300,The Blue School CofE Primary,342,19420,11328,8092
313,Hounslow,3133302,St Pauls CofE Primary School,275,18750,10938,7812
313,Hounslow,3133502,Our Lady and St Johns Catholic Primary School,169,17690,10319,7371
313,Hounslow,3133503,St Lawrence RC Primary School,387,19870,11591,8279
313,Hounslow,3133504,St Marys Catholic Primary School Isleworth,331,19310,11264,8046
313,Hounslow,3133505,St Marys Catholic Primary School Chiswick,180,17800,10383,7417
313,Hounslow,3133507,St Michael and St Martin Catholic Primary School,360,19600,11433,8167
313,Hounslow,3133941,The Rosary Catholic Primary School,360,19600,11433,8167
313,Hounslow,3133942,Orchard Primary School,533,21330,12443,8887
313,Hounslow,3133943,Chatsworth Primary School,520,21200,12367,8833
313,Hounslow,3133944,Heston Primary School,356,19560,11410,8150
313,Hounslow,3137005,Marjory Kinnon School,97,16970,9899,7071
313,Hounslow,3137007,Lindon Bennett School,130,17300,10092,7208
313,Hounslow,3137010,The Cedars Primary School,60,16600,9683,6917
313,Hounslow,3132030,Southville Primary School,529,21290,12419,8871
313,Hounslow,3137006,Oaklands School,2,2000,1167,833
314,Kingston upon Thames,3142001,Burlington Junior School,475,20750,12104,8646
314,Kingston upon Thames,3142002,Burlington Infant and Nursery School,241,18410,10739,7671
314,Kingston upon Thames,3142004,Coombe Hill Infant School,210,18100,10558,7542
314,Kingston upon Thames,3142005,Ellingham Primary School,339,19390,11311,8079
314,Kingston upon Thames,3142006,Lime Tree Primary School,349,19490,11369,8121
314,Kingston upon Thames,3142020,Robin Hood Primary School,171,17710,10331,7379
314,Kingston upon Thames,3142024,Tolworth Junior School,362,19620,11445,8175
314,Kingston upon Thames,3142025,Tolworth Infant and Nursery School,178,17780,10372,7408
314,Kingston upon Thames,3142028,Coombe Hill Junior School,420,20200,11783,8417
314,Kingston upon Thames,3142030,Maple Infants School,177,17770,10366,7404
314,Kingston upon Thames,3142031,Alexandra School,277,18770,10949,7821
314,Kingston upon Thames,3142032,King Athelstan Primary School,333,19330,11276,8054
314,Kingston upon Thames,3142033,Grand Avenue Primary and Nursery School,527,21270,12408,8862
314,Kingston upon Thames,3142034,Malden Manor Primary and Nursery School,343,19430,11334,8096
314,Kingston upon Thames,3142035,Kings Oak Primary School,407,20070,11708,8362
314,Kingston upon Thames,3142036,Lovelace Primary School,445,20450,11929,8521
314,Kingston upon Thames,3142037,Fern Hill Primary School,566,21660,12635,9025
314,Kingston upon Thames,3143301,Christ Church New Malden CofE Primary School,358,19580,11422,8158
314,Kingston upon Thames,3143302,Christ Church CofE Primary School,464,20640,12040,8600
314,Kingston upon Thames,3143303,Malden Parochial CofE Primary School,239,18390,10728,7662
314,Kingston upon Thames,3143304,St Andrews and St Marks CofE Junior School,310,19100,11142,7958
314,Kingston upon Thames,3143305,St Johns C of E Primary School,175,17750,10354,7396
314,Kingston upon Thames,3143308,St Pauls CofE Primary School,177,17770,10366,7404
314,Kingston upon Thames,3143309,St Pauls CofE Primary School Kingston Hill,326,19260,11235,8025
314,Kingston upon Thames,3143310,St Matthews CofE Primary School,332,19320,11270,8050
314,Kingston upon Thames,3143311,St Marys CofE (Aided) Primary School,199,17990,10494,7496
314,Kingston upon Thames,3143500,Corpus Christi Catholic Primary School,358,19580,11422,8158
314,Kingston upon Thames,3143501,Our Lady Immaculate Catholic Primary School,351,19510,11381,8129
314,Kingston upon Thames,3143502,St Josephs Catholic Primary School,197,17970,10483,7487
314,Kingston upon Thames,3145200,St Lukes CofE Primary School,210,18100,10558,7542
315,Merton,3152052,Bond Primary School,339,19390,11311,8079
315,Merton,3152055,Dundonald Primary School,266,18660,10885,7775
315,Merton,3152056,Garfield Primary School,324,19240,11223,8017
315,Merton,3152059,Hatfeild Primary School,355,19550,11404,8146
315,Merton,3152061,Hollymount School,354,19540,11398,8142
315,Merton,3152062,Joseph Hood Primary School,258,18580,10838,7742
315,Merton,3152063,Links Primary School,321,19210,11206,8004
315,Merton,3152064,Lonesome Primary School,307,19070,11124,7946
315,Merton,3152066,Merton Abbey Primary School,258,18580,10838,7742
315,Merton,3152067,Merton Park Primary School,176,17760,10360,7400
315,Merton,3152068,Morden Primary School,173,17730,10343,7387
315,Merton,3152070,Pelham Primary School,321,19210,11206,8004
315,Merton,3152071,Haslemere Primary School,347,19470,11358,8112
315,Merton,3152072,Poplar Primary School,467,20670,12058,8612
315,Merton,3152073,St Marks Primary School,175,17750,10354,7396
315,Merton,3152074,The Sherwood School,323,19230,11218,8012
315,Merton,3152075,Singlegate Primary School,432,20320,11853,8467
315,Merton,3152076,Wimbledon Park Primary School,530,21300,12425,8875
315,Merton,3152077,Abbotsbury Primary School,338,19380,11305,8075
315,Merton,3152081,West Wimbledon Primary School,385,19850,11579,8271
315,Merton,3152082,Cranmer Primary School,517,21170,12349,8821
315,Merton,3152083,Gorringe Park Primary School,462,20620,12028,8592
315,Merton,3152084,Hillcross Primary School,457,20570,11999,8571
315,Merton,3152085,Liberty Primary,388,19880,11597,8283
315,Merton,3152090,William Morris Primary School,295,18950,11054,7896
315,Merton,3152091,Wimbledon Chase Primary School,545,21450,12513,8937
315,Merton,3152092,Malmesbury Primary School,336,19360,11293,8067
315,Merton,3153300,All Saints CofE Primary School,252,18520,10803,7717
315,Merton,3153302,St Matthews CofE Primary School,153,17530,10226,7304
315,Merton,3153303,Holy Trinity CofE Primary School,348,19480,11363,8117
315,Merton,3153304,Bishop Gilpin CofE Primary School,356,19560,11410,8150
315,Merton,3153500,St Peter and Paul Catholic Primary School,341,19410,11323,8087
315,Merton,3153501,Sacred Heart Catholic Primary School,281,18810,10973,7837
315,Merton,3153502,St Teresas Catholic Primary School,359,19590,11428,8162
315,Merton,3153503,St Marys Catholic Primary School,359,19590,11428,8162
315,Merton,3153505,St John Fisher RC Primary School,356,19560,11410,8150
315,Merton,3153506,The Priory CofE School,321,19210,11206,8004
315,Merton,3153507,St Thomas of Canterbury Catholic Primary School,472,20720,12087,8633
315,Merton,3157004,Perseid School,62,16620,9695,6925
315,Merton,3157006,Cricket Green School,49,16490,9619,6871
316,Newham,3161100,Tunmarsh School,2,2000,1167,833
316,Newham,3162000,Altmore Infant School,296,18960,11060,7900
316,Newham,3162001,Avenue Primary School,679,22790,13294,9496
316,Newham,3162004,Brampton Primary School,712,23120,13487,9633
316,Newham,3162006,Carpenters Primary School,339,19390,11311,8079
316,Newham,3162015,Dersingham Primary School,523,21230,12384,8846
316,Newham,3162024,Godwin Junior School,364,19640,11457,8183
316,Newham,3162025,Woodgrange Infant School,230,18300,10675,7625
316,Newham,3162026,Grange Primary School,174,17740,10348,7392
316,Newham,3162032,Keir Hardie Primary School,352,19520,11387,8133
316,Newham,3162037,Lathom Junior School,516,21160,12343,8817
316,Newham,3162038,Manor Primary School,236,18360,10710,7650
316,Newham,3162039,Maryland Primary School,351,19510,11381,8129
316,Newham,3162049,Odessa Infant School,159,17590,10261,7329
316,Newham,3162051,Park Primary School,454,20540,11982,8558
316,Newham,3162058,Roman Road Primary School,309,19090,11136,7954
316,Newham,3162061,Salisbury Primary School,500,21000,12250,8750
316,Newham,3162065,William Davies Primary School,175,17750,10354,7396
316,Newham,3162066,Star Primary School,533,21330,12443,8887
316,Newham,3162069,St Stephens Primary School,448,20480,11947,8533
316,Newham,3162077,Winsor Primary School,508,21080,12297,8783
316,Newham,3162079,Colegrave Primary School,524,21240,12390,8850
316,Newham,3162083,Southern Road Primary School,514,21140,12332,8808
316,Newham,3162089,Calverton Primary School,356,19560,11410,8150
316,Newham,3162090,Ellen Wilkinson Primary School,345,19450,11346,8104
316,Newham,3162095,Essex Primary School,712,23120,13487,9633
316,Newham,3162096,Sandringham Primary School,716,23160,13510,9650
316,Newham,3162097,Central Park Primary School,714,23140,13498,9642
316,Newham,3162101,Sir John Heron Primary School,351,19510,11381,8129
316,Newham,3162104,Plaistow Primary School,330,19300,11258,8042
316,Newham,3163000,St James CofE Junior School,282,18820,10978,7842
316,Newham,3163001,West Ham Church Primary School,237,18370,10716,7654
316,Newham,3163300,St Lukes Primary School,169,17690,10319,7371
316,Newham,3163503,St Edwards Catholic Primary School,350,19500,11375,8125
316,Newham,3163507,St Michaels Catholic Primary School,177,17770,10366,7404
316,Newham,3163508,St Winefrides RC Primary School,263,18630,10868,7762
316,Newham,3163510,St Francis Catholic Primary School,322,19220,11212,8008
316,Newham,3163511,St Antonys Catholic Primary School,356,19560,11410,8150
317,Redbridge,3172002,Manford Primary School,377,19770,11533,8237
317,Redbridge,3172012,Cleveland Road Primary School,744,23440,13673,9767
317,Redbridge,3172015,Downshall Primary School,501,21010,12256,8754
317,Redbridge,3172017,Fairlop Primary School,591,21910,12781,9129
317,Redbridge,3172021,Gilbert Colvin Primary School,339,19390,11311,8079
317,Redbridge,3172022,Glade Primary School,386,19860,11585,8275
317,Redbridge,3172023,Goodmayes Primary School,535,21350,12454,8896
317,Redbridge,3172025,Gordon Primary School,208,18080,10547,7533
317,Redbridge,3172030,Mossford Green Primary School,329,19290,11253,8037
317,Redbridge,3172031,Newbury Park Primary School,743,23430,13668,9762
317,Redbridge,3172038,Uphall Primary School,800,24000,14000,10000
317,Redbridge,3172039,William Torbitt Primary School,593,21930,12793,9137
317,Redbridge,3172042,Aldersbrook Primary School,528,21280,12413,8867
317,Redbridge,3172051,Roding Primary School,385,19850,11579,8271
317,Redbridge,3172053,Wells Primary School,270,18700,10908,7792
317,Redbridge,3172054,Snaresbrook Primary School,353,19530,11393,8137
317,Redbridge,3172055,Fullwood Primary School,359,19590,11428,8162
317,Redbridge,3172056,Woodlands Primary School,710,23100,13475,9625
317,Redbridge,3172057,Grove Primary School,510,21100,12308,8792
317,Redbridge,3172058,Chadwell Primary School,507,21070,12291,8779
317,Redbridge,3172061,Coppice Primary School,370,19700,11492,8208
317,Redbridge,3172062,John Bramston Primary School,350,19500,11375,8125
317,Redbridge,3172063,Nightingale Primary School,582,21820,12728,9092
317,Redbridge,3172066,Barley Lane Primary School,648,22480,13113,9367
317,Redbridge,3172069,Highlands Primary School,542,21420,12495,8925
317,Redbridge,3172071,Mayespark Primary School,706,23060,13452,9608
317,Redbridge,3172072,Christchurch Primary School,891,24910,14531,10379
317,Redbridge,3172073,South Park Primary School,629,22290,13003,9287
317,Redbridge,3173300,Wanstead Church School,179,17790,10378,7412
317,Redbridge,3173500,St Augustines Catholic Primary School,362,19620,11445,8175
317,Redbridge,3173504,Our Lady of Lourdes RC Primary School,359,19590,11428,8162
317,Redbridge,3173505,St Antonys Catholic Primary School,360,19600,11433,8167
317,Redbridge,3173506,St Bedes Catholic Primary School,351,19510,11381,8129
317,Redbridge,3173509,Wohl Ilford Jewish Primary School,213,18130,10576,7554
317,Redbridge,3173513,SS Peter and Pauls Catholic Primary School,357,19570,11416,8154
317,Redbridge,3173514,Clore Tikva School,357,19570,11416,8154
317,Redbridge,3173516,Oakdale Junior School,336,19360,11293,8067
317,Redbridge,3173517,Oakdale Infants School,172,17720,10337,7383
317,Redbridge,3173519,Gearies Primary School,562,21620,12612,9008
317,Redbridge,3173520,Churchfields Junior School,475,20750,12104,8646
317,Redbridge,3173521,Churchfields Infants School,241,18410,10739,7671
317,Redbridge,3173523,Parkhill Infants School,205,18050,10529,7521
317,Redbridge,3173524,Parkhill Junior School,392,19920,11620,8300
317,Redbridge,3173527,Redbridge Primary School,606,22060,12868,9192
317,Redbridge,3173528,Cranbrook Primary School,749,23490,13703,9787
317,Redbridge,3174032,Seven Kings School,239,18390,10728,7662
317,Redbridge,3177004,The New Rush Hall School,24,16240,9473,6767
317,Redbridge,3177007,Hatton School and Special Needs Centre,178,17780,10372,7408
317,Redbridge,3172008,Al-Noor Voluntary Aided Muslim Primary School,59,16590,9678,6912
318,Richmond upon Thames,3182000,St Richard Reynolds Catholic Primary School,119,17190,10028,7162
318,Richmond upon Thames,3182001,Carlisle Infant School,178,17780,10372,7408
318,Richmond upon Thames,3182004,Darell Primary and Nursery School,251,18510,10798,7712
318,Richmond upon Thames,3182006,East Sheen Primary School,469,20690,12069,8621
318,Richmond upon Thames,3182007,Hampton Hill Junior School,359,19590,11428,8162
318,Richmond upon Thames,3182008,Hampton Junior School,372,19720,11503,8217
318,Richmond upon Thames,3182009,Hampton Infant School and Nursery,204,18040,10523,7517
318,Richmond upon Thames,3182010,Hampton Wick Infant and Nursery School,154,17540,10232,7308
318,Richmond upon Thames,3182011,Heathfield Junior School,414,20140,11748,8392
318,Richmond upon Thames,3182012,Heathfield Infant School,228,18280,10663,7617
318,Richmond upon Thames,3182013,Lowther Primary School,284,18840,10990,7850
318,Richmond upon Thames,3182015,Meadlands Primary School,174,17740,10348,7392
318,Richmond upon Thames,3182018,Orleans Primary School,354,19540,11398,8142
318,Richmond upon Thames,3182019,The Russell Primary School,222,18220,10628,7592
318,Richmond upon Thames,3182020,Sheen Mount Primary School,478,20780,12122,8658
318,Richmond upon Thames,3182021,Stanley  Primary School,653,22530,13143,9387
318,Richmond upon Thames,3182023,Trafalgar Junior School,347,19470,11358,8112
318,Richmond upon Thames,3182024,Trafalgar Infant School,176,17760,10360,7400
318,Richmond upon Thames,3182028,Barnes Primary School,390,19900,11608,8292
318,Richmond upon Thames,3182032,Collis Primary School,625,22250,12979,9271
318,Richmond upon Thames,3182035,Buckingham Primary School,476,20760,12110,8650
318,Richmond upon Thames,3182036,Chase Bridge Primary School,526,21260,12402,8858
318,Richmond upon Thames,3182037,The Vineyard School,477,20770,12116,8654
318,Richmond upon Thames,3182039,Kew Riverside Primary School,156,17560,10243,7317
318,Richmond upon Thames,3182040,Marshgate Primary School,390,19900,11608,8292
318,Richmond upon Thames,3183303,St Richards Church of England Primary School,171,17710,10331,7379
318,Richmond upon Thames,3183304,Holy Trinity Church of England Primary School,378,19780,11538,8242
318,Richmond upon Thames,3183309,St Mary Magdalens Catholic Primary School,223,18230,10634,7596
318,Richmond upon Thames,3183310,St Elizabeths Catholic Primary School,269,18690,10903,7787
318,Richmond upon Thames,3183312,St John the Baptist Church of England Junior School,309,19090,11136,7954
318,Richmond upon Thames,3183315,St Edmunds Catholic Primary School,359,19590,11428,8162
318,Richmond upon Thames,3183316,St Jamess Roman Catholic Primary School,539,21390,12478,8912
318,Richmond upon Thames,3183317,St Marys Church of England Primary School,561,21610,12606,9004
318,Richmond upon Thames,3183319,St Stephens C E Primary School,353,19530,11393,8137
318,Richmond upon Thames,3183320,Sacred Heart Roman Catholic Primary School,195,17950,10471,7479
318,Richmond upon Thames,3183321,St Marys and St Peters Church of England Primary School,539,21390,12478,8912
318,Richmond upon Thames,3183322,Bishop Perrin Church of England Primary School,181,17810,10389,7421
318,Richmond upon Thames,3183324,St Osmunds Catholic Primary School,188,17880,10430,7450
318,Richmond upon Thames,3183326,Archdeacon Cambridges Church of England Primary School,384,19840,11573,8267
318,Richmond upon Thames,3183327,The Queens Church of England Primary School,355,19550,11404,8146
319,Sutton,3191100,The Limes College,2,2000,1167,833
319,Sutton,3192000,Bandon Hill Primary School,911,25110,14648,10462
319,Sutton,3192016,Hackbridge Primary School,500,21000,12250,8750
319,Sutton,3192019,High View Primary School,363,19630,11451,8179
319,Sutton,3192023,Devonshire Primary School,566,21660,12635,9025
319,Sutton,3192037,Robin Hood Infants School,179,17790,10378,7412
319,Sutton,3192038,Dorchester Primary School,518,21180,12355,8825
319,Sutton,3192040,Beddington Infants School,176,17760,10360,7400
319,Sutton,3192041,Robin Hood Junior School,357,19570,11416,8154
319,Sutton,3192042,Nonsuch Primary School,180,17800,10383,7417
319,Sutton,3192043,Foresters Primary School,209,18090,10553,7537
319,Sutton,3192048,Culvers House Primary School,352,19520,11387,8133
319,Sutton,3192049,Muschamp Primary School and Language Opportunity Base,527,21270,12408,8862
319,Sutton,3193301,All Saints Benhilton CofE Primary School,335,19350,11288,8062
319,Sutton,3193303,Holy Trinity CofE Junior School,360,19600,11433,8167
319,Sutton,3193304,St Dunstans Cheam CofE Primary School,375,19750,11521,8229
319,Sutton,3193500,St Cecilias Catholic Primary School,374,19740,11515,8225
319,Sutton,3193501,St Marys RC Junior School,338,19380,11305,8075
319,Sutton,3193502,St Marys RC Infants School,179,17790,10378,7412
319,Sutton,3193503,St Elpheges RC Junior School,355,19550,11404,8146
319,Sutton,3193504,St Elpheges RC Infants School,180,17800,10383,7417
319,Sutton,3195201,Stanley Park Junior School,360,19600,11433,8167
319,Sutton,3197002,Sherwood Park School,38,16380,9555,6825
320,Waltham Forest,3201105,Hawkswood Primary PRU,8,8000,4667,3333
320,Waltham Forest,3202001,Chase Lane Primary School,550,21500,12542,8958
320,Waltham Forest,3202006,Whitehall Primary School,368,19680,11480,8200
320,Waltham Forest,3202017,Downsell Primary School,438,20380,11888,8492
320,Waltham Forest,3202023,Newport School,690,22900,13358,9542
320,Waltham Forest,3202028,Chapel End Infant School and Early Years Centre,176,17760,10360,7400
320,Waltham Forest,3202030,Edinburgh Primary School,494,20940,12215,8725
320,Waltham Forest,3202031,Greenleaf Primary School,387,19870,11591,8279
320,Waltham Forest,3202045,Handsworth Primary School,357,19570,11416,8154
320,Waltham Forest,3202049,Thorpe Hall Primary School,389,19890,11603,8287
320,Waltham Forest,3202050,The Winns Primary School,662,22620,13195,9425
320,Waltham Forest,3202062,Oakhill Primary School,201,18010,10506,7504
320,Waltham Forest,3202064,Henry Maynard Primary School,706,23060,13452,9608
320,Waltham Forest,3202066,South Grove Primary School,362,19620,11445,8175
320,Waltham Forest,3202067,Dawlish Primary School,153,17530,10226,7304
320,Waltham Forest,3202069,Gwyn Jones Primary School,332,19320,11270,8050
320,Waltham Forest,3202072,George Tomlinson Primary School,433,20330,11859,8471
320,Waltham Forest,3202074,Mission Grove Primary School,629,22290,13003,9287
320,Waltham Forest,3202075,Coppermill Primary School,200,18000,10500,7500
320,Waltham Forest,3202076,Stoneydown Park School,397,19970,11649,8321
320,Waltham Forest,3202078,Parkside Primary School,413,20130,11743,8387
320,Waltham Forest,3202079,The Jenny Hammond Primary School,256,18560,10827,7733
320,Waltham Forest,3202082,Ainslie Wood Primary School,350,19500,11375,8125
320,Waltham Forest,3202083,Barn Croft Primary School,155,17550,10238,7312
320,Waltham Forest,3203001,Chingford CofE Primary School,341,19410,11323,8087
320,Waltham Forest,3203300,St Marys Catholic Primary School,187,17870,10424,7446
320,Waltham Forest,3203301,St Josephs Catholic Junior School,213,18130,10576,7554
320,Waltham Forest,3203305,St Josephs Catholic Infant School,111,17110,9981,7129
320,Waltham Forest,3203311,Our Lady and St Georges Catholic Primary School,359,19590,11428,8162
320,Waltham Forest,3204000,Buxton School,622,22220,12962,9258
320,Waltham Forest,3205200,St Patricks Catholic Primary School,360,19600,11433,8167
320,Waltham Forest,3207011,Belmont Park School,1,1000,583,417
330,Birmingham,3301100,City of Birmingham School,110,17100,9975,7125
330,Birmingham,3302004,Mapledene Primary School,281,18810,10973,7837
330,Birmingham,3302005,Kings Heath Primary School,559,21590,12594,8996
330,Birmingham,3302008,Shaw Hill Primary School,364,19640,11457,8183
330,Birmingham,3302010,Adderley Primary School,522,21220,12378,8842
330,Birmingham,3302011,Wheelers Lane Primary School,539,21390,12478,8912
330,Birmingham,3302014,Barford Primary School,351,19510,11381,8129
330,Birmingham,3302015,James Watt Primary School,360,19600,11433,8167
330,Birmingham,3302016,Beeches Junior School,363,19630,11451,8179
330,Birmingham,3302017,Beeches Infant School,178,17780,10372,7408
330,Birmingham,3302018,The Oaks Primary School,315,19150,11171,7979
330,Birmingham,3302019,West Heath Primary School,355,19550,11404,8146
330,Birmingham,3302021,Paganel Primary School,328,19280,11247,8033
330,Birmingham,3302024,Birches Green Junior School,223,18230,10634,7596
330,Birmingham,3302025,Birches Green Infant School,116,17160,10010,7150
330,Birmingham,3302026,Banners Gate Primary School,325,19250,11229,8021
330,Birmingham,3302030,Bordesley Green Primary School,598,21980,12822,9158
330,Birmingham,3302040,Cherry Orchard Primary School,373,19730,11509,8221
330,Birmingham,3302053,Colmore Junior School,478,20780,12122,8658
330,Birmingham,3302054,Colmore Infant and Nursery School,240,18400,10733,7667
330,Birmingham,3302055,Cotteridge Primary School,347,19470,11358,8112
330,Birmingham,3302062,Anderton Park Primary School,583,21830,12734,9096
330,Birmingham,3302063,Regents Park Community Primary School,528,21280,12413,8867
330,Birmingham,3302067,Summerfield Junior and Infant School,353,19530,11393,8137
330,Birmingham,3302079,George Dixon Primary School,337,19370,11299,8071
330,Birmingham,3302081,Gilbertstone Primary School,362,19620,11445,8175
330,Birmingham,3302087,Grendon Junior and Infant School (NC),282,18820,10978,7842
330,Birmingham,3302091,Gunter Primary School,178,17780,10372,7408
330,Birmingham,3302092,Hall Green Junior School,478,20780,12122,8658
330,Birmingham,3302093,Hall Green Infant School,240,18400,10733,7667
330,Birmingham,3302097,Story Wood School and Childrens Centre,181,17810,10389,7421
330,Birmingham,3302099,Hawthorn Primary School,177,17770,10366,7404
330,Birmingham,3302108,Ward End Primary School,754,23540,13732,9808
330,Birmingham,3302115,Kingsland Primary School (NC),255,18550,10821,7729
330,Birmingham,3302118,Kings Norton Junior and Infant School,356,19560,11410,8150
330,Birmingham,3302119,Lakey Lane Junior and Infant School,361,19610,11439,8171
330,Birmingham,3302127,Lozells Junior and Infant School and Nursery,362,19620,11445,8175
330,Birmingham,3302128,Lyndon Green Junior School,371,19710,11498,8212
330,Birmingham,3302129,Lyndon Green Infant School,189,17890,10436,7454
330,Birmingham,3302133,Marsh Hill Primary School,353,19530,11393,8137
330,Birmingham,3302142,Nelson Junior and Infant School,316,19160,11177,7983
330,Birmingham,3302149,Paget Primary School,350,19500,11375,8125
330,Birmingham,3302150,Park Hill Primary School,474,20740,12098,8642
330,Birmingham,3302153,Allens Croft Primary School,300,19000,11083,7917
330,Birmingham,3302157,Raddlebarn Primary School,347,19470,11358,8112
330,Birmingham,3302159,Redhill Junior and Infant School,180,17800,10383,7417
330,Birmingham,3302160,Rednal Hill Junior School,331,19310,11264,8046
330,Birmingham,3302161,Rednal Hill Infant School,180,17800,10383,7417
330,Birmingham,3302169,Severne Junior Infant and Nursery School,365,19650,11463,8187
330,Birmingham,3302174,Sladefield Infant School,240,18400,10733,7667
330,Birmingham,3302176,Somerville Primary (NC) School,597,21970,12816,9154
330,Birmingham,3302178,Stanville Primary School,207,18070,10541,7529
330,Birmingham,3302179,Starbank  School,1094,26940,15715,11225
330,Birmingham,3302183,St Benedicts Infant School,218,18180,10605,7575
330,Birmingham,3302184,Stechford Primary School,360,19600,11433,8167
330,Birmingham,3302185,Colebourne Primary School,361,19610,11439,8171
330,Birmingham,3302189,Ladypool Primary School,330,19300,11258,8042
330,Birmingham,3302190,Sundridge Primary School,177,17770,10366,7404
330,Birmingham,3302191,Court Farm Primary School,178,17780,10372,7408
330,Birmingham,3302192,Thornton Primary School,657,22570,13166,9404
330,Birmingham,3302225,Worlds End Junior School,359,19590,11428,8162
330,Birmingham,3302227,Yardley Wood Community Primary School,292,18920,11037,7883
330,Birmingham,3302231,Yorkmead Junior and Infant School,360,19600,11433,8167
330,Birmingham,3302236,Broadmeadow Junior School,224,18240,10640,7600
330,Birmingham,3302238,Broadmeadow Infant School,117,17170,10016,7154
330,Birmingham,3302239,Bellfield Infant School (NC),178,17780,10372,7408
330,Birmingham,3302241,Bellfield Junior School,255,18550,10821,7729
330,Birmingham,3302245,Welsh House Farm Community School and Special Needs Resources Base,186,17860,10418,7442
330,Birmingham,3302246,The Meadows Primary School,497,20970,12233,8737
330,Birmingham,3302251,Chilcote Primary School,359,19590,11428,8162
330,Birmingham,3302254,Blakesley Hall Primary School,535,21350,12454,8896
330,Birmingham,3302276,Wilkes Green Infant School (NC),179,17790,10378,7412
330,Birmingham,3302278,Woodgate Primary School,343,19430,11334,8096
330,Birmingham,3302284,Deykin Avenue Junior and Infant School,180,17800,10383,7417
330,Birmingham,3302288,Hollywood Primary School,370,19700,11492,8208
330,Birmingham,3302289,Cofton Primary School,276,18760,10943,7817
330,Birmingham,3302293,Wilkes Green Junior School,359,19590,11428,8162
330,Birmingham,3302294,Featherstone Primary School,323,19230,11218,8012
330,Birmingham,3302296,Glenmead Primary School,347,19470,11358,8112
330,Birmingham,3302300,Arden Primary School,540,21400,12483,8917
330,Birmingham,3302306,Water Mill Primary School,173,17730,10343,7387
330,Birmingham,3302308,Welford Primary School,363,19630,11451,8179
330,Birmingham,3302312,Chad Vale Primary School,361,19610,11439,8171
330,Birmingham,3302313,Heath Mount Primary School,352,19520,11387,8133
330,Birmingham,3302314,Woodthorpe Junior and Infant School,180,17800,10383,7417
330,Birmingham,3302317,Worlds End Infant and Nursery School,180,17800,10383,7417
330,Birmingham,3302321,Kitwell Primary School and Nursery Class,181,17810,10389,7421
330,Birmingham,3302401,Boldmere Junior School,362,19620,11445,8175
330,Birmingham,3302402,Boldmere Infant School and Nursery,180,17800,10383,7417
330,Birmingham,3302406,Minworth Junior and Infant School,175,17750,10354,7396
330,Birmingham,3302412,Wylde Green Primary School,363,19630,11451,8179
330,Birmingham,3302416,Moor Hall Primary School,213,18130,10576,7554
330,Birmingham,3302420,Maney Hill Primary School,240,18400,10733,7667
330,Birmingham,3302425,Penns Primary School,180,17800,10383,7417
330,Birmingham,3302429,Holland House Infant School and Nursery,120,17200,10033,7167
330,Birmingham,3302435,Benson Community School,453,20530,11976,8554
330,Birmingham,3302436,Osborne Primary School,208,18080,10547,7533
330,Birmingham,3302438,Highters Heath Community School,177,17770,10366,7404
330,Birmingham,3302441,Kingsthorne Primary School,346,19460,11352,8108
330,Birmingham,3302445,Woodcock Hill Primary School,178,17780,10372,7408
330,Birmingham,3302454,Elms Farm Community Primary School,313,19130,11159,7971
330,Birmingham,3302456,Bells Farm Primary School,172,17720,10337,7383
330,Birmingham,3302457,Nelson Mandela School,363,19630,11451,8179
330,Birmingham,3302462,Little Sutton Primary School,360,19600,11433,8167
330,Birmingham,3302464,Coppice Primary School,364,19640,11457,8183
330,Birmingham,3302465,Calshot Primary School,359,19590,11428,8162
330,Birmingham,3302466,Grove School,539,21390,12478,8912
330,Birmingham,3302469,New Hall Primary and Childrens Centre,312,19120,11153,7967
330,Birmingham,3302474,Hollyfield Primary School,354,19540,11398,8142
330,Birmingham,3302477,Harborne Primary School,538,21380,12472,8908
330,Birmingham,3302478,Whitehouse Common Primary School,391,19910,11614,8296
330,Birmingham,3302479,Anglesey Primary School,578,21780,12705,9075
330,Birmingham,3302482,Wattville Primary School,408,20080,11713,8367
330,Birmingham,3302485,Yenton Primary School,399,19990,11661,8329
330,Birmingham,3302486,Forestdale Primary School,178,17780,10372,7408
330,Birmingham,3303002,Christ Church CofE Controlled Primary School and Nursery,180,17800,10383,7417
330,Birmingham,3303003,Moseley Church of England Primary School,183,17830,10401,7429
330,Birmingham,3303010,St James Church of England Primary School Handsworth,361,19610,11439,8171
330,Birmingham,3303016,St Matthews CofE Primary School,176,17760,10360,7400
330,Birmingham,3303019,St Saviours C of E Primary School,351,19510,11381,8129
330,Birmingham,3303025,St Marys Church of England Primary School,328,19280,11247,8033
330,Birmingham,3303302,Saint Barnabas Church of England Primary School,328,19280,11247,8033
330,Birmingham,3303307,St Laurence Church Junior School,360,19600,11433,8167
330,Birmingham,3303310,St Vincents Catholic Primary School,175,17750,10354,7396
330,Birmingham,3303316,Guardian Angels Catholic Primary School,211,18110,10564,7546
330,Birmingham,3303317,Holy Family Catholic Primary School,201,18010,10506,7504
330,Birmingham,3303318,Abbey Catholic Primary School,357,19570,11416,8154
330,Birmingham,3303319,Christ The King Catholic Primary School,317,19170,11183,7987
330,Birmingham,3303320,Corpus Christi Catholic Primary School,358,19580,11422,8158
330,Birmingham,3303321,English Martyrs Catholic Primary School,354,19540,11398,8142
330,Birmingham,3303322,Maryvale Catholic Primary School,175,17750,10354,7396
330,Birmingham,3303323,The Oratory Roman Catholic Primary School,180,17800,10383,7417
330,Birmingham,3303325,The Rosary Catholic Primary School,344,19440,11340,8100
330,Birmingham,3303327,Holy Souls Catholic Primary School,360,19600,11433,8167
330,Birmingham,3303328,Our Lady of Lourdes Catholic Primary School (NC),180,17800,10383,7417
330,Birmingham,3303329,St Augustines Catholic Primary School,175,17750,10354,7396
330,Birmingham,3303331,St Catherine of Siena Catholic Primary School,186,17860,10418,7442
330,Birmingham,3303335,St Annes Catholic Primary School,174,17740,10348,7392
330,Birmingham,3303337,St Chads Catholic Primary School,184,17840,10407,7433
330,Birmingham,3303339,St Josephs Catholic Primary School,173,17730,10343,7387
330,Birmingham,3303342,St Francis Catholic Primary School,359,19590,11428,8162
330,Birmingham,3303344,St Marys Catholic Primary School,361,19610,11439,8171
330,Birmingham,3303346,St Patricks Catholic Primary School,176,17760,10360,7400
330,Birmingham,3303347,St Edmunds Catholic Primary School,180,17800,10383,7417
330,Birmingham,3303349,St Thomas More Catholic Primary School,302,19020,11095,7925
330,Birmingham,3303351,Our Lady and St Rose of Lima Catholic Primary School,182,17820,10395,7425
330,Birmingham,3303352,King David Junior and Infant School,176,17760,10360,7400
330,Birmingham,3303353,Bournville Junior School,382,19820,11562,8258
330,Birmingham,3303354,Bournville Infant School,180,17800,10383,7417
330,Birmingham,3303355,St Edwards Catholic Primary School,347,19470,11358,8112
330,Birmingham,3303357,Our Ladys Catholic Primary School,177,17770,10366,7404
330,Birmingham,3303359,St Wilfrids Catholic Junior and Infant School,322,19220,11212,8008
330,Birmingham,3303360,St John Fisher Catholic Primary School,178,17780,10372,7408
330,Birmingham,3303361,St Margaret Mary RC Junior and Infant School,252,18520,10803,7717
330,Birmingham,3303363,St Dunstans Catholic Primary School,331,19310,11264,8046
330,Birmingham,3303365,St Teresas Catholic Primary School,181,17810,10389,7421
330,Birmingham,3303367,St Gerards RC Junior and Infant School,178,17780,10372,7408
330,Birmingham,3303371,St Laurence Church Infant School,180,17800,10383,7417
330,Birmingham,3303372,St Bernadettes Catholic Primary School,534,21340,12448,8892
330,Birmingham,3303375,St Bernards Catholic Primary School,358,19580,11422,8158
330,Birmingham,3303377,St Judes Catholic Primary School,171,17710,10331,7379
330,Birmingham,3303380,St Ambrose Barlow Catholic Primary School,178,17780,10372,7408
330,Birmingham,3303381,St Albans Catholic Primary School,177,17770,10366,7404
330,Birmingham,3303382,St Martin de Porres Catholic Primary School,175,17750,10354,7396
330,Birmingham,3303383,St Marks Catholic Primary School,180,17800,10383,7417
330,Birmingham,3303385,St Peters Catholic Primary School,180,17800,10383,7417
330,Birmingham,3303386,St Cuthberts RC Junior and Infant (NC) School,180,17800,10383,7417
330,Birmingham,3303406,St Clares Catholic Primary School,361,19610,11439,8171
330,Birmingham,3303409,Sacred Heart Catholic School,190,17900,10442,7458
330,Birmingham,3303410,St John and Monica Catholic Primary School,181,17810,10389,7421
330,Birmingham,3303411,Holly Hill Methodist CofE Infant School,118,17180,10022,7158
330,Birmingham,3303421,Yardley Primary School,719,23190,13528,9662
330,Birmingham,3303428,St Peters CofE Primary School,361,19610,11439,8171
330,Birmingham,3303431,New Oscott Primary School,538,21380,12472,8908
330,Birmingham,3303432,Clifton Primary School,719,23190,13528,9662
330,Birmingham,3303435,Four Oaks Primary School,361,19610,11439,8171
330,Birmingham,3303436,Harper Bell Seventh-day Adventist School,170,17700,10325,7375
330,Birmingham,3304334,Al-Hijrah School,358,19580,11422,8158
330,Birmingham,3305202,Walmley Junior School,361,19610,11439,8171
330,Birmingham,3305203,Walmley Infant School,181,17810,10389,7421
330,Birmingham,3305949,Al-Furqan Primary School,538,21380,12472,8908
330,Birmingham,3307006,Hamilton School,100,17000,9917,7083
330,Birmingham,3307009,Victoria School,84,16840,9823,7017
330,Birmingham,3307012,Longwill A Primary School for Deaf Children,50,16500,9625,6875
330,Birmingham,3307014,Uffculme School,85,16850,9829,7021
330,Birmingham,3307034,Priestley Smith School,24,16240,9473,6767
330,Birmingham,3307035,The Dame Ellen Pinsent School,145,17450,10179,7271
330,Birmingham,3307037,Skilts School,81,16810,9806,7004
330,Birmingham,3307040,Mayfield School,116,17160,10010,7150
330,Birmingham,3307045,The Pines Special School,115,17150,10004,7146
330,Birmingham,3307047,Springfield House Community Special School,96,16960,9893,7067
330,Birmingham,3307051,Cherry Oak School,105,17050,9946,7104
330,Birmingham,3307052,Beaufort School,59,16590,9678,6912
330,Birmingham,3307060,Langley School,114,17140,9998,7142
330,Birmingham,3307062,Lindsworth School,10,10000,5833,4167
331,Coventry,3311107,Hospital Education Service,8,8000,4667,3333
331,Coventry,3312000,Aldermans Green Community Primary School,446,20460,11935,8525
331,Coventry,3312001,Christ The King Catholic Primary School,362,19620,11445,8175
331,Coventry,3312008,Hollyfast Primary School,444,20440,11923,8517
331,Coventry,3312013,Earlsdon Primary School,352,19520,11387,8133
331,Coventry,3312015,Edgewick Community Primary School,242,18420,10745,7675
331,Coventry,3312021,Gosford Park Primary School,353,19530,11393,8137
331,Coventry,3312037,Little Heath Primary School,236,18360,10710,7650
331,Coventry,3312054,St Christopher Primary School,348,19480,11363,8117
331,Coventry,3312068,Whitley Abbey Primary School,255,18550,10821,7729
331,Coventry,3312076,Allesley Hall Primary School,173,17730,10343,7387
331,Coventry,3312078,Ernesford Grange Primary School,401,20010,11673,8337
331,Coventry,3312079,Potters Green Primary School,329,19290,11253,8037
331,Coventry,3312084,Allesley Primary School,344,19440,11340,8100
331,Coventry,3312091,Grangehurst Primary School,345,19450,11346,8104
331,Coventry,3312092,Grange Farm Primary School,332,19320,11270,8050
331,Coventry,3312095,Eastern Green Junior School,236,18360,10710,7650
331,Coventry,3312101,Park Hill Primary School,312,19120,11153,7967
331,Coventry,3312107,Cannon Park Primary School,156,17560,10243,7317
331,Coventry,3312117,Pearl Hyde Community Primary School,241,18410,10739,7671
331,Coventry,3312118,Sowe Valley Primary School,172,17720,10337,7383
331,Coventry,3312121,Joseph Cash Primary School,350,19500,11375,8125
331,Coventry,3312122,Whoberley Hall Primary School,152,17520,10220,7300
331,Coventry,3312125,Holbrook Primary School,531,21310,12431,8879
331,Coventry,3312129,Stoke Primary School,349,19490,11369,8121
331,Coventry,3312130,Coundon Primary School,438,20380,11888,8492
331,Coventry,3312131,Aldermoor Farm Primary School,419,20190,11778,8412
331,Coventry,3312132,Ravensdale Primary School,359,19590,11428,8162
331,Coventry,3312135,Whitmore Park Primary School,539,21390,12478,8912
331,Coventry,3312136,Stivichall Primary School,448,20480,11947,8533
331,Coventry,3312140,John Gulson Primary School,501,21010,12256,8754
331,Coventry,3312141,Manor Park Primary School,534,21340,12448,8892
331,Coventry,3312142,Templars Primary School,468,20680,12063,8617
331,Coventry,3312145,Frederick Bird Primary School,665,22650,13213,9437
331,Coventry,3312146,Wyken Croft Primary School,616,22160,12927,9233
331,Coventry,3312147,Moseley Primary School,390,19900,11608,8292
331,Coventry,3312149,Broad Heath Community Primary School,510,21100,12308,8792
331,Coventry,3312150,Longford Park Primary School,182,17820,10395,7425
331,Coventry,3312151,John Shelton Community Primary School,174,17740,10348,7392
331,Coventry,3312152,Stoke Heath Primary School,361,19610,11439,8171
331,Coventry,3312153,Southfields Primary School,332,19320,11270,8050
331,Coventry,3312154,Mount Nod Primary School,253,18530,10809,7721
331,Coventry,3312155,Spon Gate Primary School,287,18870,11008,7862
331,Coventry,3312156,Henley Green Primary,324,19240,11223,8017
331,Coventry,3312157,Limbrick Wood Primary School,148,17480,10197,7283
331,Coventry,3312158,Moat House Primary School,327,19270,11241,8029
331,Coventry,3313008,All Saints Church of England Primary School,171,17710,10331,7379
331,Coventry,3313009,St Andrews Church of England Infant School,115,17150,10004,7146
331,Coventry,3313010,St Mary and St Benedict Catholic Primary School,267,18670,10891,7779
331,Coventry,3313405,St Elizabeths Catholic Primary School Foleshill,178,17780,10372,7408
331,Coventry,3313406,St Osburgs Catholic Primary School,176,17760,10360,7400
331,Coventry,3313408,Our Lady of the Assumption Catholic Primary School,178,17780,10372,7408
331,Coventry,3313412,St John Vianney Catholic Primary School,179,17790,10378,7412
331,Coventry,3313418,St Annes Catholic Primary School,171,17710,10331,7379
331,Coventry,3313422,St Augustines Catholic Primary School,338,19380,11305,8075
331,Coventry,3313432,St Thomas More Catholic Primary School,350,19500,11375,8125
331,Coventry,3313433,All Souls Catholic Primary School,179,17790,10378,7412
331,Coventry,3313435,Holy Family Catholic Primary School,360,19600,11433,8167
331,Coventry,3313436,Charter Primary School,204,18040,10523,7517
331,Coventry,3313437,Howes Community Primary School,163,17630,10284,7346
331,Coventry,3313438,Willenhall Community Primary School,351,19510,11381,8129
331,Coventry,3317009,Sherbourne Fields School,40,16400,9567,6833
331,Coventry,3317017,Tiverton School,56,16560,9660,6900
331,Coventry,3317021,Woodfield,47,16470,9608,6862
331,Coventry,3317024,Castle Wood Special School,126,17260,10068,7192
331,Coventry,3317022,Corley Centre,2,2000,1167,833
332,Dudley,3321104,Sycamore Short Stay School,11,11000,6417,4583
332,Dudley,3322000,Blowers Green Primary School,178,17780,10372,7408
332,Dudley,3322012,Northfield Road Primary School,341,19410,11323,8087
332,Dudley,3322023,Brierley Hill Primary School,172,17720,10337,7383
332,Dudley,3322024,Brockmoor Primary School,314,19140,11165,7975
332,Dudley,3322029,Brook Primary School,318,19180,11188,7992
332,Dudley,3322035,Maidensbridge Primary School,171,17710,10331,7379
332,Dudley,3322036,Mount Pleasant Primary School,291,18910,11031,7879
332,Dudley,3322043,Dawley Brook Primary School,169,17690,10319,7371
332,Dudley,3322048,Wallbrook Primary School,239,18390,10728,7662
332,Dudley,3322052,Red Hall Primary School,267,18670,10891,7779
332,Dudley,3322063,Fairhaven Primary School,267,18670,10891,7779
332,Dudley,3322067,Thorns Primary School,172,17720,10337,7383
332,Dudley,3322068,Foxyards Primary School,263,18630,10868,7762
332,Dudley,3322072,Crestwood Park Primary School,179,17790,10378,7412
332,Dudley,3322075,Peters Hill Primary School,703,23030,13434,9596
332,Dudley,3322077,Blanford Mere Primary School,191,17910,10448,7462
332,Dudley,3322109,Greenfield Primary School,240,18400,10733,7667
332,Dudley,3322111,Wollescote Primary School,342,19420,11328,8092
332,Dudley,3322112,Caslon Primary Community  School,178,17780,10372,7408
332,Dudley,3322116,Huntingtree Primary School,344,19440,11340,8100
332,Dudley,3322118,Rufford Primary School,171,17710,10331,7379
332,Dudley,3322122,The Ridge Primary School,176,17760,10360,7400
332,Dudley,3322123,Amblecote Primary School,254,18540,10815,7725
332,Dudley,3322124,Hurst Green Primary School,359,19590,11428,8162
332,Dudley,3322125,Ham Dingle Primary School,336,19360,11293,8067
332,Dudley,3322126,Withymoor Primary School,345,19450,11346,8104
332,Dudley,3322130,Cotwall End Primary School,337,19370,11299,8071
332,Dudley,3322136,Russells Hall Primary School,349,19490,11369,8121
332,Dudley,3322137,Howley Grange Primary School,362,19620,11445,8175
332,Dudley,3322138,Newfield Park Primary School,390,19900,11608,8292
332,Dudley,3322141,Ashwood Park Primary School,234,18340,10698,7642
332,Dudley,3322142,Bromley Hills Primary School,248,18480,10780,7700
332,Dudley,3322143,Hawbush Primary School,152,17520,10220,7300
332,Dudley,3322144,Roberts Primary School,536,21360,12460,8900
332,Dudley,3322145,Gig Mill Primary School,510,21100,12308,8792
332,Dudley,3322146,Wrens Nest Primary School,360,19600,11433,8167
332,Dudley,3322149,Queen Victoria Primary School,491,20910,12198,8712
332,Dudley,3322150,Straits Primary School,319,19190,11194,7996
332,Dudley,3322151,Belle Vue Primary School,342,19420,11328,8092
332,Dudley,3322152,Dingle Community Primary School,147,17470,10191,7279
332,Dudley,3322153,Quarry Bank Primary School,259,18590,10844,7746
332,Dudley,3322155,Glynne Primary School,359,19590,11428,8162
332,Dudley,3322160,Milking Bank Primary School,360,19600,11433,8167
332,Dudley,3323007,Church of the Ascension CofE Primary School,270,18700,10908,7792
332,Dudley,3323008,St Marks CofE Primary School,238,18380,10722,7658
332,Dudley,3323009,St Marys CofE (VC) Primary School,178,17780,10372,7408
332,Dudley,3323010,Christ Church CofE Primary School,446,20460,11935,8525
332,Dudley,3323050,Oldswinford C of E Primary School,359,19590,11428,8162
332,Dudley,3323052,St Margarets At Hasbury CofE Primary School,188,17880,10430,7450
332,Dudley,3323306,Jessons CofE Primary School (VA),488,20880,12180,8700
332,Dudley,3323350,Cradley CofE Primary School,182,17820,10395,7425
332,Dudley,3323352,Halesowen CofE Primary School,172,17720,10337,7383
332,Dudley,3323354,Pedmore CE Primary School,189,17890,10436,7454
332,Dudley,3323357,Our Lady and St Kenelm RC School,180,17800,10383,7417
332,Dudley,3323358,St Jamess CofE Primary School,331,19310,11264,8046
332,Dudley,3325200,Alder Coppice Primary School,361,19610,11439,8171
332,Dudley,3327002,The Brier School,75,16750,9771,6979
332,Dudley,3327003,The Woodsetton School,92,16920,9870,7050
332,Dudley,3327004,The Old Park School,66,16660,9718,6942
332,Dudley,3327005,Halesbury School,66,16660,9718,6942
332,Dudley,3327009,Pens Meadow School,35,16350,9538,6812
333,Sandwell,3331106,The Primrose Centre,20,16200,9450,6750
333,Sandwell,3332015,Hamstead Junior School,242,18420,10745,7675
333,Sandwell,3332016,Hamstead Infant School,115,17150,10004,7146
333,Sandwell,3332041,Hargate Primary School,335,19350,11288,8062
333,Sandwell,3332042,Albert Pritchard Infant School,177,17770,10366,7404
333,Sandwell,3332046,Moorlands Primary School,180,17800,10383,7417
333,Sandwell,3332047,Old Park Primary School,392,19920,11620,8300
333,Sandwell,3332048,Park Hill Primary School,187,17870,10424,7446
333,Sandwell,3332051,Wood Green Junior School,241,18410,10739,7671
333,Sandwell,3332054,Burnt Tree Primary School,287,18870,11008,7862
333,Sandwell,3332056,Great Bridge Primary School,387,19870,11591,8279
333,Sandwell,3332060,Ocker Hill Infant School,118,17180,10022,7158
333,Sandwell,3332070,Whitecrest Primary School,182,17820,10395,7425
333,Sandwell,3332072,Eaton Valley Primary School,356,19560,11410,8150
333,Sandwell,3332074,Newtown Primary School,178,17780,10372,7408
333,Sandwell,3332075,Glebefields Primary School,346,19460,11352,8108
333,Sandwell,3332082,Tipton Green Junior School,358,19580,11422,8158
333,Sandwell,3332101,Abbey Junior School,363,19630,11451,8179
333,Sandwell,3332102,Abbey Infant School,183,17830,10401,7429
333,Sandwell,3332104,Annie Lennard Primary School,214,18140,10582,7558
333,Sandwell,3332105,Bearwood Primary School,362,19620,11445,8175
333,Sandwell,3332108,Bleakhouse Junior School,238,18380,10722,7658
333,Sandwell,3332112,Brickhouse Primary School,175,17750,10354,7396
333,Sandwell,3332113,Cape Primary School,541,21410,12489,8921
333,Sandwell,3332123,Crocketts Community Primary School,353,19530,11393,8137
333,Sandwell,3332127,Grace Mary Primary School,199,17990,10494,7496
333,Sandwell,3332128,Highfields Primary School,356,19560,11410,8150
333,Sandwell,3332133,Lightwoods Primary School,216,18160,10593,7567
333,Sandwell,3332134,Moat Farm Junior School,484,20840,12157,8683
333,Sandwell,3332135,Moat Farm Infant School,241,18410,10739,7671
333,Sandwell,3332136,Oakham Primary School,362,19620,11445,8175
333,Sandwell,3332138,Old Hill Primary School,181,17810,10389,7421
333,Sandwell,3332140,Perryfields Primary School,299,18990,11078,7912
333,Sandwell,3332141,Reddal Hill Primary School,306,19060,11118,7942
333,Sandwell,3332146,Rowley Hall Primary School,503,21030,12268,8762
333,Sandwell,3332148,Temple Meadow Primary School,328,19280,11247,8033
333,Sandwell,3332151,Tividale Hall Primary School,359,19590,11428,8162
333,Sandwell,3332154,Warley Infant School,121,17210,10039,7171
333,Sandwell,3332162,Lyng Primary School,363,19630,11451,8179
333,Sandwell,3332163,Lodge Primary School,362,19620,11445,8175
333,Sandwell,3332164,Joseph Turner Primary School,344,19440,11340,8100
333,Sandwell,3332166,Grove Vale Primary School,363,19630,11451,8179
333,Sandwell,3332169,Yew Tree Primary School,474,20740,12098,8642
333,Sandwell,3332171,Brandhall Primary School,354,19540,11398,8142
333,Sandwell,3332172,Hall Green Primary School,354,19540,11398,8142
333,Sandwell,3332173,Langley Primary School,359,19590,11428,8162
333,Sandwell,3332174,Ryders Green Primary School,357,19570,11416,8154
333,Sandwell,3332175,Rounds Green Primary School,346,19460,11352,8108
333,Sandwell,3332176,Blackheath Primary School,386,19860,11585,8275
333,Sandwell,3332177,Ferndale Primary School,461,20610,12023,8587
333,Sandwell,3332178,Causeway Green Primary School,353,19530,11393,8137
333,Sandwell,3332179,Rood End Primary School,392,19920,11620,8300
333,Sandwell,3332180,Uplands Manor Primary School,753,23530,13726,9804
333,Sandwell,3332181,Hanbury Primary School,364,19640,11457,8183
333,Sandwell,3332182,King George V Primary School,183,17830,10401,7429
333,Sandwell,3332183,The Priory Primary School,210,18100,10558,7542
333,Sandwell,3332186,Harvills Hawthorn Primary School,389,19890,11603,8287
333,Sandwell,3332188,Hateley Heath Primary School,354,19540,11398,8142
333,Sandwell,3332189,Springfield Primary School,350,19500,11375,8125
333,Sandwell,3333002,Holy Trinity CofE Primary School,343,19430,11334,8096
333,Sandwell,3333003,St Martins CofE Primary School,182,17820,10395,7425
333,Sandwell,3333005,St Mary Magdalene CofE Voluntary Controlled Primary School,182,17820,10395,7425
333,Sandwell,3333006,St James CofE Primary School,374,19740,11515,8225
333,Sandwell,3333007,Tividale Community Primary School,361,19610,11439,8171
333,Sandwell,3333301,All Saints CofE Primary School,310,19100,11142,7958
333,Sandwell,3333303,St John Bosco Catholic Primary School,186,17860,10418,7442
333,Sandwell,3333305,St Marys Catholic Primary School,185,17850,10413,7437
333,Sandwell,3333307,St Margarets CofE Primary School,180,17800,10383,7417
333,Sandwell,3333308,Holy Name Catholic Primary School,178,17780,10372,7408
333,Sandwell,3333400,Christ Church CofE Primary School,332,19320,11270,8050
333,Sandwell,3333403,St Matthews CofE Primary School,186,17860,10418,7442
333,Sandwell,3333406,Sacred Heart Primary School,201,18010,10506,7504
333,Sandwell,3333408,Pennyhill Primary School,557,21570,12583,8987
333,Sandwell,3333409,Galton Valley Primary School,393,19930,11626,8304
333,Sandwell,3337001,Shenstone Lodge School,29,16290,9503,6787
333,Sandwell,3337018,The Orchard School,132,17320,10103,7217
333,Sandwell,3337019,The Westminster School,21,16210,9456,6754
333,Sandwell,3337017,The Meadows School,5,5000,2917,2083
334,Solihull,3341105,Auckland Education Centre,5,5000,2917,2083
334,Solihull,3342000,Blossomfield Infant and Nursery School,180,17800,10383,7417
334,Solihull,3342001,Burman Infant School,125,17250,10063,7187
334,Solihull,3342004,Coppice Junior School,227,18270,10658,7612
334,Solihull,3342005,Cranmore Infant School,119,17190,10028,7162
334,Solihull,3342008,Dorridge Primary School,528,21280,12413,8867
334,Solihull,3342011,Haslucks Green School,227,18270,10658,7612
334,Solihull,3342013,Kineton Green Primary School,169,17690,10319,7371
334,Solihull,3342017,Sharmans Cross Junior School,359,19590,11428,8162
334,Solihull,3342019,Shirley Heath Junior School,359,19590,11428,8162
334,Solihull,3342024,Valley Primary,535,21350,12454,8896
334,Solihull,3342026,Woodlands Infant School,122,17220,10045,7175
334,Solihull,3342028,Widney Junior School,251,18510,10798,7712
334,Solihull,3342030,Oak Cottage Primary School,180,17800,10383,7417
334,Solihull,3342031,Mill Lodge Primary School,180,17800,10383,7417
334,Solihull,3342033,Yew Tree Primary School,174,17740,10348,7392
334,Solihull,3342051,Marston Green Junior School,356,19560,11410,8150
334,Solihull,3342058,Tidbury Green School,206,18060,10535,7525
334,Solihull,3342059,Castle Bromwich Junior School,474,20740,12098,8642
334,Solihull,3342060,Castle Bromwich Infant and Nursery School,240,18400,10733,7667
334,Solihull,3342065,Coleshill Heath School,381,19810,11556,8254
334,Solihull,3342066,Windy Arbor Primary School,331,19310,11264,8046
334,Solihull,3342082,Cheswick Green Primary School,180,17800,10383,7417
334,Solihull,3342085,Peterbrook Primary School,358,19580,11422,8158
334,Solihull,3342087,Chapel Fields Junior School,433,20330,11859,8471
334,Solihull,3342088,Yorkswood Primary School,392,19920,11620,8300
334,Solihull,3342089,Ulverley School,360,19600,11433,8167
334,Solihull,3342090,Greswold Primary School,422,20220,11795,8425
334,Solihull,3342091,Langley Primary School,352,19520,11387,8133
334,Solihull,3342096,Monkspath Junior and Infant School,536,21360,12460,8900
334,Solihull,3342098,Dickens Heath Community Primary School,347,19470,11358,8112
334,Solihull,3343010,Meriden Church of England Primary School,171,17710,10331,7379
334,Solihull,3343302,St Alphege Church of England Infant and Nursery School,151,17510,10214,7296
334,Solihull,3343305,St Alphege Church of England Junior School,280,18800,10967,7833
334,Solihull,3343310,Berkswell Church of England Voluntary Aided Primary School,174,17740,10348,7392
334,Solihull,3343311,George Fentham Endowed School,170,17700,10325,7375
334,Solihull,3343312,Lady Katherine Leveson Church of England Primary School,154,17540,10232,7308
334,Solihull,3343314,St Mary and St Margarets Church of England Aided Primary School,190,17900,10442,7458
334,Solihull,3343500,Our Lady of the Wayside Catholic Primary School,367,19670,11474,8196
334,Solihull,3343501,St Andrews Catholic Primary School,178,17780,10372,7408
334,Solihull,3343502,St Augustines Catholic Primary School,183,17830,10401,7429
334,Solihull,3343503,St George and St Teresa Catholic Primary School,189,17890,10436,7454
334,Solihull,3343504,Our Lady of Compassion Catholic Primary School,259,18590,10844,7746
334,Solihull,3343510,St Anthonys Catholic Primary School,177,17770,10366,7404
334,Solihull,3343511,St Annes Catholic Primary School,358,19580,11422,8158
334,Solihull,3343512,Bishop Wilson Church of England Primary School,342,19420,11328,8092
334,Solihull,3343516,St John the Baptist Catholic Primary School,170,17700,10325,7375
334,Solihull,3343517,Kingshurst Primary School,400,20000,11667,8333
334,Solihull,3345200,Fordbridge Community Primary School,370,19700,11492,8208
334,Solihull,3347001,Hazel Oak School,57,16570,9666,6904
334,Solihull,3347002,Reynalds Cross School,56,16560,9660,6900
334,Solihull,3347005,Forest Oak School,48,16480,9613,6867
334,Solihull,3347007,Merstone School,40,16400,9567,6833
335,Walsall,3351104,New Leaf Centre,27,16270,9491,6779
335,Walsall,3352000,Alumwell Junior School,361,19610,11439,8171
335,Walsall,3352001,Alumwell Infant School,180,17800,10383,7417
335,Walsall,3352002,Blakenall Heath Junior School,234,18340,10698,7642
335,Walsall,3352003,Sunshine Infant and Nursery School,118,17180,10022,7158
335,Walsall,3352004,Busill Jones Primary School,251,18510,10798,7712
335,Walsall,3352006,Butts Primary School,180,17800,10383,7417
335,Walsall,3352012,Delves Infant School,180,17800,10383,7417
335,Walsall,3352016,Elmore Green Primary School,275,18750,10938,7812
335,Walsall,3352024,Leamore Primary School,179,17790,10378,7412
335,Walsall,3352028,Palfrey Junior School,359,19590,11428,8162
335,Walsall,3352030,Palfrey Infant School,181,17810,10389,7421
335,Walsall,3352031,Whitehall Junior Community School,354,19540,11398,8142
335,Walsall,3352032,Whitehall Nursery and Infant School,178,17780,10372,7408
335,Walsall,3352041,Abbey Primary School,179,17790,10378,7412
335,Walsall,3352042,Lower Farm Primary School,347,19470,11358,8112
335,Walsall,3352043,Delves Junior School,357,19570,11416,8154
335,Walsall,3352101,Bentley West Primary School Additionally Resourced for Hearing Impaired,355,19550,11404,8146
335,Walsall,3352102,King Charles Primary School,334,19340,11282,8058
335,Walsall,3352103,Pinfold Street Primary School,354,19540,11398,8142
335,Walsall,3352105,Salisbury Primary School,263,18630,10868,7762
335,Walsall,3352106,Kings Hill Primary School,274,18740,10932,7808
335,Walsall,3352114,New Invention Infant School,180,17800,10383,7417
335,Walsall,3352116,Short Heath Junior School,239,18390,10728,7662
335,Walsall,3352117,County Bridge Primary School,180,17800,10383,7417
335,Walsall,3352119,Pool Hayes Primary School,177,17770,10366,7404
335,Walsall,3352122,New Invention Junior School,360,19600,11433,8167
335,Walsall,3352205,Rushall Primary School,195,17950,10471,7479
335,Walsall,3352214,Whetstone Field Primary School,184,17840,10407,7433
335,Walsall,3352218,Walsall Wood School,183,17830,10401,7429
335,Walsall,3352219,Watling Street Primary School,179,17790,10378,7412
335,Walsall,3352220,Millfield Primary School,178,17780,10372,7408
335,Walsall,3352222,Castlefort Junior Mixed and Infant School,177,17770,10366,7404
335,Walsall,3352225,Brownhills West Primary School,159,17590,10261,7329
335,Walsall,3352228,Radleys Primary School,182,17820,10395,7425
335,Walsall,3352234,Blackwood School,542,21420,12495,8925
335,Walsall,3352235,Lindens Primary School,374,19740,11515,8225
335,Walsall,3352237,Pelsall Village School,276,18760,10943,7817
335,Walsall,3352239,Greenfield Primary School,195,17950,10471,7479
335,Walsall,3352240,Meadow View JMI School,341,19410,11323,8087
335,Walsall,3352245,Leighswood School,448,20480,11947,8533
335,Walsall,3352246,Hillary Primary School,528,21280,12413,8867
335,Walsall,3352247,Beacon Primary School,297,18970,11066,7904
335,Walsall,3352248,St James Primary School,171,17710,10331,7379
335,Walsall,3352249,Cooper and Jordan Church of England Primary School,371,19710,11498,8212
335,Walsall,3352250,Chuckery Primary School,358,19580,11422,8158
335,Walsall,3353000,Christ Church CofE Primary School,227,18270,10658,7612
335,Walsall,3353003,Little Bloxwich CofE VC Primary School,181,17810,10389,7421
335,Walsall,3353010,Holy Trinity Church of England Primary School,183,17830,10401,7429
335,Walsall,3353100,Old Church Church of England C Primary School,271,18710,10914,7796
335,Walsall,3353101,Rosedale Church of England C Infant School,121,17210,10039,7171
335,Walsall,3353102,St Giles Church of England Primary School,282,18820,10978,7842
335,Walsall,3353110,St Michaels Church of England C Primary School,274,18740,10932,7808
335,Walsall,3353111,St Johns Church of England Primary School,272,18720,10920,7800
335,Walsall,3353300,Blue Coat Church of England Aided Junior School,358,19580,11422,8158
335,Walsall,3353301,Blue Coat Church of England Aided Infant School,181,17810,10389,7421
335,Walsall,3353302,St Marys The Mount Catholic Primary School,180,17800,10383,7417
335,Walsall,3353304,St Patricks Catholic Primary School Walsall,182,17820,10395,7425
335,Walsall,3353306,St Peters Catholic Primary School Bloxwich,175,17750,10354,7396
335,Walsall,3353310,St Josephs Catholic Primary School Darlaston,179,17790,10378,7412
335,Walsall,3353312,St Thomas of Canterbury Catholic Primary School,219,18190,10611,7579
335,Walsall,3353322,St Francis Catholic Primary School,171,17710,10331,7379
335,Walsall,3353323,St Mary of the Angels Catholic Primary School,180,17800,10383,7417
335,Walsall,3353324,St Annes Catholic Primary School Streetly,177,17770,10366,7404
335,Walsall,3353325,St Bernadettes Catholic Primary School,168,17680,10313,7367
335,Walsall,3353327,Moorcroft Wood Primary School,182,17820,10395,7425
335,Walsall,3353329,Barcroft Primary School,362,19620,11445,8175
335,Walsall,3355202,Manor Primary School,266,18660,10885,7775
335,Walsall,3355203,Pheasey Park Farm Primary School,480,20800,12133,8667
335,Walsall,3357002,Castle Business and Enterprise College,30,16300,9508,6792
335,Walsall,3357004,The Jane Lane School  A College for Cognition & Learning,33,16330,9526,6804
335,Walsall,3357007,Old Hall School,75,16750,9771,6979
335,Walsall,3357011,Oakwood School,67,16670,9724,6946
336,Wolverhampton,3362003,Bushbury Hill Primary School,235,18350,10704,7646
336,Wolverhampton,3362015,Fallings Park Primary School,463,20630,12034,8596
336,Wolverhampton,3362022,Whitgreave Primary School,359,19590,11428,8162
336,Wolverhampton,3362030,Graiseley Primary School,180,17800,10383,7417
336,Wolverhampton,3362032,Springdale Primary  School,374,19740,11515,8225
336,Wolverhampton,3362034,Rakegate Primary School,358,19580,11422,8158
336,Wolverhampton,3362042,Claregate Primary School,351,19510,11381,8129
336,Wolverhampton,3362043,Castlecroft Primary School,193,17930,10459,7471
336,Wolverhampton,3362044,Westacre Infant School,178,17780,10372,7408
336,Wolverhampton,3362051,Loxdale Primary School,236,18360,10710,7650
336,Wolverhampton,3362053,Stowlawn Primary School,213,18130,10576,7554
336,Wolverhampton,3362058,Long Knowle Primary School,178,17780,10372,7408
336,Wolverhampton,3362065,Wood End Primary School,178,17780,10372,7408
336,Wolverhampton,3362066,Stow Heath Primary School,363,19630,11451,8179
336,Wolverhampton,3362069,Wilkinson Primary School,366,19660,11468,8192
336,Wolverhampton,3362071,Lanesfield Primary School,282,18820,10978,7842
336,Wolverhampton,3362074,Spring Vale Primary School,182,17820,10395,7425
336,Wolverhampton,3362079,Uplands Junior School,376,19760,11527,8233
336,Wolverhampton,3362089,Merridale Primary School,177,17770,10366,7404
336,Wolverhampton,3362102,Oak Meadow Primary School,356,19560,11410,8150
336,Wolverhampton,3362103,Eastfield Primary School,321,19210,11206,8004
336,Wolverhampton,3362105,Warstones Primary School,351,19510,11381,8129
336,Wolverhampton,3362106,Wodensfield Primary School,360,19600,11433,8167
336,Wolverhampton,3362111,Dovecotes Primary School,226,18260,10652,7608
336,Wolverhampton,3362116,West Park Primary School,255,18550,10821,7729
336,Wolverhampton,3362117,Bantock Primary School,334,19340,11282,8058
336,Wolverhampton,3362118,St Andrews Church of England Primary School,335,19350,11288,8062
336,Wolverhampton,3363012,Christ Church (Church of England) Infant and Nursery School,119,17190,10028,7162
336,Wolverhampton,3363019,Christ Church (Church of England) Junior School,243,18430,10751,7679
336,Wolverhampton,3363024,Bilston Church of England Primary School,328,19280,11247,8033
336,Wolverhampton,3363301,St Lukes Church of England Aided Primary School,366,19660,11468,8192
336,Wolverhampton,3363303,St Anthonys Catholic Primary School,265,18650,10879,7771
336,Wolverhampton,3363309,Holy Trinity Catholic Primary School,198,17980,10488,7492
336,Wolverhampton,3363312,St Patricks Catholic Primary School Wednesfield,174,17740,10348,7392
336,Wolverhampton,3363314,St Pauls Church of England Aided Primary School,180,17800,10383,7417
336,Wolverhampton,3363316,St Michaels Church of England Aided Primary School,172,17720,10337,7383
336,Wolverhampton,3367004,Penn Fields School,53,16530,9643,6887
336,Wolverhampton,3367007,Tettenhall Wood School,60,16600,9683,6917
336,Wolverhampton,3367008,Green Park School,60,16600,9683,6917
336,Wolverhampton,3367012,Penn Hall School,34,16340,9532,6808
340,Knowsley,3401100,Meadow Park School,13,13000,7583,5417
340,Knowsley,3402002,Roby Park Primary School,150,17500,10208,7292
340,Knowsley,3402007,Knowsley Village School,149,17490,10203,7287
340,Knowsley,3402010,Prescot Primary School,334,19340,11282,8058
340,Knowsley,3402013,Malvern Primary School,345,19450,11346,8104
340,Knowsley,3402015,Park Brow Community Primary School,338,19380,11305,8075
340,Knowsley,3402017,Westvale Primary School,160,17600,10267,7333
340,Knowsley,3402018,Millbrook Community Primary School,208,18080,10547,7533
340,Knowsley,3402039,Plantation Primary School,438,20380,11888,8492
340,Knowsley,3402048,Ravenscroft Community Primary School,157,17570,10249,7321
340,Knowsley,3402050,Evelyn Community Primary School,195,17950,10471,7479
340,Knowsley,3402051,Eastcroft Park School,157,17570,10249,7321
340,Knowsley,3403000,Kirkby CofE Primary School,209,18090,10553,7537
340,Knowsley,3403304,St Gabriels CofE Primary School,164,17640,10290,7350
340,Knowsley,3403306,St Mary and St Pauls CofE Primary School,148,17480,10197,7283
340,Knowsley,3403307,Holy Family Catholic Primary School,182,17820,10395,7425
340,Knowsley,3403314,Our Ladys Catholic Primary School,176,17760,10360,7400
340,Knowsley,3403315,St Lukes Catholic Primary School,164,17640,10290,7350
340,Knowsley,3403316,St Laurences Catholic Primary School,297,18970,11066,7904
340,Knowsley,3403318,St Aidans Catholic Primary School,167,17670,10308,7362
340,Knowsley,3403319,St Michael and All Angels Catholic Primary School,303,19030,11101,7929
340,Knowsley,3403322,St Maries Catholic Primary School,212,18120,10570,7550
340,Knowsley,3403325,St Alberts Catholic Primary School,159,17590,10261,7329
340,Knowsley,3403326,Holy Family Catholic Primary School,248,18480,10780,7700
340,Knowsley,3403327,St Marks Catholic Primary School,170,17700,10325,7375
340,Knowsley,3403328,St Andrew the Apostle Catholic Primary School,176,17760,10360,7400
340,Knowsley,3403340,St Josephs Catholic Primary School,175,17750,10354,7396
340,Knowsley,3403344,St Brigids Catholic Primary School,158,17580,10255,7325
340,Knowsley,3403350,St Leos and Southmead Catholic Primary School Serving the Community,157,17570,10249,7321
340,Knowsley,3403352,St John Fisher Catholic Primary School,167,17670,10308,7362
340,Knowsley,3403353,St Annes Catholic Primary School,243,18430,10751,7679
340,Knowsley,3403356,Saints Peter and Paul Catholic Primary School,247,18470,10774,7696
340,Knowsley,3403357,St Columbas Catholic Primary School,162,17620,10278,7342
340,Knowsley,3403358,St Margaret Marys Catholic Infant School,240,18400,10733,7667
340,Knowsley,3403359,St Margaret Marys Catholic Junior School,455,20550,11988,8562
340,Knowsley,3403360,St Aloysius Catholic Primary School,264,18640,10873,7767
340,Knowsley,3403361,St Joseph the Worker Catholic Primary School,175,17750,10354,7396
340,Knowsley,3403363,Hope Primary School - A Joint Catholic and Church of England Primary School,263,18630,10868,7762
340,Knowsley,3403364,Northwood Community Primary School (With Designated Special Provision),374,19740,11515,8225
340,Knowsley,3403365,Stockbridge Village Primary School,172,17720,10337,7383
340,Knowsley,3407005,Bluebell Park School,80,16800,9800,7000
340,Knowsley,3407015,Knowsley Central School,60,16600,9683,6917
341,Liverpool,3412001,Childwall Valley Primary School,152,17520,10220,7300
341,Liverpool,3412004,St Margarets Anfield Church of England Primary School,353,19530,11393,8137
341,Liverpool,3412006,All Saints Catholic Voluntary Aided Primary School,359,19590,11428,8162
341,Liverpool,3412007,Mosspits Lane Primary School,351,19510,11381,8129
341,Liverpool,3412008,Banks Road Primary School,213,18130,10576,7554
341,Liverpool,3412009,Woolton Primary School,524,21240,12390,8850
341,Liverpool,3412010,Barlows Primary School,356,19560,11410,8150
341,Liverpool,3412011,Rudston Primary School,353,19530,11393,8137
341,Liverpool,3412014,Belle Vale Community Primary School,176,17760,10360,7400
341,Liverpool,3412017,Blackmoor Park Junior School,365,19650,11463,8187
341,Liverpool,3412018,Anfield Road Primary School,474,20740,12098,8642
341,Liverpool,3412019,Booker Avenue Junior School,360,19600,11433,8167
341,Liverpool,3412025,Blessed Sacrament Catholic Primary School,643,22430,13084,9346
341,Liverpool,3412034,Rice Lane Primary School,529,21290,12419,8871
341,Liverpool,3412036,Dovedale Community Primary School,600,22000,12833,9167
341,Liverpool,3412037,St Oswalds Catholic Primary School,495,20950,12221,8729
341,Liverpool,3412039,Corinthian Community Primary School,336,19360,11293,8067
341,Liverpool,3412063,Gilmour Junior School,232,18320,10687,7633
341,Liverpool,3412064,Gilmour (Southbank) Infant School,180,17800,10383,7417
341,Liverpool,3412065,Springwood Heath Primary School,213,18130,10576,7554
341,Liverpool,3412084,Hunts Cross Primary School,219,18190,10611,7579
341,Liverpool,3412086,Knotty Ash Primary School,189,17890,10436,7454
341,Liverpool,3412092,Lister Junior School,218,18180,10605,7575
341,Liverpool,3412093,Lister Infant and Nursery School,103,17030,9934,7096
341,Liverpool,3412098,Matthew Arnold Primary School,178,17780,10372,7408
341,Liverpool,3412110,Northcote Primary School,355,19550,11404,8146
341,Liverpool,3412113,Northway Primary and Nursery School,285,18850,10996,7854
341,Liverpool,3412123,Pleasant Street Primary School,159,17590,10261,7329
341,Liverpool,3412128,Whitefield Primary School,221,18210,10623,7587
341,Liverpool,3412130,Ranworth Square Primary School,166,17660,10302,7358
341,Liverpool,3412149,Sudley Infant School,178,17780,10372,7408
341,Liverpool,3412166,Windsor Community Primary School,176,17760,10360,7400
341,Liverpool,3412170,Middlefield Community Primary School,266,18660,10885,7775
341,Liverpool,3412171,Blackmoor Park Infants School,180,17800,10383,7417
341,Liverpool,3412172,Booker Avenue Infant School,181,17810,10389,7421
341,Liverpool,3412176,Holy Family Catholic Primary School,231,18310,10681,7629
341,Liverpool,3412180,Sudley Junior School,357,19570,11416,8154
341,Liverpool,3412199,Norman Pannell School,126,17260,10068,7192
341,Liverpool,3412214,Gwladys Street Primary and Nursery School,314,19140,11165,7975
341,Liverpool,3412215,Broadgreen Primary School,182,17820,10395,7425
341,Liverpool,3412218,Dovecot Primary School,107,17070,9958,7112
341,Liverpool,3412221,Lawrence Community Primary School,359,19590,11428,8162
341,Liverpool,3412222,Four Oaks Primary School,217,18170,10599,7571
341,Liverpool,3412226,Mab Lane Junior Mixed and Infant School,173,17730,10343,7387
341,Liverpool,3412227,Smithdown Primary School,223,18230,10634,7596
341,Liverpool,3412229,Kingsley Community School,296,18960,11060,7900
341,Liverpool,3412230,Fazakerley Primary School,328,19280,11247,8033
341,Liverpool,3412232,Kirkdale St Lawrence CofE VA Primary School,172,17720,10337,7383
341,Liverpool,3412233,St Matthews Catholic Primary School,348,19480,11363,8117
341,Liverpool,3412234,St Johns Catholic Primary School,316,19160,11177,7983
341,Liverpool,3412235,Greenbank Primary School,348,19480,11363,8117
341,Liverpool,3412236,Wellesbourne Community Primary School,300,19000,11083,7917
341,Liverpool,3412237,St Michael-in-the-Hamlet Community Primary School,356,19560,11410,8150
341,Liverpool,3412238,Stockton Wood Community Primary School,234,18340,10698,7642
341,Liverpool,3412239,Our Lady of the Assumption Catholic Primary School,171,17710,10331,7379
341,Liverpool,3412240,Monksdown Primary School,385,19850,11579,8271
341,Liverpool,3412241,Longmoor Community Primary School,283,18830,10984,7846
341,Liverpool,3412242,Kensington Primary School,364,19640,11457,8183
341,Liverpool,3413001,St Cleopas Church of England Junior Mixed and Infant School,193,17930,10459,7471
341,Liverpool,3413015,Wavertree Church of England School,168,17680,10313,7367
341,Liverpool,3413021,Leamington Community Primary School,351,19510,11381,8129
341,Liverpool,3413022,Florence Melly Community Primary School,348,19480,11363,8117
341,Liverpool,3413023,Broad Square Community Primary School,318,19180,11188,7992
341,Liverpool,3413024,St Christophers Catholic Primary School,298,18980,11072,7908
341,Liverpool,3413025,Blueberry Park,209,18090,10553,7537
341,Liverpool,3413026,Phoenix Primary School,162,17620,10278,7342
341,Liverpool,3413310,St Annes (Stanley) Junior Mixed and Infant School,327,19270,11241,8029
341,Liverpool,3413327,St Marys Church of England Primary School West Derby,182,17820,10395,7425
341,Liverpool,3413329,Childwall Church of England Primary School,362,19620,11445,8175
341,Liverpool,3413507,Christ The King Catholic Primary School,307,19070,11124,7946
341,Liverpool,3413511,Our Lady and St Swithins Catholic Primary School,185,17850,10413,7437
341,Liverpool,3413512,Holy Cross Catholic Primary School,136,17360,10127,7233
341,Liverpool,3413513,Holy Name Catholic Primary School,256,18560,10827,7733
341,Liverpool,3413514,Holy Trinity Catholic Primary School,197,17970,10483,7487
341,Liverpool,3413516,Much Woolton Catholic Primary School,355,19550,11404,8146
341,Liverpool,3413523,Our Lady Immaculate Catholic Primary School,258,18580,10838,7742
341,Liverpool,3413527,St Finbars Catholic Primary School,145,17450,10179,7271
341,Liverpool,3413528,Sacred Heart Catholic Primary School,172,17720,10337,7383
341,Liverpool,3413541,Our Ladys Bishop Eton Catholic Primary School,360,19600,11433,8167
341,Liverpool,3413543,St Austins Catholic Primary School,348,19480,11363,8117
341,Liverpool,3413547,St Cecilias Catholic Junior School,236,18360,10710,7650
341,Liverpool,3413548,St Charles Catholic Primary School,166,17660,10302,7358
341,Liverpool,3413550,St Clares Catholic Primary School,170,17700,10325,7375
341,Liverpool,3413551,St Cuthberts Catholic Primary and Nursery School,168,17680,10313,7367
341,Liverpool,3413552,St Francis de Sales Catholic Junior School,405,20050,11696,8354
341,Liverpool,3413553,St Francis de Sales Catholic Infant and Nursery School,229,18290,10669,7621
341,Liverpool,3413558,St Hughs Catholic Primary School,179,17790,10378,7412
341,Liverpool,3413571,St Michaels Catholic Primary School,327,19270,11241,8029
341,Liverpool,3413573,St Nicholass Catholic Primary School,147,17470,10191,7279
341,Liverpool,3413582,St Patricks Catholic Primary School,177,17770,10366,7404
341,Liverpool,3413584,St Pauls Catholic Junior School,501,21010,12256,8754
341,Liverpool,3413588,St Sebastians Catholic Primary School and Nursery,180,17800,10383,7417
341,Liverpool,3413594,St Vincent de Paul Catholic Primary School,206,18060,10535,7525
341,Liverpool,3413599,Our Lady of Good Help Catholic Primary School,138,17380,10138,7242
341,Liverpool,3413601,St Ambrose Catholic Primary School,191,17910,10448,7462
341,Liverpool,3413606,St Pauls and St Timothys Catholic Infant School,240,18400,10733,7667
341,Liverpool,3413631,St Anthony of Padua Catholic Primary School,182,17820,10395,7425
341,Liverpool,3413632,St Cecilias Catholic Infant School,120,17200,10033,7167
341,Liverpool,3413633,St Gregorys Catholic Primary School,173,17730,10343,7387
341,Liverpool,3413635,St Paschal Baylon Catholic Primary School,318,19180,11188,7992
341,Liverpool,3413644,St Annes Catholic Primary School,217,18170,10599,7571
341,Liverpool,3413956,Emmaus Church of England and Catholic Primary School,360,19600,11433,8167
341,Liverpool,3413960,Our Lady and St Philomenas Catholic Primary School,156,17560,10243,7317
341,Liverpool,3413961,Pinehurst Primary School Anfield,291,18910,11031,7879
341,Liverpool,3413963,The Trinity Catholic Primary School,286,18860,11002,7858
341,Liverpool,3413964,Faith Primary School,142,17420,10162,7258
341,Liverpool,3413965,Arnot St Mary CofE Primary School,326,19260,11235,8025
341,Liverpool,3413967,St Teresa of Lisieux Catholic Primary School,360,19600,11433,8167
341,Liverpool,3415200,King David Primary School,364,19640,11457,8183
341,Liverpool,3417025,Abbots Lea School,83,16830,9818,7012
341,Liverpool,3417045,Ernest Cookson School,96,16960,9893,7067
341,Liverpool,3417054,Millstead School,118,17180,10022,7158
341,Liverpool,3417063,Princes School,127,17270,10074,7196
341,Liverpool,3417065,Hope School,34,16340,9532,6808
341,Liverpool,3417070,Bank View High School,21,16210,9456,6754
341,Liverpool,3417052,Redbridge High School,1,1000,583,417
341,Liverpool,3417069,Childwall Abbey School,1,1000,583,417
342,St. Helens,3421100,Pace,2,2000,1167,833
342,St. Helens,3422001,Allanson Street Primary School,355,19550,11404,8146
342,St. Helens,3422007,Rivington Primary School,176,17760,10360,7400
342,St. Helens,3422008,Robins Lane Community Primary School,195,17950,10471,7479
342,St. Helens,3422010,Thatto Heath Community Primary School,498,20980,12238,8742
342,St. Helens,3422012,Sutton Manor Community Primary School,174,17740,10348,7392
342,St. Helens,3422019,Sherdley Primary School,333,19330,11276,8054
342,St. Helens,3422020,Eaves Primary School,180,17800,10383,7417
342,St. Helens,3422021,Ashurst Primary School,177,17770,10366,7404
342,St. Helens,3422022,Willow Tree Primary School,228,18280,10663,7617
342,St. Helens,3422051,Bleak Hill Primary School,407,20070,11708,8362
342,St. Helens,3422053,Grange Valley Primary School,182,17820,10395,7425
342,St. Helens,3422056,Newton-le-Willows Primary School,426,20260,11818,8442
342,St. Helens,3422058,Lyme Community Primary School,170,17700,10325,7375
342,St. Helens,3422059,Longton Lane Community Primary School,178,17780,10372,7408
342,St. Helens,3422061,Garswood Primary School,192,17920,10453,7467
342,St. Helens,3422062,Chapel End Primary School,214,18140,10582,7558
342,St. Helens,3422063,Rainford Brook Lodge Community Primary School,178,17780,10372,7408
342,St. Helens,3422064,Oakdene Primary School,178,17780,10372,7408
342,St. Helens,3422065,Legh Vale Primary School,415,20150,11754,8396
342,St. Helens,3422066,Eccleston Mere Primary School,324,19240,11223,8017
342,St. Helens,3422068,Merton Bank Primary School,166,17660,10302,7358
342,St. Helens,3422070,Broad Oak Community Primary School,433,20330,11859,8471
342,St. Helens,3422071,St. Marys  Catholic Primary Blackbrook,357,19570,11416,8154
342,St. Helens,3422072,Holy Spirit Catholic Primary School,172,17720,10337,7383
342,St. Helens,3423106,Wargrave CofE Primary School,308,19080,11130,7950
342,St. Helens,3423109,Eccleston Lane Ends Primary School,208,18080,10547,7533
342,St. Helens,3423205,Rainford CofE Primary School,246,18460,10768,7692
342,St. Helens,3423206,Sutton Oak CofE Primary School,265,18650,10879,7771
342,St. Helens,3423207,The District CofE Primary School,300,19000,11083,7917
342,St. Helens,3423208,Queens Park CofE URC Primary School,336,19360,11293,8067
342,St. Helens,3423320,Rectory CofE Primary School,140,17400,10150,7250
342,St. Helens,3423321,St Aidans CofE  Primary School Billinge,176,17760,10360,7400
342,St. Helens,3423328,St Peters CofE Primary School,207,18070,10541,7529
342,St. Helens,3423404,Holy Cross Catholic Primary School,157,17570,10249,7321
342,St. Helens,3423414,St Annes Catholic Primary School,267,18670,10891,7779
342,St. Helens,3423415,St Austins Catholic Primary School,178,17780,10372,7408
342,St. Helens,3423420,St Teresas Catholic Primary School Devon Street,169,17690,10319,7371
342,St. Helens,3423430,St Thomas of Canterbury Catholic Primary School,177,17770,10366,7404
342,St. Helens,3423432,St Peter and St Paul Catholic Primary School,177,17770,10366,7404
342,St. Helens,3423434,St John Vianney Catholic Primary School,180,17800,10383,7417
342,St. Helens,3423450,St Marys Catholic Primary School,176,17760,10360,7400
342,St. Helens,3423451,Corpus Christi Catholic Primary School,152,17520,10220,7300
342,St. Helens,3423452,St Bartholomews Catholic Primary School,269,18690,10903,7787
342,St. Helens,3423453,St Marys Catholic Junior School,238,18380,10722,7658
342,St. Helens,3423454,St Marys Catholic Infant School,120,17200,10033,7167
342,St. Helens,3423455,Haydock English Martyrs Catholic Primary School,267,18670,10891,7779
342,St. Helens,3423456,St Julies Catholic Primary School,206,18060,10535,7525
342,St. Helens,3423827,St Theresas Catholic Primary School,177,17770,10366,7404
342,St. Helens,3423828,Carr Mill Primary School,221,18210,10623,7587
342,St. Helens,3427005,Penkford School,12,12000,7000,5000
342,St. Helens,3427008,Lansbury Bridge School,124,17240,10057,7183
343,Sefton,3431101,Jigsaw Primary Pupil Referral Unit,4,4000,2333,1667
343,Sefton,3432008,Linacre Primary School,135,17350,10121,7229
343,Sefton,3432013,Netherton Moss Primary School,154,17540,10232,7308
343,Sefton,3432023,The Grange Primary School,230,18300,10675,7625
343,Sefton,3432030,Birkdale Primary School,331,19310,11264,8046
343,Sefton,3432034,Farnborough Road Junior School,479,20790,12128,8662
343,Sefton,3432035,Farnborough Road Infant School,236,18360,10710,7650
343,Sefton,3432036,Linaker Primary School,389,19890,11603,8287
343,Sefton,3432038,Norwood Primary School,383,19830,11568,8262
343,Sefton,3432047,Marshside Primary School,156,17560,10243,7317
343,Sefton,3432050,Aintree Davenhill Primary School,344,19440,11340,8100
343,Sefton,3432053,Hudson Primary School,145,17450,10179,7271
343,Sefton,3432054,Waterloo Primary School,341,19410,11323,8087
343,Sefton,3432056,Forefield Junior School,362,19620,11445,8175
343,Sefton,3432057,Forefield Community Infant and Nursery School,178,17780,10372,7408
343,Sefton,3432060,Lander Road Primary School,179,17790,10378,7412
343,Sefton,3432066,Hatton Hill Primary School,296,18960,11060,7900
343,Sefton,3432067,Northway Primary School,240,18400,10733,7667
343,Sefton,3432075,Woodlands Primary School,274,18740,10932,7808
343,Sefton,3432076,Summerhill Primary School,169,17690,10319,7371
343,Sefton,3432078,Freshfield Primary School,194,17940,10465,7475
343,Sefton,3432080,Green Park Primary School,170,17700,10325,7375
343,Sefton,3432086,Redgate Community Primary School,141,17410,10156,7254
343,Sefton,3432087,Kings Meadow Primary School and Early Years Education Centre,164,17640,10290,7350
343,Sefton,3432088,Larkfield Primary School,252,18520,10803,7717
343,Sefton,3432090,Melling Primary School,171,17710,10331,7379
343,Sefton,3432091,Valewood Primary School,176,17760,10360,7400
343,Sefton,3432092,Lydiate Primary School,256,18560,10827,7733
343,Sefton,3432093,Bedford Primary School,343,19430,11334,8096
343,Sefton,3433000,Christ Church Church of England Controlled Primary School,266,18660,10885,7775
343,Sefton,3433010,St Johns Church of England Primary School,152,17520,10220,7300
343,Sefton,3433024,St Lukes Church of England Primary School,364,19640,11457,8183
343,Sefton,3433025,St Philips Church of England Controlled Primary School,174,17740,10348,7392
343,Sefton,3433303,St Oswalds Church of England Primary School,175,17750,10354,7396
343,Sefton,3433305,St Philips Church of England Primary School,176,17760,10360,7400
343,Sefton,3433307,Ainsdale St Johns Church of England Primary School,179,17790,10378,7412
343,Sefton,3433313,St Monicas Catholic Primary School,356,19560,11410,8150
343,Sefton,3433316,St Robert Bellarmine Catholic Primary School,177,17770,10366,7404
343,Sefton,3433322,Holy Spirit Catholic Primary School,159,17590,10261,7329
343,Sefton,3433336,Holy Family Catholic Primary School,175,17750,10354,7396
343,Sefton,3433337,Our Lady of Lourdes Catholic Primary School,477,20770,12116,8654
343,Sefton,3433338,St Teresas Catholic Infant and Nursery School,46,16460,9602,6858
343,Sefton,3433339,St Patricks Catholic Primary School,299,18990,11078,7912
343,Sefton,3433342,St Johns Church of England Primary School,153,17530,10226,7304
343,Sefton,3433343,St Lukes Halsall Church of England Primary School,174,17740,10348,7392
343,Sefton,3433345,St Nicholas Church of England Primary School,178,17780,10372,7408
343,Sefton,3433351,St Georges Catholic Primary School,162,17620,10278,7342
343,Sefton,3433353,Great Crosby Catholic Primary School,569,21690,12653,9037
343,Sefton,3433354,St Marys Catholic Primary School,93,16930,9876,7054
343,Sefton,3433355,St Edmunds and St Thomas Catholic Primary School,262,18620,10862,7758
343,Sefton,3433357,Our Lady Star of the Sea Catholic Primary School,148,17480,10197,7283
343,Sefton,3433359,Our Lady of Compassion Catholic Primary School,207,18070,10541,7529
343,Sefton,3433361,English Martyrs Catholic Primary School,359,19590,11428,8162
343,Sefton,3433362,St Elizabeths Catholic Primary School,286,18860,11002,7858
343,Sefton,3433364,St William of York Catholic Primary School,171,17710,10331,7379
343,Sefton,3433366,Our Lady Queen of Peace Catholic Primary School,102,17020,9928,7092
343,Sefton,3433367,St Gregorys Catholic Primary School,177,17770,10366,7404
343,Sefton,3433368,Ursuline Catholic Primary School,359,19590,11428,8162
343,Sefton,3433369,St Jeromes Catholic Primary School,185,17850,10413,7437
343,Sefton,3433374,Holy Rosary Catholic Primary School,355,19550,11404,8146
343,Sefton,3433375,St John Bosco Catholic Primary School,173,17730,10343,7387
343,Sefton,3433376,Bishop David Sheppard Church of England Primary School,175,17750,10354,7396
343,Sefton,3433378,Springwell Park Community Primary School,324,19240,11223,8017
343,Sefton,3433379,Thomas Gray Primary School,165,17650,10296,7354
343,Sefton,3433380,Trinity St Peters CofE Primary School,184,17840,10407,7433
343,Sefton,3433382,St Benedicts Catholic Primary School,175,17750,10354,7396
343,Sefton,3433383,Our Lady of Walsingham Catholic Primary School,176,17760,10360,7400
343,Sefton,3433384,All Saints Catholic Primary School,274,18740,10932,7808
343,Sefton,3433385,Rimrose Hope CofE Primary School,221,18210,10623,7587
343,Sefton,3437006,Merefield School,42,16420,9578,6842
343,Sefton,3437011,Newfield School,22,16220,9462,6758
343,Sefton,3437013,Rowan Park School,65,16650,9713,6937
344,Wirral,3442000,Bedford Drive Primary School,318,19180,11188,7992
344,Wirral,3442001,Bidston Village CofE (Controlled) Primary School,276,18760,10943,7817
344,Wirral,3442021,Woodlands Primary School,248,18480,10780,7700
344,Wirral,3442048,Devonshire Park Primary School,426,20260,11818,8442
344,Wirral,3442100,New Brighton Primary School,510,21100,12308,8792
344,Wirral,3442101,Mount Primary School,289,18890,11019,7871
344,Wirral,3442102,Liscard Primary School,539,21390,12478,8912
344,Wirral,3442104,St Georges Primary School,702,23020,13428,9592
344,Wirral,3442107,Riverside Primary School,150,17500,10208,7292
344,Wirral,3442108,Kingsway Primary School,89,16890,9853,7037
344,Wirral,3442110,Park Primary School,356,19560,11410,8150
344,Wirral,3442111,Somerville Primary School,435,20350,11871,8479
344,Wirral,3442112,Eastway Primary School,179,17790,10378,7412
344,Wirral,3442115,Castleway Primary School,119,17190,10028,7162
344,Wirral,3442116,Sandbrook Primary School,98,16980,9905,7075
344,Wirral,3442117,Greenleas Primary School,278,18780,10955,7825
344,Wirral,3442118,Lingham Primary School,301,19010,11089,7921
344,Wirral,3442203,Higher Bebington Junior School,351,19510,11381,8129
344,Wirral,3442205,Grove Street Primary School,245,18450,10763,7687
344,Wirral,3442210,Brackenwood Junior School,236,18360,10710,7650
344,Wirral,3442212,Thornton Hough Primary School,155,17550,10238,7312
344,Wirral,3442214,Mendell Primary School,153,17530,10226,7304
344,Wirral,3442215,Brookhurst Primary School,188,17880,10430,7450
344,Wirral,3442217,Raeburn Primary School,360,19600,11433,8167
344,Wirral,3442218,Brackenwood Infant School,117,17170,10016,7154
344,Wirral,3442220,Greasby Infant School,120,17200,10033,7167
344,Wirral,3442221,West Kirby Primary School,231,18310,10681,7629
344,Wirral,3442224,Irby Primary School,188,17880,10430,7450
344,Wirral,3442225,Greasby Junior School,247,18470,10774,7696
344,Wirral,3442226,Black Horse Hill Infant School,120,17200,10033,7167
344,Wirral,3442227,Brookdale Primary School,188,17880,10430,7450
344,Wirral,3442229,Barnston Primary School,253,18530,10809,7721
344,Wirral,3442232,Black Horse Hill Junior School,212,18120,10570,7550
344,Wirral,3442238,Gayton Primary School,190,17900,10442,7458
344,Wirral,3442250,Heswall Primary School,192,17920,10453,7467
344,Wirral,3442252,Fender Primary School,208,18080,10547,7533
344,Wirral,3442254,Manor Primary School,105,17050,9946,7104
344,Wirral,3442255,Mersey Park Primary School,353,19530,11393,8137
344,Wirral,3442256,Overchurch Infant School,180,17800,10383,7417
344,Wirral,3442258,Rock Ferry Primary School,258,18580,10838,7742
344,Wirral,3442260,Woodchurch Road Primary School,367,19670,11474,8196
344,Wirral,3442261,Cathcart Street Primary School,171,17710,10331,7379
344,Wirral,3442263,Well Lane Primary School,147,17470,10191,7279
344,Wirral,3442264,Thingwall Primary School,171,17710,10331,7379
344,Wirral,3442268,Leasowe Primary School,155,17550,10238,7312
344,Wirral,3442270,Overchurch Junior School,373,19730,11509,8221
344,Wirral,3442274,Heygarth Primary School,269,18690,10903,7787
344,Wirral,3442275,Bidston Avenue Primary School,355,19550,11404,8146
344,Wirral,3442279,Hillside Primary School,144,17440,10173,7267
344,Wirral,3443009,West Kirby St Bridgets CofE Primary School,370,19700,11492,8208
344,Wirral,3443010,Hoylake Holy Trinity CofE Primary School,224,18240,10640,7600
344,Wirral,3443011,Birkenhead Christ Church CofE Primary School,172,17720,10337,7383
344,Wirral,3443300,Oxton St Saviours CofE Aided Primary School,209,18090,10553,7537
344,Wirral,3443304,Woodchurch CofE Primary School,179,17790,10378,7412
344,Wirral,3443321,St Josephs Catholic Primary School Upton,240,18400,10733,7667
344,Wirral,3443322,St Peters Catholic Primary School,100,17000,9917,7083
344,Wirral,3443324,St Pauls Catholic Primary School,64,16640,9707,6933
344,Wirral,3443330,Ss Peter and Paul Catholic Primary School,264,18640,10873,7767
344,Wirral,3443331,St Albans Catholic Primary School,334,19340,11282,8058
344,Wirral,3443333,St Josephs Catholic Primary School Wallasey,187,17870,10424,7446
344,Wirral,3443335,Sacred Heart Catholic Primary School,333,19330,11276,8054
344,Wirral,3443350,St Andrews CofE Aided Primary School,180,17800,10383,7417
344,Wirral,3443351,Thurstaston Dawpool CofE Primary School,184,17840,10407,7433
344,Wirral,3443352,Heswall St Peters CofE Primary School,277,18770,10949,7821
344,Wirral,3443360,St Johns Catholic Junior School,253,18530,10809,7721
344,Wirral,3443361,Christ The King Catholic Primary School,365,19650,11463,8187
344,Wirral,3443362,St Johns Catholic Infant School,120,17200,10033,7167
344,Wirral,3443363,Holy Spirit Catholic and Church of England Primary School,164,17640,10290,7350
344,Wirral,3443365,Ladymount Catholic Primary School,259,18590,10844,7746
344,Wirral,3443366,The Priory Parish CofE Primary School,169,17690,10319,7371
344,Wirral,3443367,Our Lady and St Edwards Catholic Primary School,357,19570,11416,8154
344,Wirral,3443368,Holy Cross Catholic Primary School,128,17280,10080,7200
344,Wirral,3443369,St Annes Catholic Primary School,167,17670,10308,7362
344,Wirral,3443371,St Michael and All Angels Catholic Primary School,174,17740,10348,7392
344,Wirral,3443372,St Werburghs Catholic Primary School,164,17640,10290,7350
344,Wirral,3443374,Prenton Primary School,347,19470,11358,8112
344,Wirral,3443375,Millfields Church of England (Controlled) Primary School,145,17450,10179,7271
344,Wirral,3443376,Pensby Primary School,185,17850,10413,7437
344,Wirral,3447000,Hayfield School,118,17180,10022,7158
344,Wirral,3447005,Elleray Park School,94,16940,9882,7058
344,Wirral,3447010,Gilbrook School,60,16600,9683,6917
344,Wirral,3447017,Stanley School,106,17060,9952,7108
344,Wirral,3447020,Orrets Meadow School,75,16750,9771,6979
344,Wirral,3447215,The Observatory School,5,5000,2917,2083
350,Bolton,3502000,Brandwood Primary School,361,19610,11439,8171
350,Bolton,3502004,Brownlow Fold Primary School,179,17790,10378,7412
350,Bolton,3502005,Castle Hill Primary School,176,17760,10360,7400
350,Bolton,3502008,Church Road Primary School,339,19390,11311,8079
350,Bolton,3502010,Clarendon Primary School,360,19600,11433,8167
350,Bolton,3502013,Devonshire Road Primary School,363,19630,11451,8179
350,Bolton,3502014,Gaskell Community Primary School,286,18860,11002,7858
350,Bolton,3502016,High Lawn Primary School,349,19490,11369,8121
350,Bolton,3502017,Johnson Fold Community Primary School,180,17800,10383,7417
350,Bolton,3502019,Markland Hill Primary School,271,18710,10914,7796
350,Bolton,3502020,Oxford Grove Primary School,364,19640,11457,8183
350,Bolton,3502022,Pikes Lane Primary School,362,19620,11445,8175
350,Bolton,3502024,Sharples Primary School,177,17770,10366,7404
350,Bolton,3502025,Sunning Hill Primary School,370,19700,11492,8208
350,Bolton,3502035,Haslam Park Primary School,271,18710,10914,7796
350,Bolton,3502036,Ladybridge Community Primary School,341,19410,11323,8087
350,Bolton,3502038,Moorgate Primary School,241,18410,10739,7671
350,Bolton,3502039,Heathfield Primary School,179,17790,10378,7412
350,Bolton,3502040,Beaumont Primary School,188,17880,10430,7450
350,Bolton,3502041,Lostock Primary School,180,17800,10383,7417
350,Bolton,3502042,Blackshaw Primary School,179,17790,10378,7412
350,Bolton,3502043,The Oaks Primary School,181,17810,10389,7421
350,Bolton,3502051,Chorley New Road Primary School,229,18290,10669,7621
350,Bolton,3502056,Highfield Primary School,364,19640,11457,8183
350,Bolton,3502061,Kearsley West Primary School,173,17730,10343,7387
350,Bolton,3502062,Cherry Tree Primary School,350,19500,11375,8125
350,Bolton,3502065,Hardy Mill Primary School,271,18710,10914,7796
350,Bolton,3502066,Mytham Primary School,329,19290,11253,8037
350,Bolton,3502067,Blackrod Primary School,197,17970,10483,7487
350,Bolton,3502068,Egerton Primary School,187,17870,10424,7446
350,Bolton,3502073,Claypool Primary School,214,18140,10582,7558
350,Bolton,3502075,Spindle Point Primary School,182,17820,10395,7425
350,Bolton,3502078,Gilnow Primary School,178,17780,10372,7408
350,Bolton,3502079,Washacre Primary School,150,17500,10208,7292
350,Bolton,3502083,Eatock Primary School,191,17910,10448,7462
350,Bolton,3502084,Queensbridge Primary School,176,17760,10360,7400
350,Bolton,3502085,The Gates Primary School,254,18540,10815,7725
350,Bolton,3503000,St Marys CofE Primary School Deane,358,19580,11422,8158
350,Bolton,3503007,St Matthews CofE Primary School Bolton,358,19580,11422,8158
350,Bolton,3503021,St James CofE Primary School Daisy Hill,309,19090,11136,7954
350,Bolton,3503023,Blackrod Anglican/Methodist Primary School,196,17960,10477,7483
350,Bolton,3503302,St Michaels CofE Primary School Great Lever,364,19640,11457,8183
350,Bolton,3503306,St Stephen and All Martyrs CofE School Lever Bridge,179,17790,10378,7412
350,Bolton,3503314,St Thomas CofE Primary School Halliwell,272,18720,10920,7800
350,Bolton,3503315,Holy Infant and St Anthony RC Primary School,176,17760,10360,7400
350,Bolton,3503316,St Columbas RC Primary School,178,17780,10372,7408
350,Bolton,3503317,St Thomas of Canterbury RC School,361,19610,11439,8171
350,Bolton,3503319,St Ethelberts RC Primary School,179,17790,10378,7412
350,Bolton,3503320,St Josephs RC Primary School Halliwell Bolton,175,17750,10354,7396
350,Bolton,3503328,St Peter and St Paul RC Primary School,180,17800,10383,7417
350,Bolton,3503331,St William of York Catholic Primary School,179,17790,10378,7412
350,Bolton,3503336,Bolton Parish Church CofE Primary School,180,17800,10383,7417
350,Bolton,3503337,St Bernards RC Primary School Bolton,170,17700,10325,7375
350,Bolton,3503341,Walmsley CofE Primary School,304,19040,11107,7933
350,Bolton,3503344,Horwich Parish CofE Primary School,343,19430,11334,8096
350,Bolton,3503345,St Thomas CofE Primary School,183,17830,10401,7429
350,Bolton,3503348,St Andrews CofE Primary School Over Hulton,186,17860,10418,7442
350,Bolton,3503349,St Bartholomews CofE Primary School,180,17800,10383,7417
350,Bolton,3503351,All Saints CofE Primary School,177,17770,10366,7404
350,Bolton,3503352,St Peters CofE Primary School,330,19300,11258,8042
350,Bolton,3503354,St Stephens CofE Primary School,179,17790,10378,7412
350,Bolton,3503355,St John CofE Primary School Kearsley,180,17800,10383,7417
350,Bolton,3503356,St Matthews CofE Primary School Little Lever,187,17870,10424,7446
350,Bolton,3503359,Sacred Heart R.C. Primary School,348,19480,11363,8117
350,Bolton,3503360,St Gregorys RC Primary School Farnworth Bolton,173,17730,10343,7387
350,Bolton,3503362,Our Lady of Lourdes RC Primary School,183,17830,10401,7429
350,Bolton,3503363,St Brendans RC Primary School Harwood Bolton,179,17790,10378,7412
350,Bolton,3503364,St Teresas RC Primary School,135,17350,10121,7229
350,Bolton,3503365,St Saviour CofE Primary School Ringley,180,17800,10383,7417
350,Bolton,3503366,St John the Evangelist RC Primary School Bromley Cross Bolton,175,17750,10354,7396
350,Bolton,3503367,St Marys RC Primary School,187,17870,10424,7446
350,Bolton,3503369,St Georges CofE Primary School,243,18430,10751,7679
350,Bolton,3503370,The Valley Community Primary School,359,19590,11428,8162
350,Bolton,3503371,SS Osmund and Andrews R.C. Primary School,303,19030,11101,7929
350,Bolton,3503373,Leverhulme Community Primary School,358,19580,11422,8158
350,Bolton,3507002,Thomasson Memorial School,38,16380,9555,6825
350,Bolton,3507008,Green Fold School,95,16950,9888,7062
351,Bury,3512006,Fairfield Community Primary School,215,18150,10588,7562
351,Bury,3512012,Greenhill Primary School,214,18140,10582,7558
351,Bury,3512013,Chantlers Primary School,210,18100,10558,7542
351,Bury,3512014,Woodbank Primary School,241,18410,10739,7671
351,Bury,3512015,Chesham Primary School,273,18730,10926,7804
351,Bury,3512019,Old Hall Primary School,170,17700,10325,7375
351,Bury,3512020,Lowercroft Primary School,209,18090,10553,7537
351,Bury,3512025,Hazlehurst Community Primary School,179,17790,10378,7412
351,Bury,3512027,Butterstile Primary School,333,19330,11276,8054
351,Bury,3512029,Mersey Drive Community Primary School,163,17630,10284,7346
351,Bury,3512030,Ribble Drive Community Primary School,180,17800,10383,7417
351,Bury,3512032,Greenmount Primary School,213,18130,10576,7554
351,Bury,3512035,Tottington Primary School,274,18740,10932,7808
351,Bury,3512036,Cams Lane Primary School,182,17820,10395,7425
351,Bury,3512037,Heaton Park Primary School,345,19450,11346,8104
351,Bury,3512038,Park View Primary School,352,19520,11387,8133
351,Bury,3512039,Sedgley Park Community Primary School,222,18220,10628,7592
351,Bury,3512041,Whitefield Community Primary School,147,17470,10191,7279
351,Bury,3512042,Holcombe Brook Primary School,237,18370,10716,7654
351,Bury,3512045,Chapelfield Primary School,239,18390,10728,7662
351,Bury,3512046,Hollins Grundy Primary School,183,17830,10401,7429
351,Bury,3512048,Springside Primary School,207,18070,10541,7529
351,Bury,3513006,St Peters Church of England Primary School,191,17910,10448,7462
351,Bury,3513015,St Margarets Church of England Primary School,210,18100,10558,7542
351,Bury,3513016,Christ Church Ainsworth Church of England Primary School,209,18090,10553,7537
351,Bury,3513017,All Saints Church of England Primary School Stand,179,17790,10378,7412
351,Bury,3513018,St Andrews Church of England Primary School Ramsbottom,227,18270,10658,7612
351,Bury,3513019,Summerseat Methodist Primary School,82,16820,9812,7008
351,Bury,3513022,Wesley Methodist Primary School,255,18550,10821,7729
351,Bury,3513028,Radcliffe Hall Church of England/Methodist Controlled Primary School,254,18540,10815,7725
351,Bury,3513303,St Pauls Church of England Primary School Bury,205,18050,10529,7521
351,Bury,3513320,Guardian Angels Roman Catholic Primary School Bury,186,17860,10418,7442
351,Bury,3513324,St Maries Roman Catholic Primary School Bury,182,17820,10395,7425
351,Bury,3513326,St Joseph and St Bede RC Primary School,268,18680,10897,7783
351,Bury,3513328,Our Lady of Lourdes Roman Catholic Primary School Bury,169,17690,10319,7371
351,Bury,3513330,Emmanuel Holcombe Church of England Primary School,88,16880,9847,7033
351,Bury,3513332,St Marys Church of England Primary School Hawkshaw,92,16920,9870,7050
351,Bury,3513334,St Marys Church of England Aided Primary School Prestwich,179,17790,10378,7412
351,Bury,3513335,St Josephs Roman Catholic Primary School Ramsbottom,180,17800,10383,7417
351,Bury,3513336,Holly Mount Roman Catholic Primary School Bury,270,18700,10908,7792
351,Bury,3513337,Our Lady of Grace RC Primary School,359,19590,11428,8162
351,Bury,3513341,St Bernadettes Roman Catholic Primary School Whitefield,268,18680,10897,7783
351,Bury,3513343,St Michaels Roman Catholic Primary School Whitefield,182,17820,10395,7425
351,Bury,3513346,St Andrews Church of England Primary School Radcliffe,178,17780,10372,7408
351,Bury,3513348,St Hildas Church of England Primary School,168,17680,10313,7367
351,Bury,3513349,Bury and Whitefield Jewish Primary School,123,17230,10051,7179
351,Bury,3513350,St Marys Roman Catholic Primary School Radcliffe,357,19570,11416,8154
351,Bury,3513351,St Stephens Church of England Primary School,211,18110,10564,7546
351,Bury,3513352,St John with St Mark CofE Primary School,247,18470,10774,7696
351,Bury,3513353,St Lukes CofE Primary School,390,19900,11608,8292
351,Bury,3515200,Peel Brow School,113,17130,9993,7137
351,Bury,3517010,Millwood Primary Special School,112,17120,9987,7133
352,Manchester,3521102,Bridgelea Pupil Referral Unit,68,16680,9730,6950
352,Manchester,3522001,Abbott Community Primary School,176,17760,10360,7400
352,Manchester,3522006,Alma Park Primary School,374,19740,11515,8225
352,Manchester,3522008,Ringway Primary School,296,18960,11060,7900
352,Manchester,3522010,Ashbury Meadow Primary School,327,19270,11241,8029
352,Manchester,3522039,Bowker Vale Primary School,361,19610,11439,8171
352,Manchester,3522048,Acacias Community Primary School,365,19650,11463,8187
352,Manchester,3522057,Cavendish Primary School,498,20980,12238,8742
352,Manchester,3522058,Chapel Street Primary School,545,21450,12513,8937
352,Manchester,3522060,Charlestown Community Primary School,348,19480,11363,8117
352,Manchester,3522068,Claremont Primary School,524,21240,12390,8850
352,Manchester,3522075,Crosslee Community Primary School,301,19010,11089,7921
352,Manchester,3522076,Crowcroft Park Primary School,182,17820,10395,7425
352,Manchester,3522129,Heald Place Primary School,528,21280,12413,8867
352,Manchester,3522142,Lily Lane Primary School,471,20710,12081,8629
352,Manchester,3522161,Mauldeth Road Primary School,337,19370,11299,8071
352,Manchester,3522164,Moston Fields Primary School,313,19130,11159,7971
352,Manchester,3522165,Moston Lane Community Primary School,362,19620,11445,8175
352,Manchester,3522184,New Moston Primary School,437,20370,11883,8487
352,Manchester,3522186,Northenden Community School,181,17810,10389,7421
352,Manchester,3522216,Plymouth Grove Primary School,362,19620,11445,8175
352,Manchester,3522232,Rack House Primary School,305,19050,11113,7937
352,Manchester,3522234,Ravensbury Community School,343,19430,11334,8096
352,Manchester,3522249,Irk Valley Community School,384,19840,11573,8267
352,Manchester,3522278,Varna Community Primary School,365,19650,11463,8187
352,Manchester,3522288,Cheetwood Primary School,165,17650,10296,7354
352,Manchester,3522296,Crab Lane Primary School,337,19370,11299,8071
352,Manchester,3522298,Broad Oak Primary School,421,20210,11789,8421
352,Manchester,3522300,Peel Hall Primary School,220,18200,10617,7583
352,Manchester,3522301,Sandilands Primary School,334,19340,11282,8058
352,Manchester,3522302,Pike Fold Primary School,367,19670,11474,8196
352,Manchester,3522303,Higher Openshaw Community School,304,19040,11107,7933
352,Manchester,3522305,Manley Park Primary School,355,19550,11404,8146
352,Manchester,3522321,All Saints Primary School,180,17800,10383,7417
352,Manchester,3522324,Medlock Primary School,353,19530,11393,8137
352,Manchester,3522326,Baguley Hall Primary School,402,20020,11678,8342
352,Manchester,3522327,Crumpsall Lane Primary School,352,19520,11387,8133
352,Manchester,3522328,Birchfields Primary School,543,21430,12501,8929
352,Manchester,3522330,Oswald Road Primary School,530,21300,12425,8875
352,Manchester,3522340,Button Lane Primary School,344,19440,11340,8100
352,Manchester,3522341,Benchill Primary School,381,19810,11556,8254
352,Manchester,3523003,Chorlton CofE Primary School,185,17850,10413,7437
352,Manchester,3523005,Holy Trinity CofE Primary School,273,18730,10926,7804
352,Manchester,3523011,St Augustines CofE Primary School,179,17790,10378,7412
352,Manchester,3523015,St Chrysostoms CofE Primary School,354,19540,11398,8142
352,Manchester,3523022,St Margarets CofE Primary School,463,20630,12034,8596
352,Manchester,3523028,St Marys CofE Junior and Infant School,342,19420,11328,8092
352,Manchester,3523034,St Wilfrids CofE Junior and Infant School,185,17850,10413,7437
352,Manchester,3523039,St Pauls CofE Primary School,263,18630,10868,7762
352,Manchester,3523041,St Agnes Cof E Primary School,365,19650,11463,8187
352,Manchester,3523042,St Clements CofE Primary School,181,17810,10389,7421
352,Manchester,3523043,Armitage CofE Primary School,348,19480,11363,8117
352,Manchester,3523044,St Lukes CofE Primary School,359,19590,11428,8162
352,Manchester,3523045,St Johns CofE Primary School,334,19340,11282,8058
352,Manchester,3523301,All Saints CofE Primary School,182,17820,10395,7425
352,Manchester,3523310,St Andrews CofE Primary School,329,19290,11253,8037
352,Manchester,3523316,St James CofE Primary School Birch-in-Rusholme,179,17790,10378,7412
352,Manchester,3523325,St Philips Church of England Primary School,166,17660,10302,7358
352,Manchester,3523402,Christ The King RC Primary School Manchester,349,19490,11369,8121
352,Manchester,3523408,Holy Name Roman Catholic Primary School Manchester,131,17310,10098,7212
352,Manchester,3523415,St Aidans Catholic Primary School,181,17810,10389,7421
352,Manchester,3523418,St Ambrose RC Primary School,160,17600,10267,7333
352,Manchester,3523422,St Annes RC Primary School Crumpsall Manchester,352,19520,11387,8133
352,Manchester,3523429,St Brigids RC Primary School,174,17740,10348,7392
352,Manchester,3523432,St Catherines RC Primary School,348,19480,11363,8117
352,Manchester,3523434,St Chads RC Primary School,179,17790,10378,7412
352,Manchester,3523439,St Dunstans RC Primary School,271,18710,10914,7796
352,Manchester,3523440,St Edmunds RC Primary School,179,17790,10378,7412
352,Manchester,3523445,St Francis RC Primary School,185,17850,10413,7437
352,Manchester,3523446,St John Bosco RC Primary School,182,17820,10395,7425
352,Manchester,3523452,St Malachys RC Primary School,173,17730,10343,7387
352,Manchester,3523455,St Margaret Marys RC Primary School Manchester,269,18690,10903,7787
352,Manchester,3523457,St Marys RC Primary School Manchester,282,18820,10978,7842
352,Manchester,3523460,St Patricks RC Primary School,162,17620,10278,7342
352,Manchester,3523464,Sacred Heart Catholic Primary School,185,17850,10413,7437
352,Manchester,3523465,St Peters Catholic Primary School,176,17760,10360,7400
352,Manchester,3523469,St Wilfrids RC Primary School,157,17570,10249,7321
352,Manchester,3523472,St Willibrords RC Primary School,187,17870,10424,7446
352,Manchester,3523473,St Bernards RC Primary School Manchester,253,18530,10809,7721
352,Manchester,3523475,Our Ladys RC Primary School Manchester,167,17670,10308,7362
352,Manchester,3523482,St Richards RC Primary School,361,19610,11439,8171
352,Manchester,3523484,St Marys CofE Primary School Moston,181,17810,10389,7421
352,Manchester,3523489,St Johns RC Primary School,359,19590,11428,8162
352,Manchester,3523490,CofE School of the Resurrection,183,17830,10401,7429
352,Manchester,3523491,Saviour CofE Primary School,174,17740,10348,7392
352,Manchester,3523494,St Josephs RC Primary School Manchester,179,17790,10378,7412
352,Manchester,3523500,St Cuthberts RC Primary School,237,18370,10716,7654
352,Manchester,3523501,St Clares RC Primary School,365,19650,11463,8187
352,Manchester,3523503,Mount Carmel RC Primary School,360,19600,11433,8167
352,Manchester,3523504,St Annes RC Primary School,166,17660,10302,7358
352,Manchester,3523505,Sacred Heart RC Primary School,216,18160,10593,7567
352,Manchester,3523506,Park View Community Primary,346,19460,11352,8108
352,Manchester,3523507,The Divine Mercy Roman Catholic Primary School,340,19400,11317,8083
352,Manchester,3524271,Abraham Moss Community School,354,19540,11398,8142
352,Manchester,3525200,St Kentigerns RC Primary,299,18990,11078,7912
352,Manchester,3527023,Camberwell Park Specialist Support School,117,17170,10016,7154
352,Manchester,3527029,Lancasterian School,46,16460,9602,6858
352,Manchester,3527041,The Birches School,133,17330,10109,7221
352,Manchester,3527042,Meade Hill School,1,1000,583,417
352,Manchester,3527047,Rodney House School,51,16510,9631,6879
352,Manchester,3527055,Grange School,90,16900,9858,7042
352,Manchester,3527056,Southern Cross School,8,8000,4667,3333
352,Manchester,3527749,Ashgate Specialist Support Primary School,98,16980,9905,7075
352,Manchester,3527007,Manchester Hospital Schools and Home Teaching Service,35,16350,9538,6812
353,Oldham,3531100,Kingsland School,1,1000,583,417
353,Oldham,3532000,Alexandra Park Junior School,352,19520,11387,8133
353,Oldham,3532002,Beever Primary School,180,17800,10383,7417
353,Oldham,3532003,St. Theresas,162,17620,10278,7342
353,Oldham,3532033,Limehurst Community Primary School,260,18600,10850,7750
353,Oldham,3532044,Littlemoor Primary School,255,18550,10821,7729
353,Oldham,3532047,Glodwick Infant and Nursery School,179,17790,10378,7412
353,Oldham,3532052,Mills Hill Primary School,453,20530,11976,8554
353,Oldham,3532054,Mather Street Primary School,157,17570,10249,7321
353,Oldham,3532058,Blackshaw Lane Primary & Nursery School,178,17780,10372,7408
353,Oldham,3532062,South Failsworth Community Primary School,358,19580,11422,8158
353,Oldham,3532064,Whitegate End Primary and Nursery School,180,17800,10383,7417
353,Oldham,3532065,Rushcroft Primary School,180,17800,10383,7417
353,Oldham,3532071,Propps Hall Junior Infant and Nursery School,151,17510,10214,7296
353,Oldham,3532075,Diggle School,162,17620,10278,7342
353,Oldham,3532076,Friezland Primary School,94,16940,9882,7058
353,Oldham,3532077,Greenfield Primary School,177,17770,10366,7404
353,Oldham,3532078,Springhead Infant and Nursery School,144,17440,10173,7267
353,Oldham,3532079,Delph Primary School,177,17770,10366,7404
353,Oldham,3532080,Knowsley Junior School,355,19550,11404,8146
353,Oldham,3532085,Buckstones Primary School,178,17780,10372,7408
353,Oldham,3532091,Beal Vale Primary School,174,17740,10348,7392
353,Oldham,3532095,Broadfield Primary School,274,18740,10932,7808
353,Oldham,3532098,Horton Mill Community Primary School,185,17850,10413,7437
353,Oldham,3532099,Burnley Brow Community School,363,19630,11451,8179
353,Oldham,3532109,Stanley Road Primary School,345,19450,11346,8104
353,Oldham,3532110,Crompton Primary School,182,17820,10395,7425
353,Oldham,3532111,Medlock Valley Community School,264,18640,10873,7767
353,Oldham,3532113,Yew Tree Community School,489,20890,12186,8704
353,Oldham,3533005,Woodhouses Voluntary Primary School,118,17180,10022,7158
353,Oldham,3533009,Holy Trinity CofE Dobcross Primary School,166,17660,10302,7358
353,Oldham,3533010,Thornham St James CofE Primary School,178,17780,10372,7408
353,Oldham,3533011,Christ Church CofE Primary School,79,16790,9794,6996
353,Oldham,3533012,Hey-with-Zion Primary School,242,18420,10745,7675
353,Oldham,3533303,St Thomas Moorside CofE (VA) Primary School,181,17810,10389,7421
353,Oldham,3533315,St Thomas CofE Primary School,363,19630,11451,8179
353,Oldham,3533325,St Hughs CofE Primary School,173,17730,10343,7387
353,Oldham,3533326,St Agnes CofE Primary School,88,16880,9847,7033
353,Oldham,3533328,Holy Rosary RC Junior Infant and Nursery School,176,17760,10360,7400
353,Oldham,3533329,St Hildas CofE Primary School,340,19400,11317,8083
353,Oldham,3533330,St Martins CofE Junior Infant and Nursery School,210,18100,10558,7542
353,Oldham,3533333,St Margarets CofE Junior Infant and Nursery School,242,18420,10745,7675
353,Oldham,3533341,Christ Church CofE Primary School,240,18400,10733,7667
353,Oldham,3533342,St Lukes CofE Primary School,176,17760,10360,7400
353,Oldham,3533344,St Matthews CofE Primary School,349,19490,11369,8121
353,Oldham,3533345,East Crompton St James CofE Primary School,180,17800,10383,7417
353,Oldham,3533346,St Marys CofE Primary School High Crompton,181,17810,10389,7421
353,Oldham,3533351,St Thomas Leesfield CofE Primary School,180,17800,10383,7417
353,Oldham,3533353,St Annes CofE (Aided) Primary School,237,18370,10716,7654
353,Oldham,3533358,Corpus Christi RC Primary School,267,18670,10891,7779
353,Oldham,3533359,St Josephs RC Junior Infant and Nursery School,180,17800,10383,7417
353,Oldham,3533362,St Edwards RC School,217,18170,10599,7571
353,Oldham,3533363,Ss Aidan and Oswalds Roman Catholic Primary School,341,19410,11323,8087
353,Oldham,3533364,St Herberts RC School,249,18490,10786,7704
353,Oldham,3533366,Greenfield St Marys CofE School,180,17800,10383,7417
353,Oldham,3533393,Holy Cross CofE Primary School,361,19610,11439,8171
353,Oldham,3533400,Holy Family RC Primary School,173,17730,10343,7387
353,Oldham,3533401,St Annes RC Primary School,185,17850,10413,7437
353,Oldham,3533402,St Patricks RC Primary and Nursery School,180,17800,10383,7417
353,Oldham,3533403,St Marys RC Primary School,357,19570,11416,8154
353,Oldham,3533503,St Pauls CofE Primary School,187,17870,10424,7446
353,Oldham,3533504,Higher Failsworth Primary School,337,19370,11299,8071
353,Oldham,3533506,Bare Trees Primary School,519,21190,12361,8829
353,Oldham,3533507,Royton Hall Primary School,264,18640,10873,7767
353,Oldham,3533509,Hodge Clough Primary School,349,19490,11369,8121
354,Rochdale,3541100,Rochdale Pupil Referral Service,15,15000,8750,6250
354,Rochdale,3542000,Brimrod Community Primary School,179,17790,10378,7412
354,Rochdale,3542001,Broadfield Community Primary School,356,19560,11410,8150
354,Rochdale,3542002,Castleton Primary School,194,17940,10465,7475
354,Rochdale,3542003,Shawclough Community Primary School,353,19530,11393,8137
354,Rochdale,3542006,Greenbank Primary School,368,19680,11480,8200
354,Rochdale,3542009,Heybrook Primary School,511,21110,12314,8796
354,Rochdale,3542015,Meanwood Community Nursery and Primary School,353,19530,11393,8137
354,Rochdale,3542018,Norden Community Primary School,360,19600,11433,8167
354,Rochdale,3542021,Spotland Primary School,352,19520,11387,8133
354,Rochdale,3542024,Lowerplace Primary School,442,20420,11912,8508
354,Rochdale,3542025,Marland Hill Community Primary School,365,19650,11463,8187
354,Rochdale,3542027,Caldershaw Primary School,180,17800,10383,7417
354,Rochdale,3542028,Belfield Community School,276,18760,10943,7817
354,Rochdale,3542029,Whittaker Moss Primary School,291,18910,11031,7879
354,Rochdale,3542032,Ashfield Valley Primary School,178,17780,10372,7408
354,Rochdale,3542036,Littleborough Community Primary School,349,19490,11369,8121
354,Rochdale,3542039,Alkrington Primary School,353,19530,11393,8137
354,Rochdale,3542041,Boarshaw Community Primary School,236,18360,10710,7650
354,Rochdale,3542043,Moorhouse Primary School,196,17960,10477,7483
354,Rochdale,3542044,Newhey Community Primary School,238,18380,10722,7658
354,Rochdale,3542047,Elm Wood Primary School,351,19510,11381,8129
354,Rochdale,3542048,Hollin Primary School,277,18770,10949,7821
354,Rochdale,3542061,Harwood Park Primary School,283,18830,10984,7846
354,Rochdale,3542062,Heap Bridge Village Primary School,150,17500,10208,7292
354,Rochdale,3542063,Hopwood Community Primary School,329,19290,11253,8037
354,Rochdale,3542064,Parkfield Primary School,181,17810,10389,7421
354,Rochdale,3542065,Hamer Community Primary School,259,18590,10844,7746
354,Rochdale,3543002,St Edwards Church of England Primary School,308,19080,11130,7950
354,Rochdale,3543003,St Peters Church of England Primary School,354,19540,11398,8142
354,Rochdale,3543004,St Marys Church of England Primary School Balderstone,173,17730,10343,7387
354,Rochdale,3543006,St Lukes Church of England Primary School,239,18390,10728,7662
354,Rochdale,3543007,St Johns VA Church of England Primary School Thornham,76,16760,9777,6983
354,Rochdale,3543011,St Gabriels Church of England Primary School,179,17790,10378,7412
354,Rochdale,3543013,Stansfield Hall Church of England/Free Church Primary School,123,17230,10051,7179
354,Rochdale,3543014,All Souls Church of England Primary School,178,17780,10372,7408
354,Rochdale,3543016,Little Heaton Church of England Primary School,173,17730,10343,7387
354,Rochdale,3543305,St Michaels Church of England Primary School Bamford,181,17810,10389,7421
354,Rochdale,3543306,Holy Trinity Church of England Primary School,195,17950,10471,7479
354,Rochdale,3543307,St Margarets Church of England Primary School,179,17790,10378,7412
354,Rochdale,3543310,St Marys Roman Catholic Primary School Littleborough,176,17760,10360,7400
354,Rochdale,3543311,St Peters Roman Catholic Primary School Rochdale,222,18220,10628,7592
354,Rochdale,3543312,St Marys Roman Catholic Primary School Middleton,363,19630,11451,8179
354,Rochdale,3543314,Our Lady and St Pauls Roman Catholic Primary School Heywood,172,17720,10337,7383
354,Rochdale,3543319,St Thomas More Roman Catholic Primary School Middleton Rochdale,267,18670,10891,7779
354,Rochdale,3543321,Middleton Parish Church School,320,19200,11200,8000
354,Rochdale,3543322,St Michaels Church of England Primary School Alkrington,181,17810,10389,7421
354,Rochdale,3543323,Milnrow Parish Church of England Primary School,178,17780,10372,7408
354,Rochdale,3543325,St Thomas Church of England Primary School,131,17310,10098,7212
354,Rochdale,3543500,St Gabriels Roman Catholic Primary School Rochdale,180,17800,10383,7417
354,Rochdale,3543501,St Johns Roman Catholic Primary School Rochdale,201,18010,10506,7504
354,Rochdale,3543505,Sacred Heart Roman Catholic Primary School Rochdale,179,17790,10378,7412
354,Rochdale,3543506,All Saints Church of England Primary School,178,17780,10372,7408
354,Rochdale,3543507,Holy Family Roman Catholic Primary School Rochdale,184,17840,10407,7433
354,Rochdale,3543508,St Vincents Roman Catholic Primary School Rochdale,355,19550,11404,8146
354,Rochdale,3543510,St Josephs Roman Catholic Primary School Rochdale,298,18980,11072,7908
354,Rochdale,3543511,Sandbrook Community Primary School,471,20710,12081,8629
354,Rochdale,3543512,Woodland Community Primary School,421,20210,11789,8421
354,Rochdale,3543513,Bowlee Park Community Primary School,580,21800,12717,9083
354,Rochdale,3545200,Crossgates Primary School,262,18620,10862,7758
354,Rochdale,3545201,Smithy Bridge Foundation Primary School,353,19530,11393,8137
354,Rochdale,3545203,St John Fisher Roman Catholic Primary School Rochdale,178,17780,10372,7408
354,Rochdale,3545204,Healey Foundation Primary School,176,17760,10360,7400
354,Rochdale,3547006,Brownhill School,17,16170,9433,6737
354,Rochdale,3547013,Springside,89,16890,9853,7037
354,Rochdale,3547014,Newlands School,88,16880,9847,7033
355,Salford,3551103,Alder Brook,21,16210,9456,6754
355,Salford,3552007,Light Oaks Junior School,353,19530,11393,8137
355,Salford,3552011,Lower Kersal Community Primary School,195,17950,10471,7479
355,Salford,3552026,Summerville Primary School,204,18040,10523,7517
355,Salford,3552036,Brentnall Primary School,196,17960,10477,7483
355,Salford,3552037,Light Oaks Infant School,167,17670,10308,7362
355,Salford,3552040,The Friars Primary School,219,18190,10611,7579
355,Salford,3552041,River View Community Primary School,397,19970,11649,8321
355,Salford,3552042,Willow Tree Primary School,382,19820,11562,8258
355,Salford,3552043,Holy Family VA RC Primary School,176,17760,10360,7400
355,Salford,3552051,Wharton Primary School,257,18570,10833,7737
355,Salford,3552052,Irlam Primary School,312,19120,11153,7967
355,Salford,3552057,Clarendon Road Community Primary School,259,18590,10844,7746
355,Salford,3552059,Lewis Street Primary School,283,18830,10984,7846
355,Salford,3552061,Monton Green Primary School,330,19300,11258,8042
355,Salford,3552062,Westwood Park Community Primary School,259,18590,10844,7746
355,Salford,3552063,Beech Street Community Primary School,208,18080,10547,7533
355,Salford,3552065,Clifton Primary School,259,18590,10844,7746
355,Salford,3552070,Moorside Primary School,509,21090,12303,8787
355,Salford,3552072,Mesne Lea Primary School,315,19150,11171,7979
355,Salford,3552073,Bridgewater Primary School,319,19190,11194,7996
355,Salford,3552074,Peel Hall Primary School,327,19270,11241,8029
355,Salford,3552075,Hilton Lane Primary School,170,17700,10325,7375
355,Salford,3552076,Moorfield Community Primary School,113,17130,9993,7137
355,Salford,3552081,Fiddlers Lane Community Primary School,174,17740,10348,7392
355,Salford,3552082,James Brindley Community Primary School,218,18180,10605,7575
355,Salford,3552088,North Walkden Primary School,162,17620,10278,7342
355,Salford,3552091,The Deans Primary School,179,17790,10378,7412
355,Salford,3552092,Mossfield Primary School,330,19300,11258,8042
355,Salford,3552095,Grosvenor Road Primary School,389,19890,11603,8287
355,Salford,3552096,Cadishead Primary School,311,19110,11148,7962
355,Salford,3552097,Ellenbrook Community Primary School,252,18520,10803,7717
355,Salford,3552098,Lark Hill Community Primary School,413,20130,11743,8387
355,Salford,3553006,St Pauls CofE Primary School,151,17510,10214,7296
355,Salford,3553008,St Johns CofE Primary School,287,18870,11008,7862
355,Salford,3553017,St Lukes CofE Primary School,294,18940,11048,7892
355,Salford,3553025,St Georges CofE Primary School,160,17600,10267,7333
355,Salford,3553030,St Andrews CofE Primary School,351,19510,11381,8129
355,Salford,3553031,St Andrews CofE Primary School,166,17660,10302,7358
355,Salford,3553033,Christ Church CofE Primary School,163,17630,10284,7346
355,Salford,3553034,St Marys CofE Primary School,162,17620,10278,7342
355,Salford,3553037,St Pauls CofE Primary School,189,17890,10436,7454
355,Salford,3553039,St Andrews Methodist Primary School,190,17900,10442,7458
355,Salford,3553040,Irlam Endowed Primary School,182,17820,10395,7425
355,Salford,3553041,Wardley CofE Primary School,170,17700,10325,7375
355,Salford,3553042,St Pauls Peel CofE Primary School,256,18560,10827,7733
355,Salford,3553043,Boothstown Methodist Primary School,176,17760,10360,7400
355,Salford,3553302,St Pauls CofE Primary School,173,17730,10343,7387
355,Salford,3553317,St Philips CofE Primary School,141,17410,10156,7254
355,Salford,3553504,St Pauls CofE Primary School,177,17770,10366,7404
355,Salford,3553506,Godfrey Ermen Memorial CofE Primary School,296,18960,11060,7900
355,Salford,3553511,St Peters CofE Primary School,173,17730,10343,7387
355,Salford,3553512,St Marks CofE Primary School,318,19180,11188,7992
355,Salford,3553513,Christ The King RC Primary School,182,17820,10395,7425
355,Salford,3553514,St Teresas RC Primary School,199,17990,10494,7496
355,Salford,3553515,Holy Cross and All Saints RC Primary School,194,17940,10465,7475
355,Salford,3553516,St Marys RC Primary School,179,17790,10378,7412
355,Salford,3553518,St Gilberts RC Primary School,208,18080,10547,7533
355,Salford,3553519,St Charles RC Primary School,191,17910,10448,7462
355,Salford,3553520,St Marks RC Primary School,180,17800,10383,7417
355,Salford,3553521,St Marys RC Primary School,205,18050,10529,7521
355,Salford,3553525,St Joseph the Worker RC Primary School,179,17790,10378,7412
355,Salford,3553602,St Boniface RC Primary School,174,17740,10348,7392
355,Salford,3553609,St Sebastians RC Primary School,175,17750,10354,7396
355,Salford,3553612,The Cathedral School of St Peter and St John RC Primary,166,17660,10302,7358
355,Salford,3553615,St Josephs RC Primary School,140,17400,10150,7250
355,Salford,3553618,St Lukes RC Primary School,354,19540,11398,8142
355,Salford,3553622,St Philips RC Primary School,290,18900,11025,7875
355,Salford,3553625,St Thomas of Canterbury RC Primary School,372,19720,11503,8217
355,Salford,3553803,Primrose Hill Primary School and Childrens Centre,307,19070,11124,7946
355,Salford,3553806,St Edmunds RC Primary School,283,18830,10984,7846
355,Salford,3557029,Springwood Primary School,174,17740,10348,7392
356,Stockport,3562000,Adswood Primary School,240,18400,10733,7667
356,Stockport,3562005,Banks Lane Infant School,181,17810,10389,7421
356,Stockport,3562006,Banks Lane Junior School,352,19520,11387,8133
356,Stockport,3562007,Bolshaw Primary School,182,17820,10395,7425
356,Stockport,3562012,Bridge Hall Primary School,144,17440,10173,7267
356,Stockport,3562015,Broadstone Hall Primary School,425,20250,11813,8437
356,Stockport,3562017,Brookside Primary School,153,17530,10226,7304
356,Stockport,3562021,Cheadle Primary School,227,18270,10658,7612
356,Stockport,3562027,Dial Park Primary School,247,18470,10774,7696
356,Stockport,3562030,Etchells Primary School,349,19490,11369,8121
356,Stockport,3562032,Fairway Primary School,180,17800,10383,7417
356,Stockport,3562037,Great Moor Infant School,163,17630,10284,7346
356,Stockport,3562038,Great Moor Junior  School,324,19240,11223,8017
356,Stockport,3562039,Greave Primary School,217,18170,10599,7571
356,Stockport,3562044,High Lane Primary School,155,17550,10238,7312
356,Stockport,3562046,Hursthead Infant School,176,17760,10360,7400
356,Stockport,3562048,Ladybridge Primary School,151,17510,10214,7296
356,Stockport,3562049,Ladybrook Primary School,180,17800,10383,7417
356,Stockport,3562052,Lark Hill Primary School,122,17220,10045,7175
356,Stockport,3562053,Ludworth Primary School,290,18900,11025,7875
356,Stockport,3562058,Mersey Vale Primary School,171,17710,10331,7379
356,Stockport,3562063,Nevill Road Infant School,170,17700,10325,7375
356,Stockport,3562064,Nevill Road Junior School,302,19020,11095,7925
356,Stockport,3562066,Norbury Hall Primary School,357,19570,11416,8154
356,Stockport,3562067,Norris Bank Primary School,357,19570,11416,8154
356,Stockport,3562079,Prospect Vale Primary School,176,17760,10360,7400
356,Stockport,3562080,Queensgate Primary School,186,17860,10418,7442
356,Stockport,3562081,Oak Tree Primary School,452,20520,11970,8550
356,Stockport,3562082,Abingdon Primary School,222,18220,10628,7592
356,Stockport,3562083,Romiley Primary School,373,19730,11509,8221
356,Stockport,3562084,Rose Hill Primary School,457,20570,11999,8571
356,Stockport,3562087,Thorn Grove Primary School,186,17860,10418,7442
356,Stockport,3562088,Tithe Barn Primary School,184,17840,10407,7433
356,Stockport,3562089,Torkington Primary School,180,17800,10383,7417
356,Stockport,3562090,Vernon Park Primary School,241,18410,10739,7671
356,Stockport,3562091,Warren Wood Primary School,276,18760,10943,7817
356,Stockport,3562092,Whitehill Primary School,151,17510,10214,7296
356,Stockport,3562103,Pownall Green Primary School,354,19540,11398,8142
356,Stockport,3562104,Moss Hey Primary School,181,17810,10389,7421
356,Stockport,3562105,Cale Green Primary School,204,18040,10523,7517
356,Stockport,3562107,Lum Head Primary School,209,18090,10553,7537
356,Stockport,3562108,Outwood Primary School,173,17730,10343,7387
356,Stockport,3562111,Lane End Primary School,180,17800,10383,7417
356,Stockport,3562112,Didsbury Road Primary School,388,19880,11597,8283
356,Stockport,3562113,Hazel Grove Primary School,313,19130,11159,7971
356,Stockport,3562114,Arden Primary School,327,19270,11241,8029
356,Stockport,3562116,Bradshaw Hall Primary School,370,19700,11492,8208
356,Stockport,3562119,Westmorland Primary School,354,19540,11398,8142
356,Stockport,3562120,Cheadle Heath Primary School,234,18340,10698,7642
356,Stockport,3562284,Alexandra Park Primary School,355,19550,11404,8146
356,Stockport,3563000,All Saints Church of England Primary School Marple,181,17810,10389,7421
356,Stockport,3563001,All Saints Church of England Primary School Stockport,165,17650,10296,7354
356,Stockport,3563002,St Marks Church of England Primary School,235,18350,10704,7646
356,Stockport,3563005,St Johns Church of England Primary School,175,17750,10354,7396
356,Stockport,3563006,St Marys Church of England Primary School,177,17770,10366,7404
356,Stockport,3563008,St Pauls Church of England Primary School Brinnington,238,18380,10722,7658
356,Stockport,3563009,St Thomas Church of England Primary School Stockport,145,17450,10179,7271
356,Stockport,3563010,St Elisabeths Church of England Primary School,208,18080,10547,7533
356,Stockport,3563500,Cheadle Catholic Infant School,180,17800,10383,7417
356,Stockport,3563501,Cheadle Catholic Junior School,357,19570,11416,8154
356,Stockport,3563505,North Cheshire Jewish Primary School,199,17990,10494,7496
356,Stockport,3563506,Our Ladys Catholic Primary School,171,17710,10331,7379
356,Stockport,3563507,St Ambrose Catholic Primary School,167,17670,10308,7362
356,Stockport,3563509,St Bernadettes Catholic Primary School,167,17670,10308,7362
356,Stockport,3563510,St Christophers Catholic Primary School,183,17830,10401,7429
356,Stockport,3563515,St Josephs Stockport Catholic Primary School,144,17440,10173,7267
356,Stockport,3563517,St Marys Roman Catholic Primary School Stockport,118,17180,10022,7158
356,Stockport,3563518,St Peters Catholic Primary School,179,17790,10378,7412
356,Stockport,3563519,St Philips Catholic Primary School,172,17720,10337,7383
356,Stockport,3563520,St Simons Catholic Primary School,146,17460,10185,7275
356,Stockport,3563521,St Thomas Church of England Primary School Heaton Chapel,390,19900,11608,8292
356,Stockport,3563522,St Winifreds Roman Catholic Primary School Stockport,354,19540,11398,8142
356,Stockport,3563524,St Georges Church of England Primary School,334,19340,11282,8058
356,Stockport,3563525,Woodley Primary School,357,19570,11416,8154
356,Stockport,3563526,Moorfield Primary School,377,19770,11533,8237
356,Stockport,3563529,Vale View Primary School,414,20140,11748,8392
356,Stockport,3563530,St. Josephs Catholic Primary School Reddish,423,20230,11801,8429
356,Stockport,3567504,Valley School,34,16340,9532,6808
356,Stockport,3567506,Lisburne School,85,16850,9829,7021
356,Stockport,3567510,Oakgrove School,35,16350,9538,6812
357,Tameside,3571103,Tameside Pupil Referral Service,10,10000,5833,4167
357,Tameside,3572001,Greenfield Primary School and Early Years Centre,244,18440,10757,7683
357,Tameside,3572004,Hollingworth Primary School,150,17500,10208,7292
357,Tameside,3572006,Pinfold Primary School,334,19340,11282,8058
357,Tameside,3572011,Arundale Primary School,164,17640,10290,7350
357,Tameside,3572018,Gorse Hall Primary and Nursery School,357,19570,11416,8154
357,Tameside,3572019,Stalyhill Junior School,233,18330,10693,7637
357,Tameside,3572020,Arlies Primary School,206,18060,10535,7525
357,Tameside,3572021,Buckton Vale Primary School,253,18530,10809,7721
357,Tameside,3572024,Lyndhurst Community Primary School,199,17990,10494,7496
357,Tameside,3572025,Broadbent Fold Primary School and Nursery,180,17800,10383,7417
357,Tameside,3572026,Wild Bank Community School,145,17450,10179,7271
357,Tameside,3572027,Millbrook Primary School,175,17750,10354,7396
357,Tameside,3572037,The Heys Primary School,208,18080,10547,7533
357,Tameside,3572039,Audenshaw Primary School,183,17830,10401,7429
357,Tameside,3572042,Russell Scott Primary School,356,19560,11410,8150
357,Tameside,3572045,Fairfield Road Primary School,357,19570,11416,8154
357,Tameside,3572051,Livingstone Primary School,125,17250,10063,7187
357,Tameside,3572055,Aldwyn Primary School,295,18950,11054,7896
357,Tameside,3572056,St Annes Primary School,176,17760,10360,7400
357,Tameside,3572058,Corrie Primary School,308,19080,11130,7950
357,Tameside,3572063,Holden Clough Community Primary School,273,18730,10926,7804
357,Tameside,3572064,Dane Bank Primary School,182,17820,10395,7425
357,Tameside,3572068,Greswell Primary School and Nursery,346,19460,11352,8108
357,Tameside,3572073,Stalyhill Infant School,120,17200,10033,7167
357,Tameside,3572081,Ravensfield Primary School,356,19560,11410,8150
357,Tameside,3573000,Gee Cross Holy Trinity CofE  (VC) Primary School,177,17770,10366,7404
357,Tameside,3573001,Broadbottom Church of England Primary School,99,16990,9911,7079
357,Tameside,3573003,St Johns CofE Primary School Dukinfield,232,18320,10687,7633
357,Tameside,3573019,Hurst Knoll St James Church of England Primary School,177,17770,10366,7404
357,Tameside,3573022,St James CofE Primary School Ashton-under-Lyne,179,17790,10378,7412
357,Tameside,3573026,Milton St Johns CofE Primary School,200,18000,10500,7500
357,Tameside,3573027,Micklehurst All Saints CofE Primary School,172,17720,10337,7383
357,Tameside,3573301,St Georges CofE Primary School,175,17750,10354,7396
357,Tameside,3573303,Mottram CofE Primary School,115,17150,10004,7146
357,Tameside,3573304,St Pauls Catholic Primary School,198,17980,10488,7492
357,Tameside,3573305,St James Catholic Primary School,138,17380,10138,7242
357,Tameside,3573308,St Marys Catholic Primary School,186,17860,10418,7442
357,Tameside,3573309,St Peters Catholic Primary School,184,17840,10407,7433
357,Tameside,3573310,St Raphaels Catholic Primary School,168,17680,10313,7367
357,Tameside,3573312,Holy Trinity CofE Primary School,182,17820,10395,7425
357,Tameside,3573313,St Peters CofE Primary School,178,17780,10372,7408
357,Tameside,3573314,St Stephens CofE Primary School,177,17770,10366,7404
357,Tameside,3573316,St Marys CofE Primary School,181,17810,10389,7421
357,Tameside,3573317,St Georges CofE Primary School,137,17370,10133,7237
357,Tameside,3573319,Canon Burrows CofE Primary School,369,19690,11486,8204
357,Tameside,3573322,St Marys RC Primary School,184,17840,10407,7433
357,Tameside,3573323,St Stephens RC Primary School,350,19500,11375,8125
357,Tameside,3573324,St Josephs RC Primary School,140,17400,10150,7250
357,Tameside,3573325,St John Fisher RC Primary School Denton,184,17840,10407,7433
357,Tameside,3573326,St Christophers RC Primary School,195,17950,10471,7479
357,Tameside,3573327,St Annes RC Primary School,181,17810,10389,7421
357,Tameside,3573331,Our Lady of Mount Carmel RC Primary School Ashton-under-Lyne,176,17760,10360,7400
357,Tameside,3577002,Thomas Ashton School,27,16270,9491,6779
357,Tameside,3577009,Oakdale School,83,16830,9818,7012
358,Trafford,3582000,Navigation Primary School,356,19560,11410,8150
358,Trafford,3582002,Oldfield Brow Primary School,271,18710,10914,7796
358,Trafford,3582003,Stamford Park Junior School,277,18770,10949,7821
358,Trafford,3582004,Stamford Park Infant School,140,17400,10150,7250
358,Trafford,3582006,Heyes Lane Primary School,546,21460,12518,8942
358,Trafford,3582007,Broadheath Primary School,328,19280,11247,8033
358,Trafford,3582008,Broomwood Primary School,330,19300,11258,8042
358,Trafford,3582011,Well Green Primary School,189,17890,10436,7454
358,Trafford,3582012,Willows Primary School,227,18270,10658,7612
358,Trafford,3582013,Cloverlea Primary School,180,17800,10383,7417
358,Trafford,3582019,Springfield Primary School,480,20800,12133,8667
358,Trafford,3582021,Woodheys Primary School,383,19830,11568,8262
358,Trafford,3582022,Worthington Primary School,265,18650,10879,7771
358,Trafford,3582023,Brooklands Primary School,419,20190,11778,8412
358,Trafford,3582025,Firs Primary School,338,19380,11305,8075
358,Trafford,3582026,Wellfield Junior School,244,18440,10757,7683
358,Trafford,3582033,Moorlands Junior School,239,18390,10728,7662
358,Trafford,3582037,Templemoor Infant and Nursery School,122,17220,10045,7175
358,Trafford,3582039,Wellfield Infant and Nursery School,126,17260,10068,7192
358,Trafford,3582041,Urmston Primary School,421,20210,11789,8421
358,Trafford,3582042,Davyhulme Primary School,422,20220,11795,8425
358,Trafford,3582044,Flixton Primary School,362,19620,11445,8175
358,Trafford,3582047,Gorse Hill Primary School,319,19190,11194,7996
358,Trafford,3582049,Kings Road Primary School,491,20910,12198,8712
358,Trafford,3582050,Moss Park Junior School,253,18530,10809,7721
358,Trafford,3582051,Moss Park Infant School,122,17220,10045,7175
358,Trafford,3582052,Seymour Park Community Primary School,503,21030,12268,8762
358,Trafford,3582056,Victoria Park Junior School,246,18460,10768,7692
358,Trafford,3582057,Victoria Park Infant School,121,17210,10039,7171
358,Trafford,3582058,Highfield Primary School,236,18360,10710,7650
358,Trafford,3582061,Woodhouse Primary School,181,17810,10389,7421
358,Trafford,3582063,Kingsway Primary School,174,17740,10348,7392
358,Trafford,3582077,St Anns RC Primary School,351,19510,11381,8129
358,Trafford,3583005,St Matthews CofE Primary School,173,17730,10343,7387
358,Trafford,3583301,Bowdon CofE Primary School,451,20510,11964,8546
358,Trafford,3583304,St Hughs Catholic Primary School,555,21550,12571,8979
358,Trafford,3583305,Altrincham CofE (Aided) Primary School,275,18750,10938,7812
358,Trafford,3583307,St Annes CofE Primary School,197,17970,10483,7487
358,Trafford,3583308,St Marys CofE Primary School,209,18090,10553,7537
358,Trafford,3583309,Holy Family Catholic Primary School,178,17780,10372,7408
358,Trafford,3583310,Our Lady of Lourdes Catholic Primary School,161,17610,10273,7337
358,Trafford,3583311,All Saints Catholic Primary School,178,17780,10372,7408
358,Trafford,3583312,St Josephs Catholic Primary School,390,19900,11608,8292
358,Trafford,3583313,St Marys CofE Primary School,177,17770,10366,7404
358,Trafford,3583314,St Michaels CofE (Aided) Primary School,181,17810,10389,7421
358,Trafford,3583316,St Hildas CofE Primary School,267,18670,10891,7779
358,Trafford,3583318,English Martyrs RC Primary School,175,17750,10354,7396
358,Trafford,3583319,St Hugh of Lincoln RC Primary School,269,18690,10903,7787
358,Trafford,3583324,St Teresas RC Primary School,179,17790,10378,7412
358,Trafford,3583325,St Monicas RC Primary School,261,18610,10856,7754
358,Trafford,3583327,Our Lady of the Rosary RC Primary School,181,17810,10389,7421
358,Trafford,3583330,St Margaret Ward Catholic Primary School,181,17810,10389,7421
358,Trafford,3583331,St Alphonsus RC Primary School,167,17670,10308,7362
358,Trafford,3583332,St Vincents Catholic Primary School,544,21440,12507,8933
358,Trafford,3587003,Longford Park School,59,16590,9678,6912
358,Trafford,3587005,Delamere School,63,16630,9701,6929
359,Wigan,3592000,Beech Hill Community Primary School,202,18020,10512,7508
359,Wigan,3592007,Woodfield Primary School,181,17810,10389,7421
359,Wigan,3592009,Marsh Green Primary School,196,17960,10477,7483
359,Wigan,3592010,Wigan Worsley Mesnes Community Primary School,177,17770,10366,7404
359,Wigan,3592013,Mabs Cross Primary School,409,20090,11719,8371
359,Wigan,3592017,Winstanley Community Primary School,350,19500,11375,8125
359,Wigan,3592026,Orrell Newfold Community Primary School,356,19560,11410,8150
359,Wigan,3592030,Abram Bryn Gates Primary School,169,17690,10319,7371
359,Wigan,3592031,Hindley Junior and Infant School,180,17800,10383,7417
359,Wigan,3592033,Britannia Bridge Primary School,178,17780,10372,7408
359,Wigan,3592034,Leigh Central Primary School,201,18010,10506,7504
359,Wigan,3592037,Golborne Community Primary School,261,18610,10856,7754
359,Wigan,3592039,Lowton Junior and Infant School,181,17810,10389,7421
359,Wigan,3592040,Newton Westpark Primary School,178,17780,10372,7408
359,Wigan,3592043,R L Hughes Primary School,365,19650,11463,8187
359,Wigan,3592045,Meadowbank Primary School & Childrens Centre,167,17670,10308,7362
359,Wigan,3592046,Parklee Community School,252,18520,10803,7717
359,Wigan,3592047,Wood Fold Primary School,349,19490,11369,8121
359,Wigan,3592049,Lowton West Primary School,358,19580,11422,8158
359,Wigan,3592050,Shevington Vale Primary School,164,17640,10290,7350
359,Wigan,3592051,Nicol Mere School,311,19110,11148,7962
359,Wigan,3592053,Gilded Hollins Community School,178,17780,10372,7408
359,Wigan,3592058,Garrett Hall Primary School,379,19790,11544,8246
359,Wigan,3592062,Millbrook Primary School,179,17790,10378,7412
359,Wigan,3593010,Bryn St Peters CofE Primary School,179,17790,10378,7412
359,Wigan,3593015,Hindsford CofE Primary School,178,17780,10372,7408
359,Wigan,3593023,Chowbent Primary School,158,17580,10255,7325
359,Wigan,3593029,St Marys CofE Primary School,219,18190,10611,7579
359,Wigan,3593030,St Thomas CofE Primary School Leigh,361,19610,11439,8171
359,Wigan,3593300,Wigan St Andrews CofE Junior and Infant School,181,17810,10389,7421
359,Wigan,3593308,St Johns CofE Primary School,176,17760,10360,7400
359,Wigan,3593326,St Mary and St John Catholic Primary School,177,17770,10366,7404
359,Wigan,3593329,St Patricks Catholic Primary School,267,18670,10891,7779
359,Wigan,3593331,Sacred Heart Catholic Primary School,357,19570,11416,8154
359,Wigan,3593336,St Aidans Catholic Primary School Wigan,274,18740,10932,7808
359,Wigan,3593338,St Catharines CofE Primary School,176,17760,10360,7400
359,Wigan,3593350,St Thomas CofE Primary School,177,17770,10366,7404
359,Wigan,3593358,Standish Lower Ground St Annes CofE Primary School,106,17060,9952,7108
359,Wigan,3593361,Bickershaw CofE Primary School,118,17180,10022,7158
359,Wigan,3593362,Hindley All Saints CofE Primary School,173,17730,10343,7387
359,Wigan,3593363,Castle Hill St Philips CofE Primary School,166,17660,10302,7358
359,Wigan,3593367,Ince CofE Primary School,350,19500,11375,8125
359,Wigan,3593370,St Michaels CofE Primary School Howe Bridge,182,17820,10395,7425
359,Wigan,3593373,Westleigh St Pauls CofE Primary School,176,17760,10360,7400
359,Wigan,3593374,St Stephens CofE Primary School,178,17780,10372,7408
359,Wigan,3593376,St Johns CofE Primary School Mosley Common,139,17390,10144,7246
359,Wigan,3593377,St Lukes CofE Primary School,181,17810,10389,7421
359,Wigan,3593378,Lowton St Marys CofE (Voluntary Aided) Primary School,178,17780,10372,7408
359,Wigan,3593379,St Thomas CofE Junior and Infant School,181,17810,10389,7421
359,Wigan,3593382,St Oswalds Catholic Primary School,295,18950,11054,7896
359,Wigan,3593383,Our Lady Immaculate Catholic Primary School,117,17170,10016,7154
359,Wigan,3593386,Our Ladys RC Primary School Wigan,162,17620,10278,7342
359,Wigan,3593387,Holy Family Catholic Primary School New Springs Wigan,116,17160,10010,7150
359,Wigan,3593388,St James Catholic Primary School Orrell,335,19350,11288,8062
359,Wigan,3593389,St Maries Catholic Primary School Standish,171,17710,10331,7379
359,Wigan,3593390,St Benedicts Catholic Primary School Hindley,178,17780,10372,7408
359,Wigan,3593393,Holy Family Catholic Primary School Platt Bridge,155,17550,10238,7312
359,Wigan,3593394,St Williams Catholic Primary School,172,17720,10337,7383
359,Wigan,3593396,St Richards Roman Catholic Primary School Atherton,128,17280,10080,7200
359,Wigan,3593397,Sacred Heart RC Primary School,169,17690,10319,7371
359,Wigan,3593400,St Josephs Catholic Primary School Leigh,179,17790,10378,7412
359,Wigan,3593403,Sacred Heart Catholic Primary School Leigh,249,18490,10786,7704
359,Wigan,3593405,Twelve Apostles Catholic Primary School,177,17770,10366,7404
359,Wigan,3593406,Holy Family Catholic Primary School,178,17780,10372,7408
359,Wigan,3593407,All Saints Catholic Primary School Golborne Wigan,176,17760,10360,7400
359,Wigan,3593411,St Gabriels Catholic Primary School,251,18510,10798,7712
359,Wigan,3593412,St Catherines Catholic Primary School Lowton,168,17680,10313,7367
359,Wigan,3593413,St Bernadettes Catholic Primary School,172,17720,10337,7383
359,Wigan,3593414,St Wilfrids Catholic Primary School,166,17660,10302,7358
359,Wigan,3593415,St Ambrose Barlow Catholic Primary School,178,17780,10372,7408
359,Wigan,3593419,Christ Church CofE Primary School Pennington,180,17800,10383,7417
359,Wigan,3593423,St Philips CofE Primary School Atherton,333,19330,11276,8054
359,Wigan,3593424,Leigh St Marys CofE Primary School,149,17490,10203,7287
359,Wigan,3593425,Leigh St Johns CofE Primary,164,17640,10290,7350
359,Wigan,3593426,Aspull Church Primary School,175,17750,10354,7396
359,Wigan,3593431,St Judes Catholic Primary School Wigan,173,17730,10343,7387
359,Wigan,3593432,Sacred Heart Catholic Primary School Hindley Green,164,17640,10290,7350
359,Wigan,3593433,St Cuthberts Catholic Primary School Wigan,327,19270,11241,8029
359,Wigan,3593434,Tyldesley St Georges Central CofE Primary School and Nursery,248,18480,10780,7700
359,Wigan,3593437,Westfield Community School,375,19750,11521,8229
359,Wigan,3593438,Leigh St Peters CofE Primary School,313,19130,11159,7971
359,Wigan,3597001,Landgate School Bryn,41,16410,9573,6837
359,Wigan,3597002,Hope School,83,16830,9818,7012
359,Wigan,3597018,Willow Grove Primary School,56,16560,9660,6900
359,Wigan,3597020,Rowan Tree Primary School,87,16870,9841,7029
370,Barnsley,3702000,Penistone St Johns Voluntary Aided Primary School,405,20050,11696,8354
370,Barnsley,3702003,Wilthorpe Primary School,385,19850,11579,8271
370,Barnsley,3702009,Burton Road Primary School,279,18790,10961,7829
370,Barnsley,3702024,Shawlands Primary School,235,18350,10704,7646
370,Barnsley,3702052,Barugh Green Primary School,289,18890,11019,7871
370,Barnsley,3702053,Worsbrough Common Primary School,330,19300,11258,8042
370,Barnsley,3702057,Lacewood Primary School,192,17920,10453,7467
370,Barnsley,3702059,Dearne Goldthorpe Primary School,203,18030,10518,7512
370,Barnsley,3702066,Keresforth Primary School,194,17940,10465,7475
370,Barnsley,3702075,Oxspring Primary School,111,17110,9981,7129
370,Barnsley,3702076,Hoylandswaine Primary School,113,17130,9993,7137
370,Barnsley,3702077,Millhouse Primary School,113,17130,9993,7137
370,Barnsley,3702078,Springvale Primary School,174,17740,10348,7392
370,Barnsley,3702079,Thurlstone Primary School,135,17350,10121,7229
370,Barnsley,3702082,Silkstone Common Junior and Infant School,131,17310,10098,7212
370,Barnsley,3702085,Jump Primary School,182,17820,10395,7425
370,Barnsley,3702089,Birdwell Primary School,177,17770,10366,7404
370,Barnsley,3702100,Greenfield Primary School,221,18210,10623,7587
370,Barnsley,3702107,Silkstone Primary School,183,17830,10401,7429
370,Barnsley,3702109,Gawber Primary School,181,17810,10389,7421
370,Barnsley,3702123,Joseph Locke Primary School,347,19470,11358,8112
370,Barnsley,3702129,Milefield Primary School,203,18030,10518,7512
370,Barnsley,3702130,Ladywood Primary School,176,17760,10360,7400
370,Barnsley,3702132,Birkwood Primary School,241,18410,10739,7671
370,Barnsley,3702133,Cherry Dale Primary School,251,18510,10798,7712
370,Barnsley,3702134,Cudworth Churchfield Primary School,323,19230,11218,8012
370,Barnsley,3702138,Athersley North Primary School,236,18360,10710,7650
370,Barnsley,3702140,Athersley South Primary School,245,18450,10763,7687
370,Barnsley,3702141,Summer Lane Primary School,260,18600,10850,7750
370,Barnsley,3702143,Mapplewell Primary School,236,18360,10710,7650
370,Barnsley,3703004,Thurgoland Church of England (Voluntary Controlled) Primary School,184,17840,10407,7433
370,Barnsley,3703007,Cawthorne Church of England Voluntary Controlled Primary School,131,17310,10098,7212
370,Barnsley,3703011,Brierley Church of England Voluntary Controlled Primary School,181,17810,10389,7421
370,Barnsley,3703304,Holy Rood Catholic Primary School,170,17700,10325,7375
370,Barnsley,3703313,Tankersley St Peters CofE (Aided) Primary School,168,17680,10313,7367
370,Barnsley,3703314,The Ellis Church of England (Voluntary Aided) Primary School,167,17670,10308,7362
370,Barnsley,3703317,St Helens Catholic Primary School,129,17290,10086,7204
370,Barnsley,3703318,St Michael and All Angels Catholic Primary School,114,17140,9998,7142
370,Barnsley,3703320,Sacred Heart Catholic Primary School,123,17230,10051,7179
370,Barnsley,3703324,Kings Oak Primary Learning Centre,359,19590,11428,8162
371,Doncaster,3711103,The Levett School,11,11000,6417,4583
371,Doncaster,3712032,The Woodlands Primary School,346,19460,11352,8108
371,Doncaster,3712054,Adwick Primary School,308,19080,11130,7950
371,Doncaster,3712057,Askern Spa Junior School,314,19140,11165,7975
371,Doncaster,3712063,Arksey Primary School,73,16730,9759,6971
371,Doncaster,3712067,Toll Bar Primary School,151,17510,10214,7296
371,Doncaster,3712083,New Pastures Primary School,209,18090,10553,7537
371,Doncaster,3712088,Norton Junior School,235,18350,10704,7646
371,Doncaster,3712102,Thorne Moorends West Road Primary School,283,18830,10984,7846
371,Doncaster,3712104,Scawthorpe Castle Hills Primary School,198,17980,10488,7492
371,Doncaster,3712106,Barnburgh Primary School,165,17650,10296,7354
371,Doncaster,3712115,Rossington Tornedale Infant School,103,17030,9934,7096
371,Doncaster,3712121,Scawsby Saltersgate Infant School,179,17790,10378,7412
371,Doncaster,3712128,Scawsby Saltersgate Junior School,357,19570,11416,8154
371,Doncaster,3712129,Sprotbrough Orchard Infant School,111,17110,9981,7129
371,Doncaster,3712142,Norton Infant School,112,17120,9987,7133
371,Doncaster,3712144,Wadworth Primary School,128,17280,10080,7200
371,Doncaster,3712147,Hatfield Sheep Dip Lane Primary School,212,18120,10570,7550
371,Doncaster,3712148,Stainforth Kirton Lane Primary School,169,17690,10319,7371
371,Doncaster,3712157,Copley Junior School,194,17940,10465,7475
371,Doncaster,3712161,Tickhill Estfeld Primary School,183,17830,10401,7429
371,Doncaster,3712163,Windhill Primary School,223,18230,10634,7596
371,Doncaster,3712165,Park Primary School,297,18970,11066,7904
371,Doncaster,3712168,Town Field Primary School,359,19590,11428,8162
371,Doncaster,3712175,Bawtry Mayflower Primary School,221,18210,10623,7587
371,Doncaster,3712178,Lakeside Primary School,294,18940,11048,7892
371,Doncaster,3712179,Hawthorn Primary School,218,18180,10605,7575
371,Doncaster,3712184,Hayfield Lane Primary School,242,18420,10745,7675
371,Doncaster,3712185,Scawthorpe Sunnyfields Primary School,229,18290,10669,7621
371,Doncaster,3712188,Thorne King Edward Primary School,297,18970,11066,7904
371,Doncaster,3712190,Bentley New Village Primary School,198,17980,10488,7492
371,Doncaster,3712195,Warmsworth Primary School,353,19530,11393,8137
371,Doncaster,3712196,Carcroft Primary School,270,18700,10908,7792
371,Doncaster,3712205,Kirkby Avenue Primary School,266,18660,10885,7775
371,Doncaster,3712207,Plover Primary School,297,18970,11066,7904
371,Doncaster,3712209,Long Toft Primary School,240,18400,10733,7667
371,Doncaster,3713300,St Peters Catholic Primary School,179,17790,10378,7412
371,Doncaster,3713301,Our Lady of Mount Carmel Catholic Primary School,181,17810,10389,7421
371,Doncaster,3713302,St Francis Xavier Catholic Primary School,158,17580,10255,7325
371,Doncaster,3713311,Travis St Lawrence CofE Primary School,280,18800,10967,7833
371,Doncaster,3713312,Branton St Wilfrids Church of England Primary School,178,17780,10372,7408
371,Doncaster,3713314,St Joseph and St Teresas Catholic Primary School,112,17120,9987,7133
371,Doncaster,3713315,Our Lady of Perpetual Help Catholic Primary School,105,17050,9946,7104
371,Doncaster,3713316,St Albans Catholic Primary School,137,17370,10133,7237
371,Doncaster,3713318,St Marys Catholic Primary School Edlington,144,17440,10173,7267
371,Doncaster,3713323,Tickhill St Marys Church of England Primary and Nursery School,173,17730,10343,7387
371,Doncaster,3713324,Mallard Primary School,339,19390,11311,8079
371,Doncaster,3717012,Heatherwood School,30,16300,9508,6792
371,Doncaster,3717014,Coppice School,63,16630,9701,6929
371,Doncaster,3717015,Stone Hill School,36,16360,9543,6817
371,Doncaster,3717016,North Ridge Community School,40,16400,9567,6833
372,Rotherham,3721107,The Rowan Centre,11,11000,6417,4583
372,Rotherham,3721112,Rotherham Aspire,7,7000,4083,2917
372,Rotherham,3722004,Badsley Primary School,493,20930,12209,8721
372,Rotherham,3722005,Blackburn Primary School,237,18370,10716,7654
372,Rotherham,3722006,Broom Valley Community School,337,19370,11299,8071
372,Rotherham,3722013,Ferham Primary School,161,17610,10273,7337
372,Rotherham,3722021,Redscope Primary School,321,19210,11206,8004
372,Rotherham,3722022,Kimberworth Community Primary School,168,17680,10313,7367
372,Rotherham,3722023,Meadow View Primary School,195,17950,10471,7479
372,Rotherham,3722029,Thornhill Primary School,252,18520,10803,7717
372,Rotherham,3722032,Thorpe Hesley Primary School,405,20050,11696,8354
372,Rotherham,3722034,Herringthorpe Infant School,172,17720,10337,7383
372,Rotherham,3722042,Sitwell Infant School,150,17500,10208,7292
372,Rotherham,3722050,Aston Fence Junior and Infant School,184,17840,10407,7433
372,Rotherham,3722051,Swallownest Primary School,173,17730,10343,7387
372,Rotherham,3722052,Bramley Sunnyside Junior School,347,19470,11358,8112
372,Rotherham,3722055,Brinsworth Manor Infant School,144,17440,10173,7267
372,Rotherham,3722061,Harthill Primary School,154,17540,10232,7308
372,Rotherham,3722063,Crags Community School,306,19060,11118,7942
372,Rotherham,3722070,Rawmarsh Rosehill Junior School,238,18380,10722,7658
372,Rotherham,3722071,Rawmarsh Ryecroft Infant School,106,17060,9952,7108
372,Rotherham,3722081,Wales Primary School,212,18120,10570,7550
372,Rotherham,3722083,Kiveton Park Meadows Junior School,206,18060,10535,7525
372,Rotherham,3722094,Bramley Sunnyside Infant School,173,17730,10343,7387
372,Rotherham,3722095,Anston Park Junior School,261,18610,10856,7754
372,Rotherham,3722097,Thurcroft Infant School,131,17310,10098,7212
372,Rotherham,3722106,Todwick Primary School,179,17790,10378,7412
372,Rotherham,3722110,Rawmarsh Thorogate Junior and Infant School,182,17820,10395,7425
372,Rotherham,3722120,West Melton Junior and Infant School,139,17390,10144,7246
372,Rotherham,3722121,Brinsworth Howarth Primary School,185,17850,10413,7437
372,Rotherham,3722130,Anston Hillcrest Primary School,193,17930,10459,7471
372,Rotherham,3722137,St Anns Junior and Infant School,318,19180,11188,7992
372,Rotherham,3723329,Laughton All Saints CofE Primary School,88,16880,9847,7033
372,Rotherham,3723337,Our Lady and St Josephs Catholic Primary School,179,17790,10378,7412
372,Rotherham,3723339,St Josephs Catholic Primary School,145,17450,10179,7271
372,Rotherham,3727000,Newman School,30,16300,9508,6792
372,Rotherham,3727009,The Willows School,39,16390,9561,6829
373,Sheffield,3731100,Sheffield Inclusion Centre,41,16410,9573,6837
373,Sheffield,3732001,Abbey Lane Primary School,512,21120,12320,8800
373,Sheffield,3732014,Brightside Nursery and Infant School,121,17210,10039,7171
373,Sheffield,3732023,Carter Knowle Junior School,215,18150,10588,7562
373,Sheffield,3732036,Gleadless Primary School,349,19490,11369,8121
373,Sheffield,3732040,Whiteways Primary School,390,19900,11608,8292
373,Sheffield,3732058,Hunters Bar Junior School,357,19570,11416,8154
373,Sheffield,3732060,Hunters Bar Infant School,173,17730,10343,7387
373,Sheffield,3732063,Intake Primary School,352,19520,11387,8133
373,Sheffield,3732070,Lowfield Community Primary School,313,19130,11159,7971
373,Sheffield,3732071,Lydgate Junior School,478,20780,12122,8658
373,Sheffield,3732072,Lydgate Infant School,240,18400,10733,7667
373,Sheffield,3732079,Marlcliffe Community Primary School,432,20320,11853,8467
373,Sheffield,3732080,Ecclesfield Primary School,352,19520,11387,8133
373,Sheffield,3732081,Meersbrook Bank Primary School,178,17780,10372,7408
373,Sheffield,3732087,Nether Green Junior School,378,19780,11538,8242
373,Sheffield,3732092,Mundella Primary School,348,19480,11363,8117
373,Sheffield,3732093,Owler Brook Primary School,389,19890,11603,8287
373,Sheffield,3732139,Woodhouse West Primary School,300,19000,11083,7917
373,Sheffield,3732206,Ecclesall Infant School,505,21050,12279,8771
373,Sheffield,3732213,Holt House Infant School,116,17160,10010,7150
373,Sheffield,3732221,Nether Green Infant School,147,17470,10191,7279
373,Sheffield,3732233,Bradway Primary School,360,19600,11433,8167
373,Sheffield,3732239,Dobcroft Junior School,369,19690,11486,8204
373,Sheffield,3732241,Beighton Nursery Infant School,176,17760,10360,7400
373,Sheffield,3732246,Brook House Junior School,330,19300,11258,8042
373,Sheffield,3732252,Halfway Nursery Infant School,115,17150,10004,7146
373,Sheffield,3732257,Mosborough Primary School,347,19470,11358,8112
373,Sheffield,3732261,Limpsfield Junior School,229,18290,10669,7621
373,Sheffield,3732272,Netherthorpe Primary School,172,17720,10337,7383
373,Sheffield,3732279,Halfway Junior School,199,17990,10494,7496
373,Sheffield,3732281,Ballifield Primary School,363,19630,11451,8179
373,Sheffield,3732283,Dobcroft Infant School,210,18100,10558,7542
373,Sheffield,3732292,Loxley Primary School,178,17780,10372,7408
373,Sheffield,3732294,Stannington Infant School,117,17170,10016,7154
373,Sheffield,3732296,Grenoside Community Primary School,295,18950,11054,7896
373,Sheffield,3732297,High Green Primary School,179,17790,10378,7412
373,Sheffield,3732302,Stocksbridge Nursery Infant School,127,17270,10074,7196
373,Sheffield,3732303,Stocksbridge Junior School,386,19860,11585,8275
373,Sheffield,3732306,Royd Nursery and Infant School,91,16910,9864,7046
373,Sheffield,3732309,Nook Lane Junior School,248,18480,10780,7700
373,Sheffield,3732311,Wharncliffe Side Primary School,128,17280,10080,7200
373,Sheffield,3732312,Coit Primary School,179,17790,10378,7412
373,Sheffield,3732313,Oughtibridge Primary School,351,19510,11381,8129
373,Sheffield,3732319,Waterthorpe Infant School,114,17140,9998,7142
373,Sheffield,3732322,Bankwood Community Primary School,257,18570,10833,7737
373,Sheffield,3732324,Woodseats Primary School,313,19130,11159,7971
373,Sheffield,3732325,Brunswick Community Primary School,361,19610,11439,8171
373,Sheffield,3732327,Woodthorpe Primary School,333,19330,11276,8054
373,Sheffield,3732328,Bradfield Dungworth Primary School,90,16900,9858,7042
373,Sheffield,3732329,Springfield Primary School,185,17850,10413,7437
373,Sheffield,3732334,Reignhead Primary School,229,18290,10669,7621
373,Sheffield,3732338,Rivelin Primary School,313,19130,11159,7971
373,Sheffield,3732340,Athelstan Primary School,512,21120,12320,8800
373,Sheffield,3732342,Angram Bank Primary School,196,17960,10477,7483
373,Sheffield,3732343,Anns Grove Primary School,255,18550,10821,7729
373,Sheffield,3732344,Carfield Primary School,490,20900,12192,8708
373,Sheffield,3732347,Prince Edward Primary School,329,19290,11253,8037
373,Sheffield,3732349,Shooters Grove Primary School,319,19190,11194,7996
373,Sheffield,3732350,Stradbroke Primary School,360,19600,11433,8167
373,Sheffield,3732351,Walkley Primary School,243,18430,10751,7679
373,Sheffield,3732352,Westways Primary School,509,21090,12303,8787
373,Sheffield,3732356,Greystones Primary School,514,21140,12332,8808
373,Sheffield,3732358,Malin Bridge Primary School,453,20530,11976,8554
373,Sheffield,3732360,Shortbrook Primary School,83,16830,9818,7012
373,Sheffield,3732364,Dore Primary School,398,19980,11655,8325
373,Sheffield,3732366,Pye Bank CofE Primary School,359,19590,11428,8162
373,Sheffield,3732369,Sharrow Nursery Infant and Junior School,345,19450,11346,8104
373,Sheffield,3733010,Norton Free Church of England Primary School,185,17850,10413,7437
373,Sheffield,3733422,Deepcar St Johns Church of England Junior School,155,17550,10238,7312
373,Sheffield,3733428,Parson Cross Church of England Primary School,177,17770,10366,7404
373,Sheffield,3733429,Arbourthorne Community Primary School,344,19440,11340,8100
373,Sheffield,3733432,Watercliffe Meadow Community Primary School,355,19550,11404,8146
373,Sheffield,3733433,Pipworth Community Primary School,360,19600,11433,8167
373,Sheffield,3735200,Clifford CofE Infant School,56,16560,9660,6900
373,Sheffield,3735204,Broomhill Infant School,74,16740,9765,6975
373,Sheffield,3735206,Totley All Saints Church of England Voluntary Aided Primary School,181,17810,10389,7421
373,Sheffield,3735208,St Theresas Catholic Primary School,179,17790,10378,7412
373,Sheffield,3737013,The Rowan School,88,16880,9847,7033
373,Sheffield,3737023,Norfolk Park School,78,16780,9788,6992
373,Sheffield,3737026,Woolley Wood School,84,16840,9823,7017
373,Sheffield,3737036,Mossbrook School,86,16860,9835,7025
373,Sheffield,3737040,Heritage Park School,22,16220,9462,6758
373,Sheffield,3737041,Holgate Meadows School,17,16170,9433,6737
373,Sheffield,3737038,Becton School,1,1000,583,417
380,Bradford,3801103,Primary Pupil Referral Unit,55,16550,9654,6896
380,Bradford,3802002,Lister Primary School,337,19370,11299,8071
380,Bradford,3802015,Clayton Village Primary School,178,17780,10372,7408
380,Bradford,3802027,Frizinghall Primary School,349,19490,11369,8121
380,Bradford,3802043,Lidget Green Primary School,454,20540,11982,8558
380,Bradford,3802048,Marshfield Primary School,360,19600,11433,8167
380,Bradford,3802054,Newby Primary School,363,19630,11451,8179
380,Bradford,3802055,Sandy Lane Primary School,253,18530,10809,7721
380,Bradford,3802057,Swain House Primary School,372,19720,11503,8217
380,Bradford,3802058,Thackley Primary School,358,19580,11422,8158
380,Bradford,3802062,Blakehill Primary School,362,19620,11445,8175
380,Bradford,3802071,Wellington Primary School,366,19660,11468,8192
380,Bradford,3802074,Wibsey Primary School,534,21340,12448,8892
380,Bradford,3802075,Bowling Park Primary School,537,21370,12466,8904
380,Bradford,3802081,Stocks Lane Primary School,116,17160,10010,7150
380,Bradford,3802084,Farfield Primary and Nursery School,352,19520,11387,8133
380,Bradford,3802086,Princeville Primary School,488,20880,12180,8700
380,Bradford,3802087,Carrwood Primary School,291,18910,11031,7879
380,Bradford,3802090,Ley Top Primary School,287,18870,11008,7862
380,Bradford,3802093,Grove House Primary School,354,19540,11398,8142
380,Bradford,3802094,Cavendish Primary School,372,19720,11503,8217
380,Bradford,3802100,Worthinghead Primary School,170,17700,10325,7375
380,Bradford,3802101,Poplars Farm Primary School,186,17860,10418,7442
380,Bradford,3802102,Bankfoot Primary School,214,18140,10582,7558
380,Bradford,3802103,Fagley Primary School,184,17840,10407,7433
380,Bradford,3802107,Brackenhill Primary School,351,19510,11381,8129
380,Bradford,3802110,Cottingley Village Primary School,361,19610,11439,8171
380,Bradford,3802111,Crossflatts Primary School,364,19640,11457,8183
380,Bradford,3802113,Eldwick Primary School,407,20070,11708,8362
380,Bradford,3802124,Ingrow Primary School,309,19090,11136,7954
380,Bradford,3802128,Long Lee Primary School,325,19250,11229,8021
380,Bradford,3802130,Oldfield Primary School,51,16510,9631,6879
380,Bradford,3802134,Stanbury Village School,80,16800,9800,7000
380,Bradford,3802140,Saltaire Primary School,363,19630,11451,8179
380,Bradford,3802145,Low Ash Primary School,363,19630,11451,8179
380,Bradford,3802146,Silsden Primary School,482,20820,12145,8675
380,Bradford,3802147,Eastburn Junior and Infant School,174,17740,10348,7392
380,Bradford,3802148,Steeton Primary School,259,18590,10844,7746
380,Bradford,3802150,Ashlands Primary School,382,19820,11562,8258
380,Bradford,3802157,Glenaire Primary School,149,17490,10203,7287
380,Bradford,3802166,Ben Rhydding Primary School,181,17810,10389,7421
380,Bradford,3802168,Hoyle Court Primary School,253,18530,10809,7721
380,Bradford,3802173,Addingham Primary School,183,17830,10401,7429
380,Bradford,3802174,Sandal Primary School,356,19560,11410,8150
380,Bradford,3802182,Girlington Primary School,359,19590,11428,8162
380,Bradford,3802185,Miriam Lord Community Primary School,323,19230,11218,8012
380,Bradford,3802192,Menston Primary School,373,19730,11509,8221
380,Bradford,3802197,Newhall Park Primary School,343,19430,11334,8096
380,Bradford,3802198,Knowleswood Primary School,354,19540,11398,8142
380,Bradford,3802200,Thorpe Primary School,176,17760,10360,7400
380,Bradford,3802203,Burley Oaks Primary School,367,19670,11474,8196
380,Bradford,3803000,All Saints Church of England Primary School,544,21440,12507,8933
380,Bradford,3803013,St Matthews CofE Primary School and Nursery,358,19580,11422,8158
380,Bradford,3803021,St Lukes CofE Primary School,179,17790,10378,7412
380,Bradford,3803023,Low Moor CofE Primary School,356,19560,11410,8150
380,Bradford,3803026,All Saints CofE Primary School,277,18770,10949,7821
380,Bradford,3803031,Burley and Woodhead CofE Primary School,188,17880,10430,7450
380,Bradford,3803301,St Pauls CofE Primary School,178,17780,10372,7408
380,Bradford,3803304,Idle CofE Primary School,277,18770,10949,7821
380,Bradford,3803308,Heaton St Barnabas CofE Aided Primary School,344,19440,11340,8100
380,Bradford,3803313,St Stephens CofE Primary School,354,19540,11398,8142
380,Bradford,3803333,St Anthonys Catholic Primary School,182,17820,10395,7425
380,Bradford,3803334,St Clares Catholic Primary School,176,17760,10360,7400
380,Bradford,3803335,St Columbas Catholic Primary School,323,19230,11218,8012
380,Bradford,3803338,St Josephs Catholic Primary School,265,18650,10879,7771
380,Bradford,3803347,St Marys &St Peters Catholic Primary School,174,17740,10348,7392
380,Bradford,3803349,St Williams Catholic Primary School,158,17580,10255,7325
380,Bradford,3803351,St Francis Catholic Primary School,177,17770,10366,7404
380,Bradford,3803353,Our Lady and St Brendans Catholic Primary School,168,17680,10313,7367
380,Bradford,3803354,St Cuthbert and The First Martyrs Catholic Primary School,176,17760,10360,7400
380,Bradford,3803355,St Matthews Catholic Primary School,184,17840,10407,7433
380,Bradford,3803360,Baildon CofE Primary School,352,19520,11387,8133
380,Bradford,3803362,Trinity All Saints CofE VA Primary School,286,18860,11002,7858
380,Bradford,3803363,Keighley St Andrews CofE Primary School and Nursery,321,19210,11206,8004
380,Bradford,3803365,Riddlesden St Marys CofE Primary School,311,19110,11148,7962
380,Bradford,3803367,St Josephs Catholic Primary School,177,17770,10366,7404
380,Bradford,3803373,St Anthonys Catholic Primary School,110,17100,9975,7125
380,Bradford,3803377,Peel Park Primary School and Nursery,512,21120,12320,8800
380,Bradford,3803379,Home Farm Primary School,351,19510,11381,8129
380,Bradford,3805200,Killinghall Primary School,543,21430,12501,8929
380,Bradford,3805201,Foxhill Primary School,181,17810,10389,7421
380,Bradford,3805202,Russell Hall Primary School,183,17830,10401,7429
380,Bradford,3805203,Hill Top CofE Primary School,182,17820,10395,7425
380,Bradford,3805206,Myrtle Park Primary School,187,17870,10424,7446
380,Bradford,3805207,Keelham Primary School,86,16860,9835,7025
380,Bradford,3807031,Chellow Heights Special School,198,17980,10488,7492
380,Bradford,3807035,Delius Special School,111,17110,9981,7129
381,Calderdale,3811101,Calderdale PRU,10,10000,5833,4167
381,Calderdale,3812003,Ferney Lee Primary School,159,17590,10261,7329
381,Calderdale,3812006,Copley Primary School,202,18020,10512,7508
381,Calderdale,3812009,Savile Park Primary School,257,18570,10833,7737
381,Calderdale,3812010,Lee Mount Primary School,293,18930,11043,7887
381,Calderdale,3812015,Northowram Primary School,362,19620,11445,8175
381,Calderdale,3812017,Parkinson Lane Community Primary School,451,20510,11964,8546
381,Calderdale,3812021,Salterhebble Junior and Infant School,175,17750,10354,7396
381,Calderdale,3812030,Warley Town School,120,17200,10033,7167
381,Calderdale,3812033,Ling Bob Junior Infant and Nursery School,252,18520,10803,7717
381,Calderdale,3812040,Bailiffe Bridge Junior and Infant School,181,17810,10389,7421
381,Calderdale,3812042,Carr Green Primary School,265,18650,10879,7771
381,Calderdale,3812046,Withinfields Primary School,305,19050,11113,7937
381,Calderdale,3812048,Bowling Green Primary School,135,17350,10121,7229
381,Calderdale,3812050,Holywell Green Primary School,174,17740,10348,7392
381,Calderdale,3812054,Central Street Infant and Nursery School,38,16380,9555,6825
381,Calderdale,3812057,Stubbings Infant School,46,16460,9602,6858
381,Calderdale,3812058,Heptonstall Junior Infant and Nursery School,85,16850,9829,7021
381,Calderdale,3812059,Colden Junior and Infant School,70,16700,9742,6958
381,Calderdale,3812060,Shelf Junior and Infant School,265,18650,10879,7771
381,Calderdale,3812061,Ripponden Junior and Infant School,192,17920,10453,7467
381,Calderdale,3812065,Midgley School,87,16870,9841,7029
381,Calderdale,3812066,New Road Primary School,131,17310,10098,7212
381,Calderdale,3812067,Tuel Lane Infant School,70,16700,9742,6958
381,Calderdale,3812068,Castle Hill Primary School,215,18150,10588,7562
381,Calderdale,3812069,Cornholme Junior Infant and Nursery School,170,17700,10325,7375
381,Calderdale,3812073,Shade Primary School,164,17640,10290,7350
381,Calderdale,3812075,Old Town Primary School,90,16900,9858,7042
381,Calderdale,3812076,Cliffe Hill Community Primary School,163,17630,10284,7346
381,Calderdale,3812081,Woodhouse Primary School,360,19600,11433,8167
381,Calderdale,3812082,Riverside Junior School,179,17790,10378,7412
381,Calderdale,3812087,Cross Lane Primary and Nursery School,243,18430,10751,7679
381,Calderdale,3812093,Ash Green Community Primary School,341,19410,11323,8087
381,Calderdale,3812095,Sowerby Village CofE VC Primary School,134,17340,10115,7225
381,Calderdale,3813001,Christ Church Pellon CofE VC Primary School,157,17570,10249,7321
381,Calderdale,3813010,Norland CE School,87,16870,9841,7029
381,Calderdale,3813011,St Marys CofE (VC) J and I School,87,16870,9841,7029
381,Calderdale,3813013,Triangle CofE VC Primary School,161,17610,10273,7337
381,Calderdale,3813014,Luddenden CofE School,147,17470,10191,7279
381,Calderdale,3813303,St Augustines CofE VA Junior and Infant School,152,17520,10220,7300
381,Calderdale,3813305,St Josephs Catholic Primary School,162,17620,10278,7342
381,Calderdale,3813308,St Marys Catholic Primary School,241,18410,10739,7671
381,Calderdale,3813314,St Andrews CofE (VA) Junior School,237,18370,10716,7654
381,Calderdale,3813315,St Andrews Church of England (VA) Infant School,103,17030,9934,7096
381,Calderdale,3813318,Elland CofE Junior and Infant School,158,17580,10255,7325
381,Calderdale,3813319,Hebden Royd CofE VA Primary School,115,17150,10004,7146
381,Calderdale,3813321,Barkisland CofE VA Primary School,175,17750,10354,7396
381,Calderdale,3813323,Christ Church CofE VA Junior School Sowerby Bridge,130,17300,10092,7208
381,Calderdale,3813326,Todmorden CofE J I & N School,175,17750,10354,7396
381,Calderdale,3813327,St Patricks Catholic Primary School,101,17010,9923,7087
381,Calderdale,3813329,St Josephs Catholic Primary School Brighouse,173,17730,10343,7387
381,Calderdale,3813330,St Josephs RC Primary School Todmorden,104,17040,9940,7100
381,Calderdale,3813332,Moorside Community Primary School,193,17930,10459,7471
381,Calderdale,3814022,Calder High School The Calder Learning Trust,41,16410,9573,6837
381,Calderdale,3815201,All Saints CofE VA Junior and Infant School,182,17820,10395,7425
381,Calderdale,3815202,St Michael and All Angels CofE Primary & Pre School,177,17770,10366,7404
381,Calderdale,3815207,Longroyde Primary School,342,19420,11328,8092
381,Calderdale,3815208,Walsden St Peters CE (VC) Primary School,149,17490,10203,7287
381,Calderdale,3817008,Wood Bank School,58,16580,9672,6908
381,Calderdale,3817010,Highbury School,58,16580,9672,6908
382,Kirklees,3822004,Berry Brow Infant and Nursery School,115,17150,10004,7146
382,Kirklees,3822005,Carlton Junior and Infant School,184,17840,10407,7433
382,Kirklees,3822006,Birkby Infant and Nursery School,285,18850,10996,7854
382,Kirklees,3822007,Eastborough Junior Infant and Nursery School,176,17760,10360,7400
382,Kirklees,3822013,Earlsheaton Infant School,80,16800,9800,7000
382,Kirklees,3822014,Shaw Cross Infant and Nursery School,117,17170,10016,7154
382,Kirklees,3822016,Windmill CofE (VC) Primary School,373,19730,11509,8221
382,Kirklees,3822021,Netherton Infant and Nursery School,113,17130,9993,7137
382,Kirklees,3822023,Westmoor Primary School,438,20380,11888,8492
382,Kirklees,3822025,Paddock Junior Infant and Nursery School,305,19050,11113,7937
382,Kirklees,3822028,Spring Grove Junior Infant and Nursery School,183,17830,10401,7429
382,Kirklees,3822032,Oak CofE Primary School,787,23870,13924,9946
382,Kirklees,3822035,Rawthorpe Junior School,256,18560,10827,7733
382,Kirklees,3822036,Reinwood  Community Junior School,414,20140,11748,8392
382,Kirklees,3822037,Reinwood Infant and Nursery School,206,18060,10535,7525
382,Kirklees,3822038,Crow Lane Primary and Foundation Stage School,184,17840,10407,7433
382,Kirklees,3822041,Birkby Junior School,524,21240,12390,8850
382,Kirklees,3822043,Ashbrow School,347,19470,11358,8112
382,Kirklees,3822045,Newsome Junior School,228,18280,10663,7617
382,Kirklees,3822050,Honley CofE (VC) Junior Infant and Nursery School,372,19720,11503,8217
382,Kirklees,3822056,Fixby Junior and Infant School,259,18590,10844,7746
382,Kirklees,3822061,Carlinghow Princess Royal Junior Infant and Nursery School,282,18820,10978,7842
382,Kirklees,3822065,Mill Lane Primary School,146,17460,10185,7275
382,Kirklees,3822066,Park Road Junior Infant and Nursery School,179,17790,10378,7412
382,Kirklees,3822067,Purlwell Infant and Nursery School,173,17730,10343,7387
382,Kirklees,3822068,Warwick Road Primary School,280,18800,10967,7833
382,Kirklees,3822069,Clough Head Junior and Infant School,78,16780,9788,6992
382,Kirklees,3822073,Marsden Infant and Nursery School,97,16970,9899,7071
382,Kirklees,3822074,Scapegoat Hill Junior and Infant School,67,16670,9724,6946
382,Kirklees,3822075,Nields Junior Infant and Nursery School,164,17640,10290,7350
382,Kirklees,3822076,Wellhouse Junior and Infant School,65,16650,9713,6937
382,Kirklees,3822077,Wilberlee Junior and Infant School,75,16750,9771,6979
382,Kirklees,3822079,Kayes First and Nursery School,146,17460,10185,7275
382,Kirklees,3822081,Emley First School,123,17230,10051,7179
382,Kirklees,3822085,Holmfirth Junior Infant and Nursery School,188,17880,10430,7450
382,Kirklees,3822086,Hade Edge Junior and Infant School,67,16670,9724,6946
382,Kirklees,3822087,Hepworth Junior and Infant School,95,16950,9888,7062
382,Kirklees,3822088,Hinchliffe Mill Junior and Infant School,91,16910,9864,7046
382,Kirklees,3822089,Holme Junior and Infant School,32,16320,9520,6800
382,Kirklees,3822090,Netherthong Primary School,186,17860,10418,7442
382,Kirklees,3822091,Scholes (Holmfirth) J & I School,176,17760,10360,7400
382,Kirklees,3822095,Shepley First School,155,17550,10238,7312
382,Kirklees,3822096,Grange Moor Primary School,87,16870,9841,7029
382,Kirklees,3822097,Hopton Primary School,267,18670,10891,7779
382,Kirklees,3822099,Gomersal Primary School,362,19620,11445,8175
382,Kirklees,3822100,Hartshead Junior and Infant School,77,16770,9783,6987
382,Kirklees,3822102,Hightown Junior Infant & Nursery School,177,17770,10366,7404
382,Kirklees,3822103,Littletown Junior Infant and Nursery School,149,17490,10203,7287
382,Kirklees,3822108,Howard Park Community School,178,17780,10372,7408
382,Kirklees,3822110,Manorfield Infant and Nursery School,178,17780,10372,7408
382,Kirklees,3822114,Scholes Village Primary School,170,17700,10325,7375
382,Kirklees,3822118,Wooldale Junior School,235,18350,10704,7646
382,Kirklees,3822120,Rowley Lane Junior Infant and Nursery School,388,19880,11597,8283
382,Kirklees,3822122,Lydgate Junior and Infant School,242,18420,10745,7675
382,Kirklees,3822125,Upperthong Junior and Infant School,184,17840,10407,7433
382,Kirklees,3822126,Meltham Moor Primary School,169,17690,10319,7371
382,Kirklees,3822129,Hyrstmount Junior School,355,19550,11404,8146
382,Kirklees,3822130,Kirkheaton Primary School,324,19240,11223,8017
382,Kirklees,3822134,High Bank Junior Infant and Nursery School,116,17160,10010,7150
382,Kirklees,3822135,Norristhorpe Junior and Infant School,355,19550,11404,8146
382,Kirklees,3822136,Kirkroyds Infant School,110,17100,9975,7125
382,Kirklees,3822138,Old Bank Junior Infant and Nursery School,129,17290,10086,7204
382,Kirklees,3822139,Denby Dale First and Nursery School,135,17350,10121,7229
382,Kirklees,3822144,Pentland Infant and Nursery School,96,16960,9893,7067
382,Kirklees,3822145,Moldgreen Community Primary School,293,18930,11043,7887
382,Kirklees,3822148,Linthwaite Clough J I & Early Years Unit,272,18720,10920,7800
382,Kirklees,3822151,Golcar Junior Infant and Nursery School,370,19700,11492,8208
382,Kirklees,3822152,Crossley Fields Junior and Infant School,524,21240,12390,8850
382,Kirklees,3822153,Mount Pleasant Primary School,507,21070,12291,8779
382,Kirklees,3822154,Heckmondwike Primary School,361,19610,11439,8171
382,Kirklees,3822157,Dalton School,406,20060,11702,8358
382,Kirklees,3823000,Lowerhouses CofE (Voluntary Controlled) Junior Infant and Early Years School,155,17550,10238,7312
382,Kirklees,3823001,Ravensthorpe Church of England Voluntary Controlled Junior School,436,20360,11877,8483
382,Kirklees,3823002,Rawthorpe St James CofE (VC) Infant and Nursery School,177,17770,10366,7404
382,Kirklees,3823003,St Johns Church of England Voluntary Controlled Infant School,115,17150,10004,7146
382,Kirklees,3823004,Savile Town Church of England Voluntary Controlled Infant and Nursery School,71,16710,9748,6962
382,Kirklees,3823008,Thornhill Lees Church of England Voluntary Controlled Infant and Nursery School,151,17510,10214,7296
382,Kirklees,3823009,Bywell Church of England Voluntary Controlled Junior School,365,19650,11463,8187
382,Kirklees,3823010,Headfield Church of England Voluntary Controlled Junior School,612,22120,12903,9217
382,Kirklees,3823014,Hanging Heaton Church of England Voluntary Controlled Junior and Infant School,116,17160,10010,7150
382,Kirklees,3823015,Staincliffe Church of England Voluntary Controlled Junior School,335,19350,11288,8062
382,Kirklees,3823016,Slaithwaite Church of England Voluntary Controlled Junior and Infant School,146,17460,10185,7275
382,Kirklees,3823021,Brockholes Church of England Voluntary Controlled Junior and Infant School,181,17810,10389,7421
382,Kirklees,3823022,Flockton Church of England Voluntary Controlled First School,70,16700,9742,6958
382,Kirklees,3823023,Highburton Church of England Voluntary Controlled First School,145,17450,10179,7271
382,Kirklees,3823026,Lepton Church of England Voluntary Controlled Junior Infant and Nursery School,189,17890,10436,7454
382,Kirklees,3823027,Thurstonland Endowed Voluntary Controlled First School,63,16630,9701,6929
382,Kirklees,3823028,Meltham CofE (VC) Primary School,332,19320,11270,8050
382,Kirklees,3823032,East Bierley Church of England Voluntary Controlled Primary School,181,17810,10389,7421
382,Kirklees,3823034,Roberttown Church of England Voluntary Controlled Junior and Infant School,211,18110,10564,7546
382,Kirklees,3823036,Farnley Tyas Church of England Voluntary Controlled First School,43,16430,9584,6846
382,Kirklees,3823037,Headlands Church of England Voluntary Controlled Junior Infant and Nursery School,349,19490,11369,8121
382,Kirklees,3823041,Crowlees Church of England Voluntary Controlled Junior and Infant School,364,19640,11457,8183
382,Kirklees,3823045,All Hallows CofE (VA) Primary School,88,16880,9847,7033
382,Kirklees,3823046,Battyeford CofE (VC) Primary School,368,19680,11480,8200
382,Kirklees,3823048,Birkenshaw Church of England Voluntary Controlled Primary School,364,19640,11457,8183
382,Kirklees,3823049,St Thomas CE (VC) Primary School,349,19490,11369,8121
382,Kirklees,3823304,St Marys Catholic Primary School Batley,264,18640,10873,7767
382,Kirklees,3823310,St Josephs Catholic Primary School (Dewsbury),187,17870,10424,7446
382,Kirklees,3823314,South Crosland Church of England Voluntary Aided Junior School,227,18270,10658,7612
382,Kirklees,3823320,Batley Parish Church of England Voluntary Aided Junior Infant and Nursery School,181,17810,10389,7421
382,Kirklees,3823321,St Peters Church of England Voluntary Aided Junior Infant and Early Years School,171,17710,10331,7379
382,Kirklees,3823323,St Johns Church of England Voluntary Aided Junior and Infant School,173,17730,10343,7387
382,Kirklees,3823324,Linthwaite Ardron CofE (Voluntary Aided) Junior and Infant School,167,17670,10308,7362
382,Kirklees,3823325,Cumberworth Church of England Voluntary Aided First School,106,17060,9952,7108
382,Kirklees,3823326,Denby Church of England Voluntary Aided First School,61,16610,9689,6921
382,Kirklees,3823329,Kirkburton Church of England Voluntary Aided First School,119,17190,10028,7162
382,Kirklees,3823332,Gomersal St Marys Church of England Voluntary Controlled Primary School,184,17840,10407,7433
382,Kirklees,3823336,Holy Spirit Catholic Primary School,181,17810,10389,7421
382,Kirklees,3823400,St Josephs Catholic Primary School (Huddersfield),281,18810,10973,7837
382,Kirklees,3823401,St Patricks Catholic Primary School Huddersfield,360,19600,11433,8167
382,Kirklees,3823402,Our Lady of Lourdes Catholic Primary School,173,17730,10343,7387
382,Kirklees,3823405,St Patricks Catholic Primary School Birstall,205,18050,10529,7521
382,Kirklees,3823408,St Paulinus Catholic Primary School,354,19540,11398,8142
382,Kirklees,3823410,Moorlands Primary School,539,21390,12478,8912
382,Kirklees,3823411,Hillside Primary School,268,18680,10897,7783
382,Kirklees,3823412,Whitechapel Church of England Primary School,351,19510,11381,8129
382,Kirklees,3824019,Almondbury Community School,339,19390,11311,8079
382,Kirklees,3827001,Woodley School and College,43,16430,9584,6846
382,Kirklees,3827005,Ravenshall School,45,16450,9596,6854
382,Kirklees,3827010,Southgate School,27,16270,9491,6779
382,Kirklees,3827011,Fairfield School,50,16500,9625,6875
383,Leeds,3832000,Lane End Primary School,174,17740,10348,7392
383,Leeds,3832002,Rufford Park Primary School,237,18370,10716,7654
383,Leeds,3832270,Guiseley Primary School,278,18780,10955,7825
383,Leeds,3832271,Rawdon Littlemoor Primary School,269,18690,10903,7787
383,Leeds,3832275,Scholes (Elmet) Primary School,260,18600,10850,7750
383,Leeds,3832283,Horsforth Featherbank Primary School,180,17800,10383,7417
383,Leeds,3832286,Churwell Primary School,358,19580,11422,8158
383,Leeds,3832293,Seven Hills Primary School,359,19590,11428,8162
383,Leeds,3832302,Westroyd Primary School and Nursery,90,16900,9858,7042
383,Leeds,3832303,Greenside Primary School,265,18650,10879,7771
383,Leeds,3832308,Carlton Primary School,270,18700,10908,7792
383,Leeds,3832309,Robin Hood Primary School,321,19210,11206,8004
383,Leeds,3832312,Thorpe Primary School,203,18030,10518,7512
383,Leeds,3832313,Rothwell Haigh Road Infant School,90,16900,9858,7042
383,Leeds,3832314,Woodlesford Primary School,355,19550,11404,8146
383,Leeds,3832324,Yeadon Westfield Junior School,223,18230,10634,7596
383,Leeds,3832327,Oulton Primary School,308,19080,11130,7950
383,Leeds,3832329,Bramham Primary School,126,17260,10068,7192
383,Leeds,3832331,Pudsey Bolton Royd Primary School,358,19580,11422,8158
383,Leeds,3832334,West End Primary School,210,18100,10558,7542
383,Leeds,3832335,Southroyd Primary and Nursery School,355,19550,11404,8146
383,Leeds,3832336,Gildersome Primary School,333,19330,11276,8054
383,Leeds,3832338,Farsley Springbank Primary School,359,19590,11428,8162
383,Leeds,3832342,Victoria Junior School,164,17640,10290,7350
383,Leeds,3832347,Crossley Street Primary School,180,17800,10383,7417
383,Leeds,3832348,Tranmere Park Primary School,310,19100,11142,7958
383,Leeds,3832356,Queensway Primary School,153,17530,10226,7304
383,Leeds,3832358,Yeadon Westfield Infant School,114,17140,9998,7142
383,Leeds,3832363,Horsforth Newlaithes Primary School,359,19590,11428,8162
383,Leeds,3832364,Westbrook Lane Primary School,182,17820,10395,7425
383,Leeds,3832365,Lowtown Primary School,181,17810,10389,7421
383,Leeds,3832369,Birchfield Primary School,178,17780,10372,7408
383,Leeds,3832382,Morley Victoria Primary School,352,19520,11387,8133
383,Leeds,3832385,Bardsey Primary School,158,17580,10255,7325
383,Leeds,3832389,Primrose Lane Primary School,180,17800,10383,7417
383,Leeds,3832390,Wigton Moor Primary School,382,19820,11562,8258
383,Leeds,3832397,Ninelands Primary School,358,19580,11422,8158
383,Leeds,3832398,Broadgate Primary School,238,18380,10722,7658
383,Leeds,3832400,Deighton Gates Primary School,177,17770,10366,7404
383,Leeds,3832401,Ashfield Primary School,191,17910,10448,7462
383,Leeds,3832403,Westgate Primary School,180,17800,10383,7417
383,Leeds,3832405,Otley the Whartons Primary School,162,17620,10278,7342
383,Leeds,3832406,Bramhope Primary School,239,18390,10728,7662
383,Leeds,3832407,Beecroft Primary School,221,18210,10623,7587
383,Leeds,3832408,Blenheim Primary School,351,19510,11381,8129
383,Leeds,3832409,Brudenell Primary School,233,18330,10693,7637
383,Leeds,3832410,Iveson Primary School,261,18610,10856,7754
383,Leeds,3832411,Kirkstall Valley Primary School,177,17770,10366,7404
383,Leeds,3832412,Little London Community Primary School,490,20900,12192,8708
383,Leeds,3832413,Quarry Mount Primary School,179,17790,10378,7412
383,Leeds,3832414,Spring Bank Primary School,180,17800,10383,7417
383,Leeds,3832415,Rosebank Primary School,253,18530,10809,7721
383,Leeds,3832416,Adel Primary School,178,17780,10372,7408
383,Leeds,3832417,Hawksworth Wood Primary School,234,18340,10698,7642
383,Leeds,3832418,Cookridge Primary School,270,18700,10908,7792
383,Leeds,3832420,Ireland Wood Primary School,356,19560,11410,8150
383,Leeds,3832421,Weetwood Primary School,179,17790,10378,7412
383,Leeds,3832425,Bankside Primary School,539,21390,12478,8912
383,Leeds,3832427,Chapel Allerton Primary School,385,19850,11579,8271
383,Leeds,3832428,Gledhow Primary School,420,20200,11783,8417
383,Leeds,3832432,Talbot Primary School,390,19900,11608,8292
383,Leeds,3832433,Bracken Edge Primary School,418,20180,11772,8408
383,Leeds,3832434,Kerr Mackie Primary School,366,19660,11468,8192
383,Leeds,3832436,Alwoodley Primary School,365,19650,11463,8187
383,Leeds,3832437,Carr Manor Primary School,406,20060,11702,8358
383,Leeds,3832438,Highfield Primary School,391,19910,11614,8296
383,Leeds,3832439,Moor Allerton Hall Primary School,356,19560,11410,8150
383,Leeds,3832440,Moortown Primary School,180,17800,10383,7417
383,Leeds,3832441,Shadwell Primary School,175,17750,10354,7396
383,Leeds,3832444,Beechwood Primary School,360,19600,11433,8167
383,Leeds,3832447,Grange Farm Primary School,353,19530,11393,8137
383,Leeds,3832448,Grimes Dyke Primary School,225,18250,10646,7604
383,Leeds,3832449,Harehills Primary School,541,21410,12489,8921
383,Leeds,3832450,Hovingham Primary School,619,22190,12944,9246
383,Leeds,3832452,Seacroft Grange Primary School,179,17790,10378,7412
383,Leeds,3832456,White Laith Primary School,180,17800,10383,7417
383,Leeds,3832457,Wykebeck Primary School,345,19450,11346,8104
383,Leeds,3832458,Cross Gates Primary School,176,17760,10360,7400
383,Leeds,3832462,Shakespeare Primary School,324,19240,11223,8017
383,Leeds,3832464,Manston Primary School,181,17810,10389,7421
383,Leeds,3832467,Parklands Primary School,293,18930,11043,7887
383,Leeds,3832468,Swarcliffe Primary School,259,18590,10844,7746
383,Leeds,3832469,Fieldhead Carr Primary School,182,17820,10395,7425
383,Leeds,3832470,Beeston Primary School,518,21180,12355,8825
383,Leeds,3832471,Windmill Primary School,361,19610,11439,8171
383,Leeds,3832473,Greenmount Primary School,367,19670,11474,8196
383,Leeds,3832474,Hunslet Carr Primary School,331,19310,11264,8046
383,Leeds,3832475,Hunslet Moor Primary School,265,18650,10879,7771
383,Leeds,3832476,Ingram Road Primary School,275,18750,10938,7812
383,Leeds,3832478,Westwood Primary School,244,18440,10757,7683
383,Leeds,3832481,Low Road Primary School,124,17240,10057,7183
383,Leeds,3832482,Clapgate Primary School,332,19320,11270,8050
383,Leeds,3832483,Hugh Gaitskell Primary School,500,21000,12250,8750
383,Leeds,3832484,Armley Primary School,153,17530,10226,7304
383,Leeds,3832486,Castleton Primary School,202,18020,10512,7508
383,Leeds,3832487,Cobden Primary School,176,17760,10360,7400
383,Leeds,3832488,Park Spring Primary School,305,19050,11113,7937
383,Leeds,3832490,Stanningley Primary School,178,17780,10372,7408
383,Leeds,3832491,Summerfield Primary School,171,17710,10331,7379
383,Leeds,3832492,Five Lanes Primary School,360,19600,11433,8167
383,Leeds,3832493,Whingate Primary School,343,19430,11334,8096
383,Leeds,3832494,Whitecote Primary School,318,19180,11188,7992
383,Leeds,3832496,Lower Wortley Primary School,269,18690,10903,7787
383,Leeds,3832497,Lawns Park Primary School,180,17800,10383,7417
383,Leeds,3832499,Greenhill Primary School,339,19390,11311,8079
383,Leeds,3832503,Swinnow Primary School,182,17820,10395,7425
383,Leeds,3832505,Farsley Farfield Primary School,359,19590,11428,8162
383,Leeds,3832506,Rothwell Primary School,265,18650,10879,7771
383,Leeds,3832510,Sharp Lane Primary School,438,20380,11888,8492
383,Leeds,3832512,Asquith Primary School,311,19110,11148,7962
383,Leeds,3832513,Otley All Saints CofE Primary School,188,17880,10430,7450
383,Leeds,3833030,Aberford Church of England Voluntary Controlled Primary School,87,16870,9841,7029
383,Leeds,3833031,Rawdon St Peters Church of England Voluntary Controlled Primary School,263,18630,10868,7762
383,Leeds,3833033,Barwick-in-Elmet Church of England Voluntary Controlled Primary School,167,17670,10308,7362
383,Leeds,3833037,Harewood Church of England Voluntary Controlled Primary School,91,16910,9864,7046
383,Leeds,3833038,St Margarets Church of England Voluntary Controlled Primary School,366,19660,11468,8192
383,Leeds,3833040,Micklefield Church of England Voluntary Controlled Primary School,82,16820,9812,7008
383,Leeds,3833045,St James Church of England Voluntary Controlled Primary School,67,16670,9724,6946
383,Leeds,3833046,Calverley Church of England Voluntary Aided Primary School,331,19310,11264,8046
383,Leeds,3833047,St Marys Church of England Controlled Primary School Boston Spa,114,17140,9998,7142
383,Leeds,3833051,Pool-in-Wharfedale Church of England Voluntary Controlled Primary School,174,17740,10348,7392
383,Leeds,3833052,Burley St Matthias Church of England Voluntary Controlled Primary School,168,17680,10313,7367
383,Leeds,3833053,Middleton St Marys Church of England Voluntary Controlled Primary School,353,19530,11393,8137
383,Leeds,3833054,Bramley St Peters Church of England Primary School,299,18990,11078,7912
383,Leeds,3833056,St Bartholomews CofE Voluntary Controlled Primary School,568,21680,12647,9033
383,Leeds,3833329,Roundhay St Johns Church of England Primary School,181,17810,10389,7421
383,Leeds,3833350,St Oswalds Church of England Primary School,368,19680,11480,8200
383,Leeds,3833351,Hawksworth Church of England Primary School,89,16890,9853,7037
383,Leeds,3833356,Lady Elizabeth Hastings CofE VA Primary School Thorp Arch,121,17210,10039,7171
383,Leeds,3833357,Collingham Lady Elizabeth Hastings Church of England Primary School,177,17770,10366,7404
383,Leeds,3833358,St Edwards Catholic Primary School Boston Spa,134,17340,10115,7225
383,Leeds,3833362,St Francis Catholic Primary School Morley,160,17600,10267,7333
383,Leeds,3833364,Rothwell St Marys RC Primary School,181,17810,10389,7421
383,Leeds,3833366,St Josephs Catholic Primary School Wetherby,177,17770,10366,7404
383,Leeds,3833367,St Anthonys Catholic Primary School Beeston,181,17810,10389,7421
383,Leeds,3833368,St Augustines Catholic Primary School,357,19570,11416,8154
383,Leeds,3833370,Corpus Christi Catholic Primary School,277,18770,10949,7821
383,Leeds,3833371,St Francis of Assisi Catholic Primary School,178,17780,10372,7408
383,Leeds,3833372,Holy Family Catholic Primary School,172,17720,10337,7383
383,Leeds,3833373,St Urbans Catholic Primary School,179,17790,10378,7412
383,Leeds,3833374,St Josephs Catholic Primary School Hunslet,176,17760,10360,7400
383,Leeds,3833375,St Nicholas Catholic Primary School,251,18510,10798,7712
383,Leeds,3833376,Our Lady of Good Counsel Catholic Primary School,179,17790,10378,7412
383,Leeds,3833377,Sacred Heart Catholic Primary School,156,17560,10243,7317
383,Leeds,3833378,St Pauls Catholic Primary School,180,17800,10383,7417
383,Leeds,3833379,St Philips Catholic Primary and Nursery School,210,18100,10558,7542
383,Leeds,3833381,Immaculate Heart of Mary Catholic Primary School,357,19570,11416,8154
383,Leeds,3833382,St Patrick Catholic Primary School,182,17820,10395,7425
383,Leeds,3833383,Holy Rosary and St Annes Catholic Primary School,180,17800,10383,7417
383,Leeds,3833385,St Theresas Catholic Primary School,370,19700,11492,8208
383,Leeds,3833902,Adel St John the Baptist Church of England Primary School,179,17790,10378,7412
383,Leeds,3833903,Cookridge Holy Trinity Church of England Primary School,362,19620,11445,8175
383,Leeds,3833904,Kirkstall St Stephens Church of England Primary School,174,17740,10348,7392
383,Leeds,3833907,Meanwood Church of England Primary School,186,17860,10418,7442
383,Leeds,3833908,St Matthews Church of England Aided Primary School,353,19530,11393,8137
383,Leeds,3833909,All Saints Richmond Hill Church of England Primary School,185,17850,10413,7437
383,Leeds,3833911,St Peters Church of England Primary School Leeds,180,17800,10383,7417
383,Leeds,3833912,Whinmoor St Pauls Church of England Primary School,174,17740,10348,7392
383,Leeds,3833913,Beeston Hill St Lukes Church of England Primary School,290,18900,11025,7875
383,Leeds,3833914,Hunslet St Marys Church of England Primary School,196,17960,10477,7483
383,Leeds,3833915,Brodetsky Primary School,227,18270,10658,7612
383,Leeds,3833917,Strawberry Fields Primary School,272,18720,10920,7800
383,Leeds,3833921,Drighlington Primary School,338,19380,11305,8075
383,Leeds,3833922,Hollybush Primary,365,19650,11463,8187
383,Leeds,3833925,Great Preston VC CofE Primary School,174,17740,10348,7392
383,Leeds,3833926,Fountain Primary School,350,19500,11375,8125
383,Leeds,3833927,The New Bewerley Community Primary School,354,19540,11398,8142
383,Leeds,3833928,Valley View Community Primary School,366,19660,11468,8192
383,Leeds,3833929,Shire Oak VC Primary School,178,17780,10372,7408
383,Leeds,3833930,Mill Field Primary School,342,19420,11328,8092
383,Leeds,3833931,Allerton CofE Primary School,414,20140,11748,8392
383,Leeds,3834041,Carr Manor Community School Specialist Sports College,212,18120,10570,7550
383,Leeds,3834063,Roundhay School,329,19290,11253,8037
383,Leeds,3835200,Lady E Hastings CofE Primary School,115,17150,10004,7146
383,Leeds,3837015,John Jamieson School,75,16750,9771,6979
383,Leeds,3837062,Broomfield South SILC,68,16680,9730,6950
383,Leeds,3837072,West Oaks SEN Specialist School and College,109,17090,9969,7121
383,Leeds,3837073,North West Specialist Inclusive Learning Centre,76,16760,9777,6983
383,Leeds,3837074,West Specialist Inclusive Learning Centre,43,16430,9584,6846
384,Wakefield,3841101,The Priory Centre,8,8000,4667,3333
384,Wakefield,3842023,Fairburn View Primary School Castleford,344,19440,11340,8100
384,Wakefield,3842039,Crofton Junior School,237,18370,10716,7654
384,Wakefield,3842054,Martin Frobisher Infant School,79,16790,9794,6996
384,Wakefield,3842060,Ossett Flushdyke Junior and Infant School,91,16910,9864,7046
384,Wakefield,3842070,Sitlington Netherton Junior and Infant School,178,17780,10372,7408
384,Wakefield,3842076,Stanley Grove Primary and Nursery School,173,17730,10343,7387
384,Wakefield,3842079,Newton Hill Community School,177,17770,10366,7404
384,Wakefield,3842084,West Bretton Junior and Infant School,82,16820,9812,7008
384,Wakefield,3842091,Dimple Well Infant School and Nursery,120,17200,10033,7167
384,Wakefield,3842128,Streethouse Junior Infant and Nursery,86,16860,9835,7025
384,Wakefield,3842133,Featherstone Purston Infant School,97,16970,9899,7071
384,Wakefield,3842150,Featherstone North Featherstone Junior and Infant School,252,18520,10803,7717
384,Wakefield,3842152,Normanton Altofts Junior School,322,19220,11212,8008
384,Wakefield,3842154,Wakefield Pinders Primary (JIN) School,179,17790,10378,7412
384,Wakefield,3842155,Crigglestone Mackie Hill Junior and Infant School,151,17510,10214,7296
384,Wakefield,3842156,Crigglestone Dane Royd Junior and Infant School,265,18650,10879,7771
384,Wakefield,3842159,The Mount Junior Infant & Nursery School,181,17810,10389,7421
384,Wakefield,3842160,Wakefield Flanshaw Junior and Infant School,302,19020,11095,7925
384,Wakefield,3842162,Hendal Primary School,291,18910,11031,7879
384,Wakefield,3842163,Wakefield Greenhill Primary School,182,17820,10395,7425
384,Wakefield,3842173,Castleford Townville Infants School,114,17140,9998,7142
384,Wakefield,3842180,Castleford Wheldon Infant School and Nursery,87,16870,9841,7029
384,Wakefield,3842186,South Kirkby Common Road Infant and Nursery School,118,17180,10022,7158
384,Wakefield,3842189,Northfield Primary School: With Communication Resource,278,18780,10955,7825
384,Wakefield,3842191,South Elmsall Carlton Junior and Infant School,326,19260,11235,8025
384,Wakefield,3842192,Moorthorpe Primary (J and I ) School,180,17800,10383,7417
384,Wakefield,3842193,Upton Primary School,331,19310,11264,8046
384,Wakefield,3842195,Ryhill Junior Infant and Nursery School,180,17800,10383,7417
384,Wakefield,3842199,Hemsworth Grove Lea Primary School,181,17810,10389,7421
384,Wakefield,3842203,Shay Lane Primary (J and I) School,146,17460,10185,7275
384,Wakefield,3842204,Wakefield Lawefield Primary School,223,18230,10634,7596
384,Wakefield,3842206,Newlands Primary School,200,18000,10500,7500
384,Wakefield,3842208,Smawthorne Henry Moore Primary School Castleford,353,19530,11393,8137
384,Wakefield,3842209,Wakefield Snapethorpe Primary School,525,21250,12396,8854
384,Wakefield,3843010,Ossett Southdale Church of England Voluntary Controlled Junior School,329,19290,11253,8037
384,Wakefield,3843015,Stanley St Peters Church of England Voluntary Controlled Primary School,298,18980,11072,7908
384,Wakefield,3843018,Featherstone Purston St Thomas Church of England Voluntary Controlled Junior School,259,18590,10844,7746
384,Wakefield,3843021,Methodist Voluntary Controlled Junior Infant and Nursery School: With Communication Resource,187,17870,10424,7446
384,Wakefield,3843022,Badsworth Church of England Voluntary Controlled Junior and Infant School,175,17750,10354,7396
384,Wakefield,3843023,Ackworth Howard Church of England Voluntary Controlled Junior and Infant School,171,17710,10331,7379
384,Wakefield,3843301,Alverthorpe St Pauls CofE (VA) School 3-11yrs,217,18170,10599,7571
384,Wakefield,3843305,Wakefield St Johns Church of England Voluntary Aided Junior and Infant School,182,17820,10395,7425
384,Wakefield,3843318,Normanton All Saints CofE Infant School,177,17770,10366,7404
384,Wakefield,3843319,Ossett Holy Trinity CofE VA Primary School,274,18740,10932,7808
384,Wakefield,3843338,Wakefield St Marys Church of England Voluntary Aided Primary School,178,17780,10372,7408
384,Wakefield,3843339,Sandal Castle VA Community Primary School,525,21250,12396,8854
384,Wakefield,3843341,Ossett South Parade Primary,347,19470,11358,8112
384,Wakefield,3843343,Horbury St Peters and Clifton CofE (VC) Primary School,271,18710,10914,7796
384,Wakefield,3847054,Kingsland Primary School,150,17500,10208,7292
384,Wakefield,3841102,Pinderfields Hospital PRU,12,12000,7000,5000
390,Gateshead,3902008,Carr Hill Community Primary School,253,18530,10809,7721
390,Gateshead,3902012,Kelvin Grove Community Primary School,255,18550,10821,7729
390,Gateshead,3902036,South Street Community Primary School,222,18220,10628,7592
390,Gateshead,3902039,Bede Community Primary School,162,17620,10278,7342
390,Gateshead,3902049,Oakfield Junior School,235,18350,10704,7646
390,Gateshead,3902051,Larkspur Community Primary School,119,17190,10028,7162
390,Gateshead,3902055,Oakfield Infant School,119,17190,10028,7162
390,Gateshead,3902056,Ravensworth Terrace Primary School,226,18260,10652,7608
390,Gateshead,3902162,Portobello Primary School,177,17770,10366,7404
390,Gateshead,3902163,Birtley East Community Primary School,187,17870,10424,7446
390,Gateshead,3902164,Dunston Hill Community Primary School,332,19320,11270,8050
390,Gateshead,3902167,Emmaville Primary School,272,18720,10920,7800
390,Gateshead,3902168,High Spen Primary School,144,17440,10173,7267
390,Gateshead,3902172,Swalwell Primary School,149,17490,10203,7287
390,Gateshead,3902177,Winlaton West Lane Community Primary School,302,19020,11095,7925
390,Gateshead,3902181,Greenside Primary School,158,17580,10255,7325
390,Gateshead,3902182,Blaydon West Primary School,117,17170,10016,7154
390,Gateshead,3902184,Front Street Community Primary School,352,19520,11387,8133
390,Gateshead,3902186,Highfield Community Primary School,96,16960,9893,7067
390,Gateshead,3902188,Ryton Community Infant School,69,16690,9736,6954
390,Gateshead,3902193,Ryton Junior School,174,17740,10348,7392
390,Gateshead,3902194,Washingwell Community Primary School,136,17360,10127,7233
390,Gateshead,3902197,Bill Quay Primary School,181,17810,10389,7421
390,Gateshead,3902198,Falla Park Community Primary School,184,17840,10407,7433
390,Gateshead,3902200,Brandling Primary School,121,17210,10039,7171
390,Gateshead,3902205,Lingey House Primary School,338,19380,11305,8075
390,Gateshead,3902213,The Drive Community Primary School,155,17550,10238,7312
390,Gateshead,3902214,White Mere Community Primary School,114,17140,9998,7142
390,Gateshead,3902216,Clover Hill Community Primary School,181,17810,10389,7421
390,Gateshead,3902219,Crookhill Community Primary School,157,17570,10249,7321
390,Gateshead,3902221,Brighton Avenue Primary School,240,18400,10733,7667
390,Gateshead,3902222,Lobley Hill Primary School,335,19350,11288,8062
390,Gateshead,3902224,Wardley Primary School,248,18480,10780,7700
390,Gateshead,3902225,Glynwood Community Primary School,309,19090,11136,7954
390,Gateshead,3902226,Barley Mow Primary School,147,17470,10191,7279
390,Gateshead,3902227,Windy Nook Primary School,250,18500,10792,7708
390,Gateshead,3902228,Colegate Community Primary School,155,17550,10238,7312
390,Gateshead,3902229,Roman Road Primary School,147,17470,10191,7279
390,Gateshead,3902231,Fellside Community Primary School,180,17800,10383,7417
390,Gateshead,3902232,Fell Dyke Community Primary School,239,18390,10728,7662
390,Gateshead,3902233,Caedmon Community Primary School,176,17760,10360,7400
390,Gateshead,3902234,Kells Lane Primary School,356,19560,11410,8150
390,Gateshead,3902235,Chopwell Primary School,168,17680,10313,7367
390,Gateshead,3902236,Parkhead Community Primary School,275,18750,10938,7812
390,Gateshead,3902237,St Aidans Church of England Primary School,176,17760,10360,7400
390,Gateshead,3902238,Harlow Green Community Primary School,326,19260,11235,8025
390,Gateshead,3902239,Rowlands Gill Community Primary School,237,18370,10716,7654
390,Gateshead,3903001,Whickham Parochial Church of England Primary School,180,17800,10383,7417
390,Gateshead,3903313,Corpus Christi Catholic Primary School,171,17710,10331,7379
390,Gateshead,3903317,St Josephs Roman Catholic Voluntary Aided Primary School Gateshead,169,17690,10319,7371
390,Gateshead,3903318,St Oswalds Roman Catholic Voluntary Aided Primary School,164,17640,10290,7350
390,Gateshead,3903319,St Peters Roman Catholic Voluntary Aided Primary School,180,17800,10383,7417
390,Gateshead,3903322,St Annes Catholic Primary School,114,17140,9998,7142
390,Gateshead,3903324,St Josephs Catholic Junior School Birtley,114,17140,9998,7142
390,Gateshead,3903325,St Josephs Catholic Infant School Birtley,60,16600,9683,6917
390,Gateshead,3903326,St Agnes Catholic Primary School,177,17770,10366,7404
390,Gateshead,3903327,St Josephs Roman Catholic Voluntary Aided Primary School Highfield,100,17000,9917,7083
390,Gateshead,3903328,St Mary and St Thomas Aquinas Catholic Primary School,183,17830,10401,7429
390,Gateshead,3903330,St Philip Neri Roman Catholic Primary School,152,17520,10220,7300
390,Gateshead,3903331,St Josephs Catholic Primary School Blaydon,181,17810,10389,7421
390,Gateshead,3903333,St Marys Roman Catholic Primary School,179,17790,10378,7412
390,Gateshead,3903335,St Albans Catholic Primary School,179,17790,10378,7412
390,Gateshead,3903336,St Augustines Catholic Primary School,267,18670,10891,7779
390,Gateshead,3903339,St Wilfrids Roman Catholic Voluntary Aided Primary School,93,16930,9876,7054
390,Gateshead,3907007,Gibside School,113,17130,9993,7137
390,Gateshead,3907010,Eslington Primary School,59,16590,9678,6912
391,Newcastle upon Tyne,3912000,Dinnington First School,113,17130,9993,7137
391,Newcastle upon Tyne,3912001,Archibald First School,242,18420,10745,7675
391,Newcastle upon Tyne,3912002,South Gosforth First School,208,18080,10547,7533
391,Newcastle upon Tyne,3912003,Regent Farm First School,240,18400,10733,7667
391,Newcastle upon Tyne,3912005,Gosforth Park First School,181,17810,10389,7421
391,Newcastle upon Tyne,3912006,Broadway East First School,178,17780,10372,7408
391,Newcastle upon Tyne,3912009,Grange First School,180,17800,10383,7417
391,Newcastle upon Tyne,3912012,Throckley Primary School,216,18160,10593,7567
391,Newcastle upon Tyne,3912013,Newburn Manor Primary School,163,17630,10284,7346
391,Newcastle upon Tyne,3912015,West Denton Primary School,255,18550,10821,7729
391,Newcastle upon Tyne,3912016,Knop Law Primary School,295,18950,11054,7896
391,Newcastle upon Tyne,3912017,Milecastle Primary School,153,17530,10226,7304
391,Newcastle upon Tyne,3912020,Waverley Primary School,216,18160,10593,7567
391,Newcastle upon Tyne,3912021,Simonside Primary School,183,17830,10401,7429
391,Newcastle upon Tyne,3912030,Lemington Riverside Primary School,110,17100,9975,7125
391,Newcastle upon Tyne,3912031,Westerhope Primary School,319,19190,11194,7996
391,Newcastle upon Tyne,3912032,Byker Primary School,348,19480,11363,8117
391,Newcastle upon Tyne,3912033,West Jesmond Primary National Teaching School,528,21280,12413,8867
391,Newcastle upon Tyne,3912050,Benton Park Primary School,308,19080,11130,7950
391,Newcastle upon Tyne,3912080,Hawthorn Primary School,183,17830,10401,7429
391,Newcastle upon Tyne,3912090,Canning Street Primary School,356,19560,11410,8150
391,Newcastle upon Tyne,3912100,Chillingham Road Primary School,163,17630,10284,7346
391,Newcastle upon Tyne,3912170,Cragside Primary School,360,19600,11433,8167
391,Newcastle upon Tyne,3912210,Bridgewater Primary School,293,18930,11043,7887
391,Newcastle upon Tyne,3912225,Broadwood Primary School,264,18640,10873,7767
391,Newcastle upon Tyne,3912670,Ravenswood Primary School,502,21020,12262,8758
391,Newcastle upon Tyne,3912720,St Johns Primary School,167,17670,10308,7362
391,Newcastle upon Tyne,3912960,Wingrove Primary School,359,19590,11428,8162
391,Newcastle upon Tyne,3912998,Hotspur Primary School,352,19520,11387,8133
391,Newcastle upon Tyne,3912999,Moorside Community Primary School,340,19400,11317,8083
391,Newcastle upon Tyne,3913321,Christ Church CofE Primary School,94,16940,9882,7058
391,Newcastle upon Tyne,3913471,Archbishop Runcie CofE First School,120,17200,10033,7167
391,Newcastle upon Tyne,3913472,St Charles RC Primary School,180,17800,10383,7417
391,Newcastle upon Tyne,3913473,St Oswalds RC Primary School,180,17800,10383,7417
391,Newcastle upon Tyne,3913474,St Marks RC Primary School,177,17770,10366,7404
391,Newcastle upon Tyne,3913475,St Georges RC Primary School,110,17100,9975,7125
391,Newcastle upon Tyne,3913476,St Cuthberts RC Primary School,158,17580,10255,7325
391,Newcastle upon Tyne,3913477,St John Vianney RC Primary School,268,18680,10897,7783
391,Newcastle upon Tyne,3913485,St Pauls CofE Primary School,208,18080,10547,7533
391,Newcastle upon Tyne,3913650,English Martyrs RC Primary School,358,19580,11422,8158
391,Newcastle upon Tyne,3913662,Sacred Heart RC Primary School,182,17820,10395,7425
391,Newcastle upon Tyne,3913762,St Bedes RC Primary School,181,17810,10389,7421
391,Newcastle upon Tyne,3913765,St Cuthberts Catholic Primary School,181,17810,10389,7421
391,Newcastle upon Tyne,3913778,St Catherines RC Primary School,162,17620,10278,7342
391,Newcastle upon Tyne,3913781,St Josephs Catholic Primary School,166,17660,10302,7358
391,Newcastle upon Tyne,3913792,St Lawrences RC Primary School,168,17680,10313,7367
391,Newcastle upon Tyne,3913799,Our Lady and St Annes RC Primary School,181,17810,10389,7421
391,Newcastle upon Tyne,3913835,St Teresas Catholic Primary School,190,17900,10442,7458
391,Newcastle upon Tyne,3913842,St Vincents RC Primary School,172,17720,10337,7383
391,Newcastle upon Tyne,3913874,St Albans RC Primary School,172,17720,10337,7383
391,Newcastle upon Tyne,3913875,Brunton First School,300,19000,11083,7917
391,Newcastle upon Tyne,3914190,Gosforth Central Middle School,256,18560,10827,7733
391,Newcastle upon Tyne,3914305,Gosforth East Middle School,256,18560,10827,7733
391,Newcastle upon Tyne,3917034,Hadrian School,141,17410,10156,7254
392,North Tyneside,3922000,Cullercoats Primary School,369,19690,11486,8204
392,North Tyneside,3922004,Waterville Primary School,179,17790,10378,7412
392,North Tyneside,3922008,Percy Main Primary School,145,17450,10179,7271
392,North Tyneside,3922013,King Edward Primary School,357,19570,11416,8154
392,North Tyneside,3922016,Spring Gardens Primary School,333,19330,11276,8054
392,North Tyneside,3922021,Riverside Primary School,127,17270,10074,7196
392,North Tyneside,3922022,Monkhouse Primary School,184,17840,10407,7433
392,North Tyneside,3922024,Whitehouse Primary School,154,17540,10232,7308
392,North Tyneside,3922026,Preston Grange Primary School,174,17740,10348,7392
392,North Tyneside,3922031,Shiremoor Primary School,309,19090,11136,7954
392,North Tyneside,3922032,Backworth Park Primary School,121,17210,10039,7171
392,North Tyneside,3922036,Holystone Primary School,370,19700,11492,8208
392,North Tyneside,3922037,Westmoor Primary School,261,18610,10856,7754
392,North Tyneside,3922041,Rockcliffe First School,178,17780,10372,7408
392,North Tyneside,3922042,Appletree Gardens First School,237,18370,10716,7654
392,North Tyneside,3922046,Southridge First School,244,18440,10757,7683
392,North Tyneside,3922048,Amberley Primary School,353,19530,11393,8137
392,North Tyneside,3922054,Bailey Green Primary School,372,19720,11503,8217
392,North Tyneside,3922055,South Wellfield First School,235,18350,10704,7646
392,North Tyneside,3922058,Marine Park First School,359,19590,11428,8162
392,North Tyneside,3922059,Coquet Park First School,121,17210,10039,7171
392,North Tyneside,3922060,Langley First School,239,18390,10728,7662
392,North Tyneside,3922062,Carville Primary School,167,17670,10308,7362
392,North Tyneside,3922065,Wallsend Jubilee Primary School,269,18690,10903,7787
392,North Tyneside,3922068,Battle Hill Primary School,279,18790,10961,7829
392,North Tyneside,3922069,Richardson Dees Primary School,166,17660,10302,7358
392,North Tyneside,3922070,Stephenson Memorial Primary School,304,19040,11107,7933
392,North Tyneside,3922072,Redesdale Primary School,174,17740,10348,7392
392,North Tyneside,3922074,Whitley Lodge First School,184,17840,10407,7433
392,North Tyneside,3922076,Collingwood Primary School,295,18950,11054,7896
392,North Tyneside,3922077,Balliol Primary School,136,17360,10127,7233
392,North Tyneside,3922078,Benton Dene Primary School,357,19570,11416,8154
392,North Tyneside,3922079,Forest Hall Primary School,147,17470,10191,7279
392,North Tyneside,3922080,Ivy Road Primary School,87,16870,9841,7029
392,North Tyneside,3922081,New York Primary School,235,18350,10704,7646
392,North Tyneside,3922082,Denbigh Community Primary School,345,19450,11346,8104
392,North Tyneside,3922083,Greenfields Community Primary School,265,18650,10879,7771
392,North Tyneside,3922084,Hazlewood Community Primary School,135,17350,10121,7229
392,North Tyneside,3922085,Fordley Primary School,231,18310,10681,7629
392,North Tyneside,3922086,Burradon Community Primary School,137,17370,10133,7237
392,North Tyneside,3922087,Hadrian Park Primary School,311,19110,11148,7962
392,North Tyneside,3922088,Western Community Primary School,353,19530,11393,8137
392,North Tyneside,3923301,Christ Church CofE Primary School,165,17650,10296,7354
392,North Tyneside,3923302,St Bartholomews Church of England Primary School (Aided),176,17760,10360,7400
392,North Tyneside,3923305,St Cuthberts Roman Catholic Primary School Aided,180,17800,10383,7417
392,North Tyneside,3923308,St Josephs Roman Catholic Primary School Aided,240,18400,10733,7667
392,North Tyneside,3923309,St Marys Roman Catholic Primary School Aided,179,17790,10378,7412
392,North Tyneside,3923315,St Marys Roman Catholic Primary School Aided,167,17670,10308,7362
392,North Tyneside,3923316,St Stephens Roman Catholic Primary School Aided,184,17840,10407,7433
392,North Tyneside,3923317,Star of the Sea RC VA Primary,354,19540,11398,8142
392,North Tyneside,3923318,St Aidans Roman Catholic Primary School,165,17650,10296,7354
392,North Tyneside,3923319,St Bernadettes Roman Catholic Primary School Aided,266,18660,10885,7775
392,North Tyneside,3923320,St Columbas Roman Catholic Primary School Aided,172,17720,10337,7383
392,North Tyneside,3923321,Wallsend St Peters CofE Aided Primary School,174,17740,10348,7392
392,North Tyneside,3924025,Marden Bridge Middle School,267,18670,10891,7779
392,North Tyneside,3924026,Valley Gardens Middle School,383,19830,11568,8262
392,North Tyneside,3924027,Monkseaton Middle School,155,17550,10238,7312
392,North Tyneside,3925400,Wellfield Middle School,142,17420,10162,7258
392,North Tyneside,3927001,Woodlawn School,39,16390,9561,6829
392,North Tyneside,3927004,Benton Dene School,106,17060,9952,7108
392,North Tyneside,3927007,Silverdale School,19,16190,9444,6746
392,North Tyneside,3927008,Beacon Hill School,75,16750,9771,6979
393,South Tyneside,3931100,Alternative Education Service - The Beacon Centre,2,2000,1167,833
393,South Tyneside,3932000,Hadrian Primary School,236,18360,10710,7650
393,South Tyneside,3932001,Westoe Crown Primary School,524,21240,12390,8850
393,South Tyneside,3932002,Sea View Primary School,330,19300,11258,8042
393,South Tyneside,3932015,Laygate Community School,168,17680,10313,7367
393,South Tyneside,3932017,Mortimer Primary School,488,20880,12180,8700
393,South Tyneside,3932020,Marine Park Primary School,169,17690,10319,7371
393,South Tyneside,3932023,Stanhope Primary School,168,17680,10313,7367
393,South Tyneside,3932028,Biddick Hall Junior School,223,18230,10634,7596
393,South Tyneside,3932033,Biddick Hall Infants School,111,17110,9981,7129
393,South Tyneside,3932038,Ashley Primary School,353,19530,11393,8137
393,South Tyneside,3932040,Hedworth Lane Primary School,254,18540,10815,7725
393,South Tyneside,3932042,Marsden Primary School,183,17830,10401,7429
393,South Tyneside,3932043,East Boldon Infants School,118,17180,10022,7158
393,South Tyneside,3932050,East Boldon Junior School,243,18430,10751,7679
393,South Tyneside,3932055,Bede Burn Primary School,179,17790,10378,7412
393,South Tyneside,3932056,Valley View Primary School,178,17780,10372,7408
393,South Tyneside,3932063,Dunn Street Primary School,116,17160,10010,7150
393,South Tyneside,3932073,Simonside Primary School,208,18080,10547,7533
393,South Tyneside,3932075,Hedworthfield Primary School,179,17790,10378,7412
393,South Tyneside,3932076,Lord Blyton Primary School,150,17500,10208,7292
393,South Tyneside,3932080,West Boldon Primary School,259,18590,10844,7746
393,South Tyneside,3932083,Toner Avenue Primary School,249,18490,10786,7704
393,South Tyneside,3932085,Fellgate Primary School,169,17690,10319,7371
393,South Tyneside,3932086,Whitburn Village Primary School,181,17810,10389,7421
393,South Tyneside,3933006,St Oswalds CofE Aided Primary School,179,17790,10378,7412
393,South Tyneside,3933010,Jarrow Cross CofE Primary School,248,18480,10780,7700
393,South Tyneside,3933301,St Bedes RC Voluntary Aided Primary School South Shields,179,17790,10378,7412
393,South Tyneside,3933303,St Gregorys RC Voluntary Aided Primary School,186,17860,10418,7442
393,South Tyneside,3933304,SS Peter and Paul RC Voluntary Aided Primary School,175,17750,10354,7396
393,South Tyneside,3933305,St Oswalds RC Voluntary Aided Primary School,167,17670,10308,7362
393,South Tyneside,3933306,St Aloysius RC Voluntary Aided Junior School,241,18410,10739,7671
393,South Tyneside,3933307,St Aloysius RC Voluntary Aided Infant School,123,17230,10051,7179
393,South Tyneside,3933311,St Matthews RC Voluntary Aided Primary School,178,17780,10372,7408
393,South Tyneside,3933312,St Marys RC Voluntary Aided Primary School,177,17770,10366,7404
393,South Tyneside,3933313,St James RC Voluntary Aided Primary School,179,17790,10378,7412
393,South Tyneside,3933314,St Josephs RC Voluntary Aided Primary School,172,17720,10337,7383
393,South Tyneside,3933315,St Bedes RC Primary School Jarrow,163,17630,10284,7346
393,South Tyneside,3933318,Forest View Primary,213,18130,10576,7554
393,South Tyneside,3933319,Hebburn Lakes Primary School,346,19460,11352,8108
393,South Tyneside,3933320,Harton Primary School,529,21290,12419,8871
393,South Tyneside,3937000,Bamburgh School,84,16840,9823,7017
393,South Tyneside,3937004,Epinay Business and Enterprise School,50,16500,9625,6875
393,South Tyneside,3937007,Keelmans Way School,61,16610,9689,6921
394,Sunderland,3941101,Ks1 Pupil Referral Unit,4,4000,2333,1667
394,Sunderland,3941102,The Link School Tudor Grove,9,9000,5250,3750
394,Sunderland,3942002,Barnes Junior School,343,19430,11334,8096
394,Sunderland,3942004,Broadway Junior School,260,18600,10850,7750
394,Sunderland,3942006,Northern Saints CofE Voluntary Aided Primary School,460,20600,12017,8583
394,Sunderland,3942010,Grangetown Primary School,209,18090,10553,7537
394,Sunderland,3942019,Fulwell Junior School,347,19470,11358,8112
394,Sunderland,3942021,Grange Park Primary School,166,17660,10302,7358
394,Sunderland,3942026,Grindon Infant School,80,16800,9800,7000
394,Sunderland,3942035,Southwick  Community Primary School,303,19030,11101,7929
394,Sunderland,3942042,Hudson Road Primary School,240,18400,10733,7667
394,Sunderland,3942070,Dame Dorothy Primary School,172,17720,10337,7383
394,Sunderland,3942088,Willow Fields Community Primary School,117,17170,10016,7154
394,Sunderland,3942089,Mill Hill Primary School,336,19360,11293,8067
394,Sunderland,3942092,Seaburn Dene Primary School,161,17610,10273,7337
394,Sunderland,3942093,Ryhope Junior School,219,18190,10611,7579
394,Sunderland,3942099,Castletown Primary School,327,19270,11241,8029
394,Sunderland,3942104,East Rainton Primary School,89,16890,9853,7037
394,Sunderland,3942105,Easington Lane Primary School,182,17820,10395,7425
394,Sunderland,3942115,Usworth Colliery Primary School,351,19510,11381,8129
394,Sunderland,3942117,Springwell Village Primary School,171,17710,10331,7379
394,Sunderland,3942126,Hetton Primary School,106,17060,9952,7108
394,Sunderland,3942153,Biddick Primary School,269,18690,10903,7787
394,Sunderland,3942157,Lambton Primary School,217,18170,10599,7571
394,Sunderland,3942158,Rickleton Primary School,359,19590,11428,8162
394,Sunderland,3942159,Richard Avenue Primary School,343,19430,11334,8096
394,Sunderland,3942167,Marlborough Primary School,142,17420,10162,7258
394,Sunderland,3942171,Shiney Row Primary School,194,17940,10465,7475
394,Sunderland,3942174,Thorney Close Primary School,193,17930,10459,7471
394,Sunderland,3942176,Bernard Gilpin Primary School,344,19440,11340,8100
394,Sunderland,3942178,Hylton Castle Primary School,171,17710,10331,7379
394,Sunderland,3942179,Blackfell Primary School,168,17680,10313,7367
394,Sunderland,3942181,Barmston Village Primary School,171,17710,10331,7379
394,Sunderland,3942182,Albany Village Primary School,178,17780,10372,7408
394,Sunderland,3943005,St Pauls CofE Primary School,175,17750,10354,7396
394,Sunderland,3943301,St Benets Roman Catholic Voluntary Aided Primary School,272,18720,10920,7800
394,Sunderland,3943302,St Cuthberts Roman Catholic Voluntary Aided Primary School,173,17730,10343,7387
394,Sunderland,3943306,St Marys Roman Catholic Voluntary Aided Primary School,364,19640,11457,8183
394,Sunderland,3943308,St Josephs Roman Catholic Voluntary Aided Primary School Sunderland,182,17820,10395,7425
394,Sunderland,3943313,English Martyrs Roman Catholic Voluntary Aided Primary School,169,17690,10319,7371
394,Sunderland,3943315,St Annes Roman Catholic Voluntary Aided Primary School,184,17840,10407,7433
394,Sunderland,3943316,St John Bosco Roman Catholic Voluntary Aided Primary School,157,17570,10249,7321
394,Sunderland,3943317,St Patricks Roman Catholic Voluntary Aided Primary School,119,17190,10028,7162
394,Sunderland,3943319,St Leonards Roman Catholic Voluntary Aided Primary School,166,17660,10302,7358
394,Sunderland,3943323,St Michaels Roman Catholic Voluntary Aided Primary School,181,17810,10389,7421
394,Sunderland,3943326,St Josephs Washington RC School,175,17750,10354,7396
394,Sunderland,3943327,Our Lady Queen of Peace Roman Catholic Voluntary Aided Primary School,245,18450,10763,7687
394,Sunderland,3943329,St Bedes Roman Catholic Voluntary Aided Primary School,181,17810,10389,7421
394,Sunderland,3943330,St John Boste Roman Catholic Voluntary Aided Primary School,174,17740,10348,7392
394,Sunderland,3943332,Wessington Primary School,171,17710,10331,7379
394,Sunderland,3947001,Columbia Grange School,105,17050,9946,7104
394,Sunderland,3947016,Sunningdale School,89,16890,9853,7037
800,Bath and North East Somerset,8002160,Twerton Infant School,88,16880,9847,7033
800,Bath and North East Somerset,8002238,Chew Magna Primary School,92,16920,9870,7050
800,Bath and North East Somerset,8002243,Paulton Infant School,149,17490,10203,7287
800,Bath and North East Somerset,8002246,Pensford Primary School,66,16660,9718,6942
800,Bath and North East Somerset,8002251,Whitchurch Primary School,166,17660,10302,7358
800,Bath and North East Somerset,8002260,Castle Primary School,236,18360,10710,7650
800,Bath and North East Somerset,8002270,Paulton Junior School,276,18760,10943,7817
800,Bath and North East Somerset,8003078,Cameley CofE VC Primary School,76,16760,9777,6983
800,Bath and North East Somerset,8003103,Swainswick CofE Primary School,57,16570,9666,6904
800,Bath and North East Somerset,8003105,St Marys CofE Primary School,151,17510,10214,7296
800,Bath and North East Somerset,8003109,St Marys Church of England Primary School,116,17160,10010,7150
800,Bath and North East Somerset,8003424,St Johns Catholic Primary School,271,18710,10914,7796
800,Bath and North East Somerset,8003425,St Marys Catholic Primary School,165,17650,10296,7354
800,Bath and North East Somerset,8003446,St Nicholas CofE Primary,203,18030,10518,7512
800,Bath and North East Somerset,8003448,St Keyna Primary School,206,18060,10535,7525
800,Bath and North East Somerset,8003449,Newbridge Primary School,356,19560,11410,8150
801,Bristol City of,8012001,Brunel Field Primary School,356,19560,11410,8150
801,Bristol City of,8012003,Ashley Down Primary School,358,19580,11422,8158
801,Bristol City of,8012004,Ashton Gate Primary School,582,21820,12728,9092
801,Bristol City of,8012006,Nova Primary School,315,19150,11171,7979
801,Bristol City of,8012018,Broomhill Junior School,181,17810,10389,7421
801,Bristol City of,8012019,St Werburghs Primary School,249,18490,10786,7704
801,Bristol City of,8012020,Chester Park Junior School,247,18470,10774,7696
801,Bristol City of,8012021,Chester Park Infant School,133,17330,10109,7221
801,Bristol City of,8012023,Hillcrest Primary School,356,19560,11410,8150
801,Bristol City of,8012027,Shirehampton Primary School,361,19610,11439,8171
801,Bristol City of,8012028,Two Mile Hill Primary School,509,21090,12303,8787
801,Bristol City of,8012037,Glenfrome Primary School,314,19140,11165,7975
801,Bristol City of,8012041,Henleaze Infant School,180,17800,10383,7417
801,Bristol City of,8012069,St Annes Infant School,167,17670,10308,7362
801,Bristol City of,8012073,Sefton Park Infant School,120,17200,10033,7167
801,Bristol City of,8012074,Sefton Park Junior School,237,18370,10716,7654
801,Bristol City of,8012079,Southville Primary School,358,19580,11422,8158
801,Bristol City of,8012081,Summerhill Infant School,170,17700,10325,7375
801,Bristol City of,8012086,Upper Horfield Primary School,156,17560,10243,7317
801,Bristol City of,8012098,Holymead Primary School,517,21170,12349,8821
801,Bristol City of,8012109,Brentry Primary School,176,17760,10360,7400
801,Bristol City of,8012115,Broomhill Infant School & Childrens Centre,110,17100,9975,7125
801,Bristol City of,8012138,Elmlea Infant School,180,17800,10383,7417
801,Bristol City of,8012139,Cabot Primary School,157,17570,10249,7321
801,Bristol City of,8012299,Hannah More Primary School,306,19060,11118,7942
801,Bristol City of,8012312,Bishop Road Primary School,684,22840,13323,9517
801,Bristol City of,8012314,Blaise Primary and Nursery School,334,19340,11282,8058
801,Bristol City of,8012326,Fair Furlong Primary School,347,19470,11358,8112
801,Bristol City of,8012327,May Park Primary School,556,21560,12577,8983
801,Bristol City of,8012328,Whitehall Primary School,415,20150,11754,8396
801,Bristol City of,8013000,Avonmouth Church of England Primary School,168,17680,10313,7367
801,Bristol City of,8013008,Horfield Church of England Primary School,359,19590,11428,8162
801,Bristol City of,8013010,St Barnabas Church of England VC Primary School,156,17560,10243,7317
801,Bristol City of,8013013,St George Church of England Primary School,60,16600,9683,6917
801,Bristol City of,8013014,St Johns Church of England Primary School Clifton,400,20000,11667,8333
801,Bristol City of,8013018,St Michaels on the Mount Church of England Primary School,141,17410,10156,7254
801,Bristol City of,8013400,School of Christ The King Catholic Primary,174,17740,10348,7392
801,Bristol City of,8013401,Holy Cross RC Primary School,155,17550,10238,7312
801,Bristol City of,8013402,Ss Peter and Paul RC Primary School,176,17760,10360,7400
801,Bristol City of,8013403,St Bernards Catholic Primary School,172,17720,10337,7383
801,Bristol City of,8013405,St Josephs Catholic Primary School,180,17800,10383,7417
801,Bristol City of,8013412,Our Lady of the Rosary Catholic Primary School Bristol,180,17800,10383,7417
801,Bristol City of,8013413,St Pius X RC Primary School,118,17180,10022,7158
801,Bristol City of,8013415,St Bernadette Catholic Voluntary Aided Primary School,173,17730,10343,7387
801,Bristol City of,8013417,St Bonaventures Catholic Primary School,339,19390,11311,8079
801,Bristol City of,8013433,Stoke Park Primary School,166,17660,10302,7358
801,Bristol City of,8013437,Bridge Farm Primary School,509,21090,12303,8787
801,Bristol City of,8013438,Knowle Park Primary School,535,21350,12454,8896
801,Bristol City of,8013439,Sea Mills Primary School,177,17770,10366,7404
801,Bristol City of,8013441,Air Balloon Hill Primary School,689,22890,13353,9537
801,Bristol City of,8013442,St Peters Church of England Primary School (VC),359,19590,11428,8162
801,Bristol City of,8017000,Elmfield School for Deaf Children,21,16210,9456,6754
801,Bristol City of,8017001,Bristol Gateway School,5,5000,2917,2083
801,Bristol City of,8017002,Kingsweston School,51,16510,9631,6879
801,Bristol City of,8017011,Claremont School,18,16180,9438,6742
801,Bristol City of,8017014,New Fosseway School,32,16320,9520,6800
801,Bristol City of,8017025,Woodstock School,58,16580,9672,6908
801,Bristol City of,8017042,Briarwood School,70,16700,9742,6958
802,North Somerset,8021102,Voyage Learning Campus,13,13000,7583,5417
802,North Somerset,8022271,Banwell Primary School,162,17620,10278,7342
802,North Somerset,8022272,Blagdon Primary School,96,16960,9893,7067
802,North Somerset,8022273,Kewstoke Primary School,78,16780,9788,6992
802,North Somerset,8022276,Uphill Primary School,266,18660,10885,7775
802,North Somerset,8022283,Sandford Primary School,128,17280,10080,7200
802,North Somerset,8022284,Winscombe Primary School,180,17800,10383,7417
802,North Somerset,8022295,Golden Valley Primary School,357,19570,11416,8154
802,North Somerset,8023113,Churchill Church of England Primary School,170,17700,10325,7375
802,North Somerset,8023114,St Andrews Primary School,215,18150,10588,7562
802,North Somerset,8023119,Wrington Church of England Primary School,173,17730,10343,7387
802,North Somerset,8023349,St Josephs Catholic Primary School,177,17770,10366,7404
802,North Somerset,8023350,St Francis Catholic Primary School,163,17630,10284,7346
802,North Somerset,8023351,Burrington Church of England Voluntary Aided Primary School,63,16630,9701,6929
802,North Somerset,8023352,Worlebury St Pauls Church of England Voluntary Aided  Primary School,176,17760,10360,7400
802,North Somerset,8023354,Corpus Christi Catholic Primary School,174,17740,10348,7392
802,North Somerset,8027036,Westhaven School,28,16280,9497,6783
802,North Somerset,8027037,Ravenswood School,33,16330,9526,6804
802,North Somerset,8027039,Baytree School,25,16250,9479,6771
803,South Gloucestershire,8031100,Pathways Learning Centre,9,9000,5250,3750
803,South Gloucestershire,8032002,Coniston Primary School,148,17480,10197,7283
803,South Gloucestershire,8032003,Little Stoke Primary School,153,17530,10226,7304
803,South Gloucestershire,8032005,Wheatfield Primary School,342,19420,11328,8092
803,South Gloucestershire,8032007,Emersons Green Primary School,238,18380,10722,7658
803,South Gloucestershire,8032008,Abbotswood Primary School,236,18360,10710,7650
803,South Gloucestershire,8032011,Watermore Primary School,260,18600,10850,7750
803,South Gloucestershire,8032168,Redfield Edge Primary School,170,17700,10325,7375
803,South Gloucestershire,8032172,Shield Road Primary School,202,18020,10512,7508
803,South Gloucestershire,8032174,Hanham Abbots Junior School,351,19510,11381,8129
803,South Gloucestershire,8032176,The Park Primary School,500,21000,12250,8750
803,South Gloucestershire,8032179,Staple Hill Primary School,261,18610,10856,7754
803,South Gloucestershire,8032180,Cadbury Heath Primary School,164,17640,10290,7350
803,South Gloucestershire,8032181,Parkwall Primary School,111,17110,9981,7129
803,South Gloucestershire,8032185,Alexander Hosea Primary School,167,17670,10308,7362
803,South Gloucestershire,8032186,Hambrook Primary School,176,17760,10360,7400
803,South Gloucestershire,8032187,North Road Community Primary School,87,16870,9841,7029
803,South Gloucestershire,8032188,The Ridge Junior School,238,18380,10722,7658
803,South Gloucestershire,8032191,Bromley Heath Junior School,236,18360,10710,7650
803,South Gloucestershire,8032192,Bromley Heath Infant School,120,17200,10033,7167
803,South Gloucestershire,8032194,Longwell Green Primary School,350,19500,11375,8125
803,South Gloucestershire,8032199,Samuel Whites Infant School,177,17770,10366,7404
803,South Gloucestershire,8032200,The Tynings School,348,19480,11363,8117
803,South Gloucestershire,8032208,Crossways Junior School,241,18410,10739,7671
803,South Gloucestershire,8032215,St Stephens Infant School,177,17770,10366,7404
803,South Gloucestershire,8032216,Barley Close Community Primary School,318,19180,11188,7992
803,South Gloucestershire,8032220,Crossways Infant School,94,16940,9882,7058
803,South Gloucestershire,8032224,Raysfield Junior School,231,18310,10681,7629
803,South Gloucestershire,8032225,Raysfield Infants School,120,17200,10033,7167
803,South Gloucestershire,8032227,Courtney Primary School,166,17660,10302,7358
803,South Gloucestershire,8032231,Broadway Infant School,118,17180,10022,7158
803,South Gloucestershire,8032306,Wellesley Primary School,176,17760,10360,7400
803,South Gloucestershire,8032308,Cherry Garden Primary School,157,17570,10249,7321
803,South Gloucestershire,8032313,Elm Park Primary School,247,18470,10774,7696
803,South Gloucestershire,8032317,Blackhorse Primary School,351,19510,11381,8129
803,South Gloucestershire,8032322,Gillingstool Primary School,147,17470,10191,7279
803,South Gloucestershire,8032329,Beacon Rise Primary School,511,21110,12314,8796
803,South Gloucestershire,8032331,Stanbridge Primary School,353,19530,11393,8137
803,South Gloucestershire,8032333,Barrs Court Primary School,255,18550,10821,7729
803,South Gloucestershire,8032339,Manorbrook Primary School,176,17760,10360,7400
803,South Gloucestershire,8032340,Bowsland Green Primary School,224,18240,10640,7600
803,South Gloucestershire,8032341,Baileys Court Primary School,384,19840,11573,8267
803,South Gloucestershire,8033042,Almondsbury Church of England Primary School,263,18630,10868,7762
803,South Gloucestershire,8033043,St Helens Church of England Primary School,179,17790,10378,7412
803,South Gloucestershire,8033044,St Annes Church of England Primary School,357,19570,11416,8154
803,South Gloucestershire,8033045,Frampton Cotterell Church of England Primary School,253,18530,10809,7721
803,South Gloucestershire,8033046,Hawkesbury Church of England Primary School,90,16900,9858,7042
803,South Gloucestershire,8033047,Iron Acton Church of England Primary School,72,16720,9753,6967
803,South Gloucestershire,8033048,Christ Church Hanham CofE Primary School,311,19110,11148,7962
803,South Gloucestershire,8033049,Mangotsfield Church of England Voluntary Controlled Primary School,434,20340,11865,8475
803,South Gloucestershire,8033050,Christ Church Church of England Junior School Downend,289,18890,11019,7871
803,South Gloucestershire,8033051,Christ Church Church of England Infant School Downend,148,17480,10197,7283
803,South Gloucestershire,8033052,St Stephens Church of England Junior School Soundwell,360,19600,11433,8167
803,South Gloucestershire,8033053,Marshfield Church of England Primary School,144,17440,10173,7267
803,South Gloucestershire,8033054,Oldbury on Severn Church of England Primary School,46,16460,9602,6858
803,South Gloucestershire,8033055,Olveston Church of England Primary School,155,17550,10238,7312
803,South Gloucestershire,8033056,Pucklechurch CofE VC Primary School,159,17590,10261,7329
803,South Gloucestershire,8033057,Rangeworthy Church of England Primary School,44,16440,9590,6850
803,South Gloucestershire,8033059,St Barnabas CofE Primary School,185,17850,10413,7437
803,South Gloucestershire,8033061,Old Sodbury Church of England Primary School,86,16860,9835,7025
803,South Gloucestershire,8033064,The Manor Coalpit Heath Church of England Primary School,160,17600,10267,7333
803,South Gloucestershire,8033065,Wick Church of England Primary School,149,17490,10203,7287
803,South Gloucestershire,8033067,Frenchay Church of England Primary School,116,17160,10010,7150
803,South Gloucestershire,8033070,St Chads Patchway CofE Primary School,226,18260,10652,7608
803,South Gloucestershire,8033071,Tortworth VC Primary School,36,16360,9543,6817
803,South Gloucestershire,8033072,St Andrews Church of England Primary School Cromhall,61,16610,9689,6921
803,South Gloucestershire,8033073,Trinity Church of England Primary School,126,17260,10068,7192
803,South Gloucestershire,8033123,St Michaels Church of England Primary School Winterbourne,171,17710,10331,7379
803,South Gloucestershire,8033126,St Michaels Church of England Primary School Stoke Gifford,565,21650,12629,9021
803,South Gloucestershire,8033127,St Johns Mead Church of England Primary School,262,18620,10862,7758
803,South Gloucestershire,8033300,St Marys Catholic Primary School,176,17760,10360,7400
803,South Gloucestershire,8033410,Holy Trinity Primary School,174,17740,10348,7392
803,South Gloucestershire,8033431,Horton CofE VA Primary School,58,16580,9672,6908
803,South Gloucestershire,8033432,St Marys Church of England Primary School Thornbury,189,17890,10436,7454
803,South Gloucestershire,8033433,St Marys Church of England Primary School Yate,284,18840,10990,7850
803,South Gloucestershire,8033434,Our Lady of Lourdes Catholic Primary School,162,17620,10278,7342
803,South Gloucestershire,8033435,Holy Family Catholic Primary School,160,17600,10267,7333
803,South Gloucestershire,8033436,Christ The King Catholic Primary School Thornbury,144,17440,10173,7267
803,South Gloucestershire,8033437,St Augustines of Canterbury RC Primary School,193,17930,10459,7471
803,South Gloucestershire,8033438,St Pauls Catholic Primary School,176,17760,10360,7400
803,South Gloucestershire,8033440,Kings Forest Primary School,353,19530,11393,8137
803,South Gloucestershire,8033441,St Peters Anglican / Methodist VC Primary,177,17770,10366,7404
803,South Gloucestershire,8033442,Tyndale Primary School,163,17630,10284,7346
803,South Gloucestershire,8037028,Warmley Park School,40,16400,9567,6833
803,South Gloucestershire,8037032,New Horizons Learning Centre,16,16000,9333,6667
805,Hartlepool,8052000,Ward Jackson Primary School,106,17060,9952,7108
805,Hartlepool,8052126,Golden Flatts Primary School,117,17170,10016,7154
805,Hartlepool,8052153,Lynnfield Primary School,300,19000,11083,7917
805,Hartlepool,8052187,Fens Primary School,348,19480,11363,8117
805,Hartlepool,8052189,Kingsley Primary School,361,19610,11439,8171
805,Hartlepool,8052211,St Helens Primary School,256,18560,10827,7733
805,Hartlepool,8052236,Throston Primary School,359,19590,11428,8162
805,Hartlepool,8052238,Clavering Primary School,318,19180,11188,7992
805,Hartlepool,8052310,Barnard Grove Primary School,270,18700,10908,7792
805,Hartlepool,8052341,Rift House Primary School,185,17850,10413,7437
805,Hartlepool,8052342,Rossmere Primary School,283,18830,10984,7846
805,Hartlepool,8052364,Grange Primary School,286,18860,11002,7858
805,Hartlepool,8053006,Greatham CofE Primary School,81,16810,9806,7004
805,Hartlepool,8053321,Sacred Heart RC Primary School,357,19570,11416,8154
805,Hartlepool,8053322,St Cuthberts RC Primary School,212,18120,10570,7550
805,Hartlepool,8053323,St Josephs RC Primary School,106,17060,9952,7108
805,Hartlepool,8053324,St Teresas RC Primary School,272,18720,10920,7800
805,Hartlepool,8053328,St Begas RC Primary School,144,17440,10173,7267
805,Hartlepool,8053329,St John Vianney RC Primary School,171,17710,10331,7379
805,Hartlepool,8057027,Springwell School,68,16680,9730,6950
806,Middlesbrough,8062000,Abingdon Primary School,350,19500,11375,8125
806,Middlesbrough,8062002,Whinney Banks Primary School,357,19570,11416,8154
806,Middlesbrough,8062120,Beech Grove Primary School,335,19350,11288,8062
806,Middlesbrough,8062124,Newport Primary School,244,18440,10757,7683
806,Middlesbrough,8062138,Newham Bridge Primary School,226,18260,10652,7608
806,Middlesbrough,8062139,Acklam Whin Primary School,366,19660,11468,8192
806,Middlesbrough,8062141,Breckon Hill Primary School,412,20120,11737,8383
806,Middlesbrough,8062326,Berwick Hills Primary School,255,18550,10821,7729
806,Middlesbrough,8062332,Park End Primary School,392,19920,11620,8300
806,Middlesbrough,8062333,Thorntree Primary School,277,18770,10949,7821
806,Middlesbrough,8067000,Priory Woods School,68,16680,9730,6950
806,Middlesbrough,8067003,Beverley School,50,16500,9625,6875
806,Middlesbrough,8067005,Holmwood School,78,16780,9788,6992
807,Redcar and Cleveland,8071100,Archway,2,2000,1167,833
807,Redcar and Cleveland,8072000,Highcliffe Primary School,325,19250,11229,8021
807,Redcar and Cleveland,8072016,Lingdale Primary School,62,16620,9695,6925
807,Redcar and Cleveland,8072018,Lockwood Primary School,151,17510,10214,7296
807,Redcar and Cleveland,8072207,Bankfields Primary School,230,18300,10675,7625
807,Redcar and Cleveland,8072311,Hummersea Primary School,189,17890,10436,7454
807,Redcar and Cleveland,8072336,Whale Hill Primary School,443,20430,11918,8512
807,Redcar and Cleveland,8072339,Newcomen Primary School,299,18990,11078,7912
807,Redcar and Cleveland,8072349,Grangetown Primary School,204,18040,10523,7517
807,Redcar and Cleveland,8072365,Belmont Primary School,274,18740,10932,7808
807,Redcar and Cleveland,8072366,Saltburn Primary School,343,19430,11334,8096
807,Redcar and Cleveland,8073389,Caedmon Primary School,223,18230,10634,7596
807,Redcar and Cleveland,8073394,South Bank Community Primary School,174,17740,10348,7392
807,Redcar and Cleveland,8073396,Chaloner Primary School,192,17920,10453,7467
807,Redcar and Cleveland,8073397,Handale Primary School,169,17690,10319,7371
807,Redcar and Cleveland,8077008,Kirkleatham Hall School,67,16670,9724,6946
808,Stockton-on-Tees,8081101,Bishopton Centre,1,1000,583,417
808,Stockton-on-Tees,8082000,Oakdene Primary School,224,18240,10640,7600
808,Stockton-on-Tees,8082002,St Francis of Assisi CofE School,271,18710,10914,7796
808,Stockton-on-Tees,8082003,Myton Park Primary School,183,17830,10401,7429
808,Stockton-on-Tees,8082004,High Clarence Primary School,70,16700,9742,6958
808,Stockton-on-Tees,8082005,Billingham South Community Primary School,354,19540,11398,8142
808,Stockton-on-Tees,8082022,Preston Primary School,167,17670,10308,7362
808,Stockton-on-Tees,8082030,Mill Lane Primary School,162,17620,10278,7342
808,Stockton-on-Tees,8082032,Bowesfield Primary School,181,17810,10389,7421
808,Stockton-on-Tees,8082056,Whitehouse Primary School,336,19360,11293,8067
808,Stockton-on-Tees,8082057,The Glebe Primary School,308,19080,11130,7950
808,Stockton-on-Tees,8082080,Durham Lane Primary School,154,17540,10232,7308
808,Stockton-on-Tees,8082088,Bewley Primary School,345,19450,11346,8104
808,Stockton-on-Tees,8082345,Oxbridge Lane Primary School,314,19140,11165,7975
808,Stockton-on-Tees,8082362,Ingleby Mill Primary School,482,20820,12145,8675
808,Stockton-on-Tees,8082363,Tilery Primary School,215,18150,10588,7562
808,Stockton-on-Tees,8082371,Mandale Mill Primary School,255,18550,10821,7729
808,Stockton-on-Tees,8083000,Priors Mill Church of England Controlled Primary School Billingham,405,20050,11696,8354
808,Stockton-on-Tees,8083001,St John the Baptist Church of England Voluntary Controlled Primary School,180,17800,10383,7417
808,Stockton-on-Tees,8083002,Thornaby-on-Tees Church of England Voluntary Controlled Primary School,293,18930,11043,7887
808,Stockton-on-Tees,8083312,St Cuthberts RC Voluntary Aided Primary School,171,17710,10331,7379
808,Stockton-on-Tees,8083316,St Patricks Roman Catholic Voluntary Aided Primary School,230,18300,10675,7625
808,Stockton-on-Tees,8083392,William Cassidi Church of England Aided Primary School,144,17440,10173,7267
808,Stockton-on-Tees,8083393,Fairfield Primary School,356,19560,11410,8150
808,Stockton-on-Tees,8083394,Barley Fields Primary,505,21050,12279,8771
808,Stockton-on-Tees,8083395,Harewood Primary School,355,19550,11404,8146
808,Stockton-on-Tees,8083396,Holy Trinity Rosehill CofE Voluntary Aided Primary School,352,19520,11387,8133
808,Stockton-on-Tees,8083397,Roseberry Primary School,335,19350,11288,8062
810,Kingston Upon Hull City of,8102001,Victoria Dock Primary School,265,18650,10879,7771
810,Kingston Upon Hull City of,8102080,Cavendish Primary School,357,19570,11416,8154
810,Kingston Upon Hull City of,8102081,Gillshill Primary School,398,19980,11655,8325
810,Kingston Upon Hull City of,8102490,Oldfleet Primary School,295,18950,11054,7896
810,Kingston Upon Hull City of,8103506,St Andrews Church of England Voluntary Aided Primary School,499,20990,12244,8746
810,Kingston Upon Hull City of,8107000,Northcott School,23,16230,9468,6762
811,East Riding of Yorkshire,8112000,Bay Primary School,348,19480,11363,8117
811,East Riding of Yorkshire,8112001,Keldmarsh Primary School,180,17800,10383,7417
811,East Riding of Yorkshire,8112003,Hornsea Burton Primary School,55,16550,9654,6896
811,East Riding of Yorkshire,8112478,Hilderthorpe Primary School,298,18980,11072,7908
811,East Riding of Yorkshire,8112700,Aldbrough Primary School,104,17040,9940,7100
811,East Riding of Yorkshire,8112701,Barmby-on-the-Marsh Primary School,43,16430,9584,6846
811,East Riding of Yorkshire,8112702,Bempton Primary School,66,16660,9718,6942
811,East Riding of Yorkshire,8112704,Beverley St Nicholas Community Primary School,266,18660,10885,7775
811,East Riding of Yorkshire,8112706,Bilton Community Primary School,188,17880,10430,7450
811,East Riding of Yorkshire,8112707,Boynton Primary School,56,16560,9660,6900
811,East Riding of Yorkshire,8112708,Brandesburton Primary School,127,17270,10074,7196
811,East Riding of Yorkshire,8112709,Burlington Junior School,306,19060,11118,7942
811,East Riding of Yorkshire,8112710,Burlington Infant School,158,17580,10255,7325
811,East Riding of Yorkshire,8112715,Burstwick Community Primary School,111,17110,9981,7129
811,East Riding of Yorkshire,8112718,Burton Pidsea Primary School,57,16570,9666,6904
811,East Riding of Yorkshire,8112719,Driffield Junior School,494,20940,12215,8725
811,East Riding of Yorkshire,8112720,Eastrington Primary School,94,16940,9882,7058
811,East Riding of Yorkshire,8112721,Brough Primary School,353,19530,11393,8137
811,East Riding of Yorkshire,8112731,Hedon Primary School,151,17510,10214,7296
811,East Riding of Yorkshire,8112732,Holme-upon-Spalding Moor Primary School,199,17990,10494,7496
811,East Riding of Yorkshire,8112733,Hornsea Community Primary School,449,20490,11953,8537
811,East Riding of Yorkshire,8112734,Howden Junior School,212,18120,10570,7550
811,East Riding of Yorkshire,8112735,Hutton Cranswick Community Primary School,139,17390,10144,7246
811,East Riding of Yorkshire,8112738,Nafferton Primary School,243,18430,10751,7679
811,East Riding of Yorkshire,8112739,Newbald Primary School,75,16750,9771,6979
811,East Riding of Yorkshire,8112740,Newport Primary School,107,17070,9958,7112
811,East Riding of Yorkshire,8112741,North Frodingham Primary School,56,16560,9660,6900
811,East Riding of Yorkshire,8112742,Paull Primary School,48,16480,9613,6867
811,East Riding of Yorkshire,8112744,Preston Primary School,175,17750,10354,7396
811,East Riding of Yorkshire,8112747,Walkington Primary School,234,18340,10698,7642
811,East Riding of Yorkshire,8112748,Wawne Primary School,92,16920,9870,7050
811,East Riding of Yorkshire,8112749,Welton Primary School,354,19540,11398,8142
811,East Riding of Yorkshire,8112754,Leconfield Primary School,122,17220,10045,7175
811,East Riding of Yorkshire,8112757,Bacon Garth Primary School,159,17590,10261,7329
811,East Riding of Yorkshire,8112761,Bubwith Community Primary School,130,17300,10092,7208
811,East Riding of Yorkshire,8112765,Kirk Ella St Andrews Community Primary School,442,20420,11912,8508
811,East Riding of Yorkshire,8112766,Skipsea Primary School,39,16390,9561,6829
811,East Riding of Yorkshire,8112768,Westfield Primary School,353,19530,11393,8137
811,East Riding of Yorkshire,8112770,Springhead Primary School,177,17770,10366,7404
811,East Riding of Yorkshire,8112771,Martongate Primary School,365,19650,11463,8187
811,East Riding of Yorkshire,8112777,Acre Heads Primary School,331,19310,11264,8046
811,East Riding of Yorkshire,8112778,Molescroft Primary School,363,19630,11451,8179
811,East Riding of Yorkshire,8112780,Elloughton Primary School,253,18530,10809,7721
811,East Riding of Yorkshire,8112789,Rawcliffe Primary School,87,16870,9841,7029
811,East Riding of Yorkshire,8112790,Rawcliffe Bridge Primary School,40,16400,9567,6833
811,East Riding of Yorkshire,8112796,Snaith Primary School,266,18660,10885,7775
811,East Riding of Yorkshire,8112879,New Pasture Lane Primary School,179,17790,10378,7412
811,East Riding of Yorkshire,8112881,Inmans Primary School,353,19530,11393,8137
811,East Riding of Yorkshire,8112882,Market Weighton Infant School,149,17490,10203,7287
811,East Riding of Yorkshire,8112889,Northfield Infant School,86,16860,9835,7025
811,East Riding of Yorkshire,8112908,Parkside Primary School,407,20070,11708,8362
811,East Riding of Yorkshire,8112909,Kingsway Primary School,389,19890,11603,8287
811,East Riding of Yorkshire,8112910,Marshlands Primary School,201,18010,10506,7504
811,East Riding of Yorkshire,8112912,Reedness Primary School,37,16370,9549,6821
811,East Riding of Yorkshire,8112914,Boothferry Primary School,286,18860,11002,7858
811,East Riding of Yorkshire,8112915,Swinefleet Primary School,49,16490,9619,6871
811,East Riding of Yorkshire,8113011,Beeford Church of England Voluntary Controlled Primary School,68,16680,9730,6950
811,East Riding of Yorkshire,8113012,Beswick and Watton CofE (VC) School,15,15000,8750,6250
811,East Riding of Yorkshire,8113013,Beverley Minster Church of England Voluntary Controlled Primary School,333,19330,11276,8054
811,East Riding of Yorkshire,8113017,Bishop Wilton Church of England Voluntary Controlled Primary School,27,16270,9491,6779
811,East Riding of Yorkshire,8113018,Burton Agnes Church of England Voluntary Controlled Primary School,64,16640,9707,6933
811,East Riding of Yorkshire,8113019,Driffield Church of England Voluntary Controlled Infant School,157,17570,10249,7321
811,East Riding of Yorkshire,8113021,Flamborough CofE Primary School,93,16930,9876,7054
811,East Riding of Yorkshire,8113022,Garton-on-the-Wolds Church of England Voluntary Controlled Primary School,98,16980,9905,7075
811,East Riding of Yorkshire,8113023,All Saints Church of England Junior School,387,19870,11591,8279
811,East Riding of Yorkshire,8113024,All Saints Church of England Voluntary Controlled Infant School Hessle,199,17990,10494,7496
811,East Riding of Yorkshire,8113026,Kilham Church of England Voluntary Controlled School,113,17130,9993,7137
811,East Riding of Yorkshire,8113027,Leven Church of England Voluntary Controlled Primary School,144,17440,10173,7267
811,East Riding of Yorkshire,8113029,Mount Pleasant Church of England Voluntary Controlled Junior School,322,19220,11212,8008
811,East Riding of Yorkshire,8113030,Middleton-on-the-Wolds Church of England Voluntary Controlled Primary School,64,16640,9707,6933
811,East Riding of Yorkshire,8113031,North Cave Church of England Voluntary Controlled Primary School,85,16850,9829,7021
811,East Riding of Yorkshire,8113032,North Ferriby Church of England Voluntary Controlled Primary School,237,18370,10716,7654
811,East Riding of Yorkshire,8113034,Pocklington Church of England Voluntary Controlled Infant School,122,17220,10045,7175
811,East Riding of Yorkshire,8113036,Roos Church of England Voluntary Controlled Primary School,94,16940,9882,7058
811,East Riding of Yorkshire,8113037,Little Weighton Rowley Church of England Voluntary Controlled Primary School,41,16410,9573,6837
811,East Riding of Yorkshire,8113039,Skidby Church of England Voluntary Controlled Primary School,61,16610,9689,6921
811,East Riding of Yorkshire,8113040,Skirlaugh Church of England Voluntary Controlled Primary School,120,17200,10033,7167
811,East Riding of Yorkshire,8113042,Tickton Church of England Voluntary Controlled Primary School,179,17790,10378,7412
811,East Riding of Yorkshire,8113044,Wetwang Church of England Voluntary Controlled Primary School,44,16440,9590,6850
811,East Riding of Yorkshire,8113045,Wilberfoss Church of England Voluntary Controlled Primary School,184,17840,10407,7433
811,East Riding of Yorkshire,8113046,Woodmansey Church of England Voluntary Controlled Primary School,46,16460,9602,6858
811,East Riding of Yorkshire,8113047,Bugthorpe Church of England Voluntary Controlled Primary School,67,16670,9724,6946
811,East Riding of Yorkshire,8113048,Lockington Church of England Voluntary Controlled Primary School,37,16370,9549,6821
811,East Riding of Yorkshire,8113049,Cherry Burton Church of England Voluntary Controlled Primary School,149,17490,10203,7287
811,East Riding of Yorkshire,8113050,South Cave Church of England Voluntary Controlled Primary School,252,18520,10803,7717
811,East Riding of Yorkshire,8113081,Cowick Church of England Voluntary Controlled Primary School,85,16850,9829,7021
811,East Riding of Yorkshire,8113082,Sutton Upon Derwent Church of England Voluntary Controlled Primary School,73,16730,9759,6971
811,East Riding of Yorkshire,8113086,Sledmere Church of England Voluntary Controlled Primary School,38,16380,9555,6825
811,East Riding of Yorkshire,8113088,St Marys Church of England Voluntary Controlled Primary School Beverley,347,19470,11358,8112
811,East Riding of Yorkshire,8113313,St John of Beverley Roman Catholic Primary School Beverley,151,17510,10214,7296
811,East Riding of Yorkshire,8113315,St Marys Market Weighton Roman Catholic Primary School,85,16850,9829,7021
811,East Riding of Yorkshire,8113316,St Martins Church of England Voluntary Aided Primary School Fangfoss,71,16710,9748,6962
811,East Riding of Yorkshire,8113317,St Mary and St Joseph Roman Catholic Voluntary Aided Primary School,86,16860,9835,7025
811,East Riding of Yorkshire,8113318,Our Lady and St Peter Roman Catholic Voluntary Aided Primary School Bridlington,172,17720,10337,7383
811,East Riding of Yorkshire,8113331,Pollington-Balne Church of England Primary School,90,16900,9858,7042
811,East Riding of Yorkshire,8113332,St Josephs Catholic Primary School,91,16910,9864,7046
811,East Riding of Yorkshire,8113508,Keyingham Primary School,172,17720,10337,7383
811,East Riding of Yorkshire,8113509,Thorngumbald Primary School,200,18000,10500,7500
811,East Riding of Yorkshire,8113510,Hallgate Primary School Cottingham,241,18410,10739,7671
811,East Riding of Yorkshire,8113511,Swinemoor Primary School,210,18100,10558,7542
811,East Riding of Yorkshire,8113512,Anlaby Primary School,310,19100,11142,7958
811,East Riding of Yorkshire,8113513,Willerby Carr Lane Primary School,359,19590,11428,8162
811,East Riding of Yorkshire,8115200,Wold Newton Foundation School,80,16800,9800,7000
811,East Riding of Yorkshire,8115201,Howden Church of England Infant School,117,17170,10016,7154
811,East Riding of Yorkshire,8115202,Barmby Moor Church of England Primary School,82,16820,9812,7008
811,East Riding of Yorkshire,8115203,Warter Church of England Primary School,116,17160,10010,7150
811,East Riding of Yorkshire,8117016,Kings Mill School,49,16490,9619,6871
811,East Riding of Yorkshire,8117018,St Annes School and Sixth Form College,55,16550,9654,6896
811,East Riding of Yorkshire,8117025,Riverside Special School,23,16230,9468,6762
811,East Riding of Yorkshire,8111102,The Hub School,1,1000,583,417
812,North East Lincolnshire,8122113,Queen Mary Avenue Infant School,172,17720,10337,7383
812,North East Lincolnshire,8122877,Coomb Briggs Primary School,163,17630,10284,7346
812,North East Lincolnshire,8122899,Western Primary School,236,18360,10710,7650
812,North East Lincolnshire,8122929,Scartho Infants School and Nursery,120,17200,10033,7167
812,North East Lincolnshire,8123065,The Humberston CofE Primary School,220,18200,10617,7583
812,North East Lincolnshire,8123068,Stanford Junior and Infant School,203,18030,10518,7512
812,North East Lincolnshire,8123072,Stallingborough CofE Primary School,112,17120,9987,7133
812,North East Lincolnshire,8123519,Grange Primary School,222,18220,10628,7592
813,North Lincolnshire,8132001,Westcliffe Primary School,259,18590,10844,7746
813,North Lincolnshire,8132003,Lincoln Gardens Primary School,385,19850,11579,8271
813,North Lincolnshire,8132007,The Grange Primary School,340,19400,11317,8083
813,North Lincolnshire,8132100,Alkborough Primary School,59,16590,9678,6912
813,North Lincolnshire,8132101,Althorpe and Keadby Primary School,172,17720,10337,7383
813,North Lincolnshire,8132105,Bottesford Junior School,258,18580,10838,7742
813,North Lincolnshire,8132106,Brigg Primary School,324,19240,11223,8017
813,North Lincolnshire,8132107,Broughton Primary School,301,19010,11089,7921
813,North Lincolnshire,8132108,Burton-upon-Stather Primary School,178,17780,10372,7408
813,North Lincolnshire,8132116,East Halton Primary School,49,16490,9619,6871
813,North Lincolnshire,8132118,Goxhill Primary School,205,18050,10529,7521
813,North Lincolnshire,8132121,Kirton Lindsey Primary School,197,17970,10483,7487
813,North Lincolnshire,8132122,Luddington and Garthorpe Primary School,51,16510,9631,6879
813,North Lincolnshire,8132123,Messingham Primary School,206,18060,10535,7525
813,North Lincolnshire,8132125,Killingholme Primary School,87,16870,9841,7029
813,North Lincolnshire,8132130,Bushfield Road Infant School,117,17170,10016,7154
813,North Lincolnshire,8132133,Frodingham Infant School,144,17440,10173,7267
813,North Lincolnshire,8132138,South Ferriby Primary School,55,16550,9654,6896
813,North Lincolnshire,8132140,Winteringham Primary School,84,16840,9823,7017
813,North Lincolnshire,8132143,Priory Lane Community School,347,19470,11358,8112
813,North Lincolnshire,8132155,Enderby Road Infant School,70,16700,9742,6958
813,North Lincolnshire,8132159,Leys Farm Junior School,143,17430,10168,7262
813,North Lincolnshire,8132173,Bottesford Infant School,137,17370,10133,7237
813,North Lincolnshire,8132174,Berkeley Primary School,509,21090,12303,8787
813,North Lincolnshire,8132180,Winterton Junior School,240,18400,10733,7667
813,North Lincolnshire,8132181,St Peter and St Paul CofE Primary School,217,18170,10599,7571
813,North Lincolnshire,8132567,Holme Valley Primary School,352,19520,11387,8133
813,North Lincolnshire,8132568,Bowmandale Primary School,281,18810,10973,7837
813,North Lincolnshire,8132907,Crosby Primary School,421,20210,11789,8421
813,North Lincolnshire,8132940,Castledyke Primary School,238,18380,10722,7658
813,North Lincolnshire,8133055,St Barnabas CofE Primary School Barnetby,153,17530,10226,7304
813,North Lincolnshire,8133056,John Harrison CofE Primary School,168,17680,10313,7367
813,North Lincolnshire,8133057,Barton St Peters CofE Primary School,223,18230,10634,7596
813,North Lincolnshire,8133058,Belton All Saints CofE Primary School,176,17760,10360,7400
813,North Lincolnshire,8133063,Gunness and Burringham CofE Primary School,85,16850,9829,7021
813,North Lincolnshire,8133064,Haxey CofE Primary School,145,17450,10179,7271
813,North Lincolnshire,8133067,Kirmington CofE Primary School,44,16440,9590,6850
813,North Lincolnshire,8133071,Scunthorpe CofE Primary School,231,18310,10681,7629
813,North Lincolnshire,8133073,West Butterwick C of E Primary School,35,16350,9538,6812
813,North Lincolnshire,8133075,Winterton Church of England Infants School,127,17270,10074,7196
813,North Lincolnshire,8133076,Wrawby St Marys CofE Primary School,113,17130,9993,7137
813,North Lincolnshire,8133077,Wroot Travis Charity Church of England Primary School,26,16260,9485,6775
813,North Lincolnshire,8133078,New Holland Church of England and Methodist Primary School,49,16490,9619,6871
813,North Lincolnshire,8133320,St Martins CofE Primary School,78,16780,9788,6992
813,North Lincolnshire,8133322,Wootton St Andrews CofE Primary School,59,16590,9678,6912
813,North Lincolnshire,8133330,Eastoft Church of England Primary School,49,16490,9619,6871
813,North Lincolnshire,8133508,Oakfield Primary School,257,18570,10833,7737
813,North Lincolnshire,8137020,St Lukes Primary School,113,17130,9993,7137
815,North Yorkshire,8152040,Leeming and Londonderry Community Primary School,27,16270,9491,6779
815,North Yorkshire,8152043,Goathland Primary School,19,16190,9444,6746
815,North Yorkshire,8152060,Oakridge Community Primary School,33,16330,9526,6804
815,North Yorkshire,8152061,Staithes Seton Community Primary School,65,16650,9713,6937
815,North Yorkshire,8152063,Hunton and Arrathorne Community Primary School,45,16450,9596,6854
815,North Yorkshire,8152064,Kirkbymoorside Community Primary School,180,17800,10383,7417
815,North Yorkshire,8152074,Malton Community Primary School,219,18190,10611,7579
815,North Yorkshire,8152075,Nawton Community Primary School,82,16820,9812,7008
815,North Yorkshire,8152080,Applegarth Primary School,240,18400,10733,7667
815,North Yorkshire,8152081,North and South Cowton Community Primary School,42,16420,9578,6842
815,North Yorkshire,8152083,Osmotherley Primary School,35,16350,9538,6812
815,North Yorkshire,8152096,Reeth Community Primary School,35,16350,9538,6812
815,North Yorkshire,8152097,Romanby Primary School,228,18280,10663,7617
815,North Yorkshire,8152098,Rosedale Abbey Community Primary School,11,11000,6417,4583
815,North Yorkshire,8152108,Barrowcliff School,304,19040,11107,7933
815,North Yorkshire,8152114,Friarage Community Primary School,299,18990,11078,7912
815,North Yorkshire,8152117,Gladstone Road Primary School,681,22810,13306,9504
815,North Yorkshire,8152120,Scarborough Northstead Community Primary School,528,21280,12413,8867
815,North Yorkshire,8152132,Slingsby Community Primary School,67,16670,9724,6946
815,North Yorkshire,8152133,Snape Community Primary School,16,16000,9333,6667
815,North Yorkshire,8152138,Stillington Primary School,22,16220,9462,6758
815,North Yorkshire,8152150,Alanbrooke School,54,16540,9648,6892
815,North Yorkshire,8152151,Welburn Community Primary School,79,16790,9794,6996
815,North Yorkshire,8152163,Mill Hill Community Primary School,127,17270,10074,7196
815,North Yorkshire,8152164,Easingwold Community Primary School,211,18110,10564,7546
815,North Yorkshire,8152165,Dishforth Airfield Community Primary School,95,16950,9888,7062
815,North Yorkshire,8152166,Leeming RAF Community Primary School,172,17720,10337,7383
815,North Yorkshire,8152167,Colburn Community Primary School,166,17660,10302,7358
815,North Yorkshire,8152170,Scarborough Overdale Community Primary School,161,17610,10273,7337
815,North Yorkshire,8152171,Linton-on-Ouse Primary School,90,16900,9858,7042
815,North Yorkshire,8152173,Catterick Garrison Le Cateau Community Primary School,355,19550,11404,8146
815,North Yorkshire,8152186,Sheriff Hutton Primary School,79,16790,9794,6996
815,North Yorkshire,8152188,Wavell Community Junior School,204,18040,10523,7517
815,North Yorkshire,8152189,Catterick Garrison Wavell Community Infant School,137,17370,10133,7237
815,North Yorkshire,8152206,Wheatcroft Community Primary School,178,17780,10372,7408
815,North Yorkshire,8152212,Catterick Garrison Carnagill Community Primary School,173,17730,10343,7387
815,North Yorkshire,8152221,Sinnington Primary School,62,16620,9695,6925
815,North Yorkshire,8152222,Pickering Community Junior School,258,18580,10838,7742
815,North Yorkshire,8152223,Seamer and Irton Community Primary School,350,19500,11375,8125
815,North Yorkshire,8152224,Cayton Community Primary School,167,17670,10308,7362
815,North Yorkshire,8152225,Broomfield School,198,17980,10488,7492
815,North Yorkshire,8152228,Hutton Rudby Primary School,181,17810,10389,7421
815,North Yorkshire,8152233,Lindhead School,195,17950,10471,7479
815,North Yorkshire,8152235,Pickering Community Infant School,128,17280,10080,7200
815,North Yorkshire,8152236,Helmsley Community Primary School,90,16900,9858,7042
815,North Yorkshire,8152237,Thirsk Community Primary School,195,17950,10471,7479
815,North Yorkshire,8152242,Alverton Primary School,173,17730,10343,7387
815,North Yorkshire,8152245,Alne Primary School,144,17440,10173,7267
815,North Yorkshire,8152246,Amotherby Community Primary School,141,17410,10156,7254
815,North Yorkshire,8152247,Appleton Wiske Community Primary School,71,16710,9748,6962
815,North Yorkshire,8152249,Brompton Community Primary School,137,17370,10133,7237
815,North Yorkshire,8152250,Brompton and Sawdon Community Primary School,60,16600,9683,6917
815,North Yorkshire,8152257,East Ayton Community Primary School,175,17750,10354,7396
815,North Yorkshire,8152305,Bentham Community Primary School,94,16940,9882,7058
815,North Yorkshire,8152309,Boroughbridge Primary School,122,17220,10045,7175
815,North Yorkshire,8152310,Bradleys Both Community Primary School,121,17210,10039,7171
815,North Yorkshire,8152312,Burton Salmon Community Primary School,43,16430,9584,6846
815,North Yorkshire,8152314,Carlton-in-Snaith Community Primary School,139,17390,10144,7246
815,North Yorkshire,8152316,Cononley Community Primary School,119,17190,10028,7162
815,North Yorkshire,8152317,Cowling Community Primary School,119,17190,10028,7162
815,North Yorkshire,8152320,Fairburn Community Primary School,56,16560,9660,6900
815,North Yorkshire,8152321,Kettlesing Felliscliffe Community Primary School,46,16460,9602,6858
815,North Yorkshire,8152324,Giggleswick Primary School,64,16640,9707,6933
815,North Yorkshire,8152327,Great Ouseburn Community Primary School,51,16510,9631,6879
815,North Yorkshire,8152329,Harrogate Grove Road Community Primary School,251,18510,10798,7712
815,North Yorkshire,8152332,Starbeck Community Primary School,167,17670,10308,7362
815,North Yorkshire,8152335,Summerbridge Community Primary School,46,16460,9602,6858
815,North Yorkshire,8152336,Hellifield Community Primary School,49,16490,9619,6871
815,North Yorkshire,8152337,Hensall Community Primary School,121,17210,10039,7171
815,North Yorkshire,8152338,Glasshouses Community Primary School,65,16650,9713,6937
815,North Yorkshire,8152343,Kettlewell Primary School,28,16280,9497,6783
815,North Yorkshire,8152347,Darley Community Primary School,38,16380,9555,6825
815,North Yorkshire,8152348,Beckwithshaw Community Primary School,69,16690,9736,6954
815,North Yorkshire,8152350,Scotton Lingerfield Community Primary School,75,16750,9771,6979
815,North Yorkshire,8152354,Sicklinghall Community Primary School,54,16540,9648,6892
815,North Yorkshire,8152356,Skipton Water Street Community Primary School,194,17940,10465,7475
815,North Yorkshire,8152358,Staveley Community Primary School,51,16510,9631,6879
815,North Yorkshire,8152359,Sutton-in-Craven Community Primary School,171,17710,10331,7379
815,North Yorkshire,8152360,Thornton in Craven Community Primary School,65,16650,9713,6937
815,North Yorkshire,8152363,Whitley and Eggborough Community Primary School,200,18000,10500,7500
815,North Yorkshire,8152364,Willow Tree Community Primary School,458,20580,12005,8575
815,North Yorkshire,8152365,Skipton Greatwood Community Primary School,184,17840,10407,7433
815,North Yorkshire,8152366,Moorside Infant School,54,16540,9648,6892
815,North Yorkshire,8152367,Moorside Junior School,106,17060,9952,7108
815,North Yorkshire,8152381,Thorpe Willoughby Community Primary School,231,18310,10681,7629
815,North Yorkshire,8152390,Barwic Parade Community Primary School Selby,212,18120,10570,7550
815,North Yorkshire,8152391,Ingleton Primary School,143,17430,10168,7262
815,North Yorkshire,8152393,Glusburn Community Primary School,277,18770,10949,7821
815,North Yorkshire,8152400,Barlby Bridge Community Primary School,138,17380,10138,7242
815,North Yorkshire,8152401,Barlby Community Primary School,284,18840,10990,7850
815,North Yorkshire,8152402,Hemingbrough Community Primary School,148,17480,10197,7283
815,North Yorkshire,8152403,Hunmanby Primary School,186,17860,10418,7442
815,North Yorkshire,8152404,Langton Primary School,60,16600,9683,6917
815,North Yorkshire,8152405,Leavening Community Primary School,48,16480,9613,6867
815,North Yorkshire,8152406,Luttons Community Primary School,31,16310,9514,6796
815,North Yorkshire,8152407,North Duffield Community Primary School,121,17210,10039,7171
815,North Yorkshire,8152408,Norton Community Primary School,490,20900,12192,8708
815,North Yorkshire,8152410,Riccall Community Primary School,155,17550,10238,7312
815,North Yorkshire,8152411,Rillington Community Primary School,115,17150,10004,7146
815,North Yorkshire,8152413,Filey Junior School,260,18600,10850,7750
815,North Yorkshire,8152418,Selby Longmans Hill Community Primary School,176,17760,10360,7400
815,North Yorkshire,8152421,Sherburn in Elmet Athelstan Community Primary School,250,18500,10792,7708
815,North Yorkshire,8152424,Saltergate Community Junior School,204,18040,10523,7517
815,North Yorkshire,8152425,Saltergate Infant School,112,17120,9987,7133
815,North Yorkshire,8152430,Woodfield Primary School,130,17300,10092,7208
815,North Yorkshire,8153001,Aiskew Leeming Bar Church of England Primary School,31,16310,9514,6796
815,North Yorkshire,8153005,St Hildas Ampleforth Church of England Voluntary Controlled Primary School,21,16210,9456,6754
815,North Yorkshire,8153006,Arkengarthdale Church of England Primary School,14,14000,8167,5833
815,North Yorkshire,8153008,Bainbridge Church of England Primary and Nursery School,17,16170,9433,6737
815,North Yorkshire,8153010,Bedale Church of England Primary School,287,18870,11008,7862
815,North Yorkshire,8153012,Bilsdale Midcable Chop Gate Church of England Voluntary Controlled Primary School,12,12000,7000,5000
815,North Yorkshire,8153015,Brompton-on-Swale Church of England Primary School,178,17780,10372,7408
815,North Yorkshire,8153016,West Burton Church of England Primary School,19,16190,9444,6746
815,North Yorkshire,8153020,Crakehall Church of England Primary School,84,16840,9823,7017
815,North Yorkshire,8153021,Crayke Church of England Voluntary Controlled Primary School,90,16900,9858,7042
815,North Yorkshire,8153025,Danby Church of England Voluntary Controlled School,37,16370,9549,6821
815,North Yorkshire,8153027,Dishforth Church of England Voluntary Controlled Primary School,75,16750,9771,6979
815,North Yorkshire,8153035,Sleights Church of England Voluntary Controlled Primary School,78,16780,9788,6992
815,North Yorkshire,8153039,Foston Church of England Voluntary Controlled Primary School,23,16230,9468,6762
815,North Yorkshire,8153040,Gillamoor Church of England Voluntary Controlled Primary School,29,16290,9503,6787
815,North Yorkshire,8153042,Marwood Church of England Voluntary Controlled Infant School Great Ayton,37,16370,9549,6821
815,North Yorkshire,8153045,Hackforth and Hornby Church of England Primary School,31,16310,9514,6796
815,North Yorkshire,8153046,Hackness Church of England Voluntary Controlled Primary School,61,16610,9689,6921
815,North Yorkshire,8153050,Hawsker Cum Stainsacre Church of England Voluntary Controlled Primary School,51,16510,9631,6879
815,North Yorkshire,8153053,Hipswell Church of England Primary School,148,17480,10197,7283
815,North Yorkshire,8153054,Hovingham Church of England Voluntary Controlled Primary School,29,16290,9503,6787
815,North Yorkshire,8153055,Huby Church of England Voluntary Controlled Primary School,76,16760,9777,6983
815,North Yorkshire,8153057,Husthwaite Church of England Voluntary Controlled Primary School,51,16510,9631,6879
815,North Yorkshire,8153060,Ingleby Greenhow Church of England Voluntary Controlled Primary School,39,16390,9561,6829
815,North Yorkshire,8153062,Kirby Hill Church of England Primary School,85,16850,9829,7021
815,North Yorkshire,8153069,Lythe Church of England Voluntary Controlled Primary School,62,16620,9695,6925
815,North Yorkshire,8153076,Kell Bank Church of England Primary School,23,16230,9468,6762
815,North Yorkshire,8153088,Pickhill Church of England Primary School,31,16310,9514,6796
815,North Yorkshire,8153099,Sand Hutton Church of England Voluntary Controlled Primary School,63,16630,9701,6929
815,North Yorkshire,8153101,Sessay Church of England Voluntary Controlled Primary School,68,16680,9730,6950
815,North Yorkshire,8153108,Snainton Church of England Voluntary Controlled Primary School,34,16340,9532,6808
815,North Yorkshire,8153109,South Kilvington Church of England Voluntary Controlled Primary School,78,16780,9788,6992
815,North Yorkshire,8153110,Spennithorne Church of England Primary School,28,16280,9497,6783
815,North Yorkshire,8153113,Sutton on the Forest Church of England Voluntary Controlled Primary School,65,16650,9713,6937
815,North Yorkshire,8153117,Thornton Dale CofE (VC) Primary School,129,17290,10086,7204
815,North Yorkshire,8153119,Thornton Watlass Church of England Primary School,26,16260,9485,6775
815,North Yorkshire,8153122,Warthill Church of England Voluntary Controlled Primary School,34,16340,9532,6808
815,North Yorkshire,8153124,St Nicholas Church of England Primary School West Tanfield,36,16360,9543,6817
815,North Yorkshire,8153126,Ruswarp Church of England Voluntary Controlled Primary School,83,16830,9818,7012
815,North Yorkshire,8153130,Wykeham Church of England Voluntary Controlled Primary School,41,16410,9573,6837
815,North Yorkshire,8153139,Fylingdales Church of England Voluntary Controlled Primary School,70,16700,9742,6958
815,North Yorkshire,8153150,Cliffe Voluntary Controlled Primary School,96,16960,9893,7067
815,North Yorkshire,8153153,Escrick Church of England Voluntary Controlled Primary School,119,17190,10028,7162
815,North Yorkshire,8153155,Hertford Vale Church of England Voluntary Controlled Primary School Staxton,106,17060,9952,7108
815,North Yorkshire,8153160,Settrington All Saints Church of England Voluntary Controlled Primary School,53,16530,9643,6887
815,North Yorkshire,8153161,Sherburn Church of England Voluntary Controlled Primary School,34,16340,9532,6808
815,North Yorkshire,8153163,Weaverthorpe Church of England Voluntary Controlled Primary School,30,16300,9508,6792
815,North Yorkshire,8153165,West Heslerton Church of England Voluntary Controlled Primary School,58,16580,9672,6908
815,North Yorkshire,8153207,Gunnerside Methodist Primary School,14,14000,8167,5833
815,North Yorkshire,8153208,Melsonby Methodist Primary School,18,16180,9438,6742
815,North Yorkshire,8153210,Richmond Methodist Primary School,268,18680,10897,7783
815,North Yorkshire,8153223,Barlow Church of England Voluntary Controlled Primary School,43,16430,9584,6846
815,North Yorkshire,8153225,St Cuthberts Church of England Primary School Pateley Bridge,79,16790,9794,6996
815,North Yorkshire,8153226,Birstwith Church of England Primary School,80,16800,9800,7000
815,North Yorkshire,8153227,Bishop Monkton Church of England Primary School,96,16960,9893,7067
815,North Yorkshire,8153228,Bishop Thornton Church of England Primary School,20,16200,9450,6750
815,North Yorkshire,8153231,Brayton Church of England Voluntary Controlled Primary School,308,19080,11130,7950
815,North Yorkshire,8153232,Burton Leonard Church of England Primary School,70,16700,9742,6958
815,North Yorkshire,8153233,Chapel Haddlesey Church of England Voluntary Controlled Primary School,55,16550,9654,6896
815,North Yorkshire,8153234,Clapham Church of England Voluntary Controlled Primary School,22,16220,9462,6758
815,North Yorkshire,8153235,Cracoe and Rylstone Voluntary Controlled Church of England Primary School,40,16400,9567,6833
815,North Yorkshire,8153236,Embsay Church of England Voluntary Controlled Primary School,178,17780,10372,7408
815,North Yorkshire,8153237,Follifoot Church of England Primary School,53,16530,9643,6887
815,North Yorkshire,8153238,Fountains Earth Lofthouse Church of England Endowed Primary School,20,16200,9450,6750
815,North Yorkshire,8153240,Goldsborough Church of England Primary School,81,16810,9806,7004
815,North Yorkshire,8153241,Grassington Church of England Voluntary Controlled Primary School,64,16640,9707,6933
815,North Yorkshire,8153242,Green Hammerton Church of England Primary School,76,16760,9777,6983
815,North Yorkshire,8153243,Grewelthorpe Church of England Primary School,56,16560,9660,6900
815,North Yorkshire,8153244,Hambleton Church of England Voluntary Controlled Primary School,145,17450,10179,7271
815,North Yorkshire,8153248,Killinghall Church of England Primary School,105,17050,9946,7104
815,North Yorkshire,8153249,Kirkby Malzeard Church of England Primary School,75,16750,9771,6979
815,North Yorkshire,8153252,Kirk Hammerton Church of England Primary School,50,16500,9625,6875
815,North Yorkshire,8153253,Kirk Smeaton Church of England Voluntary Controlled Primary School,81,16810,9806,7004
815,North Yorkshire,8153255,Long Marston Church of England Voluntary Controlled Primary School,35,16350,9538,6812
815,North Yorkshire,8153256,Markington Church of England Primary & Nursery School,37,16370,9549,6821
815,North Yorkshire,8153258,North Stainley Church of England Primary School,52,16520,9637,6883
815,North Yorkshire,8153261,Ripley Endowed Church of England School,69,16690,9736,6954
815,North Yorkshire,8153262,Ripon Cathedral Church of England Primary School,179,17790,10378,7412
815,North Yorkshire,8153263,Holy Trinity CofE Junior School,266,18660,10885,7775
815,North Yorkshire,8153264,Roecliffe Church of England Primary School,87,16870,9841,7029
815,North Yorkshire,8153266,Fountains Church of England Primary School,80,16800,9800,7000
815,North Yorkshire,8153268,Selby Abbey Church of England Voluntary Controlled Primary School,275,18750,10938,7812
815,North Yorkshire,8153270,Settle Church of England Voluntary Controlled Primary School,152,17520,10220,7300
815,North Yorkshire,8153271,Sharow Church of England Primary School,74,16740,9765,6975
815,North Yorkshire,8153272,Skelton Newby Hall Church of England Primary School,37,16370,9549,6821
815,North Yorkshire,8153273,Christ Church Church of England Voluntary Controlled Primary School,137,17370,10133,7237
815,North Yorkshire,8153274,Skipton Parish Church Church of England Voluntary Controlled Primary School,223,18230,10634,7596
815,North Yorkshire,8153275,Spofforth Church of England Controlled Primary School,91,16910,9864,7046
815,North Yorkshire,8153276,Sutton in Craven Church of England Voluntary Controlled Primary School,96,16960,9893,7067
815,North Yorkshire,8153277,Threshfield School,41,16410,9573,6837
815,North Yorkshire,8153282,Wistow Parochial Church of England Voluntary Controlled Primary School,115,17150,10004,7146
815,North Yorkshire,8153284,Holy Trinity CofE Infant School,118,17180,10022,7158
815,North Yorkshire,8153285,Gargrave Church of England Voluntary Controlled Primary School,115,17150,10004,7146
815,North Yorkshire,8153287,Kildwick Church of England Voluntary Controlled Primary School,108,17080,9963,7117
815,North Yorkshire,8153289,Askrigg Voluntary Controlled Primary School,32,16320,9520,6800
815,North Yorkshire,8153301,Bolton-on-Swale St Marys CofE Primary School,88,16880,9847,7033
815,North Yorkshire,8153304,St Peters Brafferton Church of England Voluntary Aided Primary School,44,16440,9590,6850
815,North Yorkshire,8153306,Carlton and Faceby Church of England Voluntary Aided Primary School,32,16320,9520,6800
815,North Yorkshire,8153307,Michael Syddall Church of England Aided Primary School,151,17510,10214,7296
815,North Yorkshire,8153308,Egton Church of England Voluntary Aided Primary School,47,16470,9608,6862
815,North Yorkshire,8153315,Kirkby and Great Broughton Church of England Voluntary Aided Primary School,108,17080,9963,7117
815,North Yorkshire,8153319,Masham Church of England VA Primary School,94,16940,9882,7058
815,North Yorkshire,8153320,Middleham Church of England Aided School,31,16310,9514,6796
815,North Yorkshire,8153326,St Martins Church of England Voluntary Aided Primary School Scarborough,236,18360,10710,7650
815,North Yorkshire,8153331,Terrington Church of England Voluntary Aided Primary School,37,16370,9549,6821
815,North Yorkshire,8153337,Burneston Church of England Voluntary Aided Primary School,43,16430,9584,6846
815,North Yorkshire,8153350,Austwick Church of England VA Primary School,45,16450,9596,6854
815,North Yorkshire,8153351,The Boyle and Petyt Primary School,57,16570,9666,6904
815,North Yorkshire,8153352,Burnsall Voluntary Aided Primary School,16,16000,9333,6667
815,North Yorkshire,8153354,Carleton Endowed CofE Primary School,137,17370,10133,7237
815,North Yorkshire,8153355,Cawood Church of England Voluntary Aided Primary School,122,17220,10045,7175
815,North Yorkshire,8153357,Dacre Braithwaite Church of England Primary School,60,16600,9683,6917
815,North Yorkshire,8153360,Kirkby in Malhamdale United Voluntary Aided Primary School,45,16450,9596,6854
815,North Yorkshire,8153362,Long Preston Endowed Voluntary Aided Primary School,57,16570,9666,6904
815,North Yorkshire,8153363,Marton-Cum-Grafton Church of England Voluntary Aided Primary School,77,16770,9783,6987
815,North Yorkshire,8153369,Barkston Ash Catholic Primary School,116,17160,10010,7150
815,North Yorkshire,8153372,St Wilfrids Catholic Primary School,116,17160,10010,7150
815,North Yorkshire,8153373,St Marys Catholic Primary School,157,17570,10249,7321
815,North Yorkshire,8153376,St Josephs Catholic Primary School,53,16530,9643,6887
815,North Yorkshire,8153377,St Roberts Catholic Primary School Harrogate,229,18290,10669,7621
815,North Yorkshire,8153600,St Benedicts Roman Catholic Primary School Ampleforth,66,16660,9718,6942
815,North Yorkshire,8153602,St Heddas Roman Catholic Primary School,23,16230,9468,6762
815,North Yorkshire,8153609,St Marys Roman Catholic Primary School Malton,127,17270,10074,7196
815,North Yorkshire,8153610,St Josephs Roman Catholic Primary School Pickering,80,16800,9800,7000
815,North Yorkshire,8153614,St Marys Roman Catholic Primary School Richmond,153,17530,10226,7304
815,North Yorkshire,8153615,St Peters Roman Catholic Primary School,181,17810,10389,7421
815,North Yorkshire,8153616,All Saints Roman Catholic Primary School,61,16610,9689,6921
815,North Yorkshire,8153620,St Hildas Roman Catholic Primary School,33,16330,9526,6804
815,North Yorkshire,8153631,St Georges Roman Catholic Primary School,75,16750,9771,6979
815,North Yorkshire,8153902,Sacred Heart RC Primary School,68,16680,9730,6950
815,North Yorkshire,8153903,Knaresborough St Johns CofE Primary School,280,18800,10967,7833
815,North Yorkshire,8155200,Nun Monkton Primary Foundation School,13,13000,7583,5417
815,North Yorkshire,8157000,Brompton Hall School,19,16190,9444,6746
815,North Yorkshire,8157004,Welburn Hall School,8,8000,4667,3333
815,North Yorkshire,8157015,The Dales School,19,16190,9444,6746
815,North Yorkshire,8157017,Springhead School,27,16270,9491,6779
815,North Yorkshire,8157022,The Forest School,42,16420,9578,6842
815,North Yorkshire,8157024,Springwater School,16,16000,9333,6667
815,North Yorkshire,8157027,Brooklands School,17,16170,9433,6737
815,North Yorkshire,8157029,Mowbray School,82,16820,9812,7008
815,North Yorkshire,8157030,Forest Moor School,13,13000,7583,5417
816,York,8161100,Danesgate Community,37,16370,9549,6821
816,York,8162002,Carr Junior School,284,18840,10990,7850
816,York,8162003,Carr Infant School,170,17700,10325,7375
816,York,8162007,Dringhouses Primary School,258,18580,10838,7742
816,York,8162008,Fishergate Primary School,261,18610,10856,7754
816,York,8162013,Copmanthorpe Primary School,334,19340,11282,8058
816,York,8162014,Poppleton Road Primary School,329,19290,11253,8037
816,York,8162015,Yearsley Grove Primary School,325,19250,11229,8021
816,York,8162017,Westfield Primary Community School,437,20370,11883,8487
816,York,8162018,Clifton Green Primary School,329,19290,11253,8037
816,York,8162058,Ralph Butterfield Primary School,285,18850,10996,7854
816,York,8162169,Skelton Primary School,59,16590,9678,6912
816,York,8162227,Stockton-on-the-Forest Primary School,73,16730,9759,6971
816,York,8162240,Wigginton Primary School,234,18340,10698,7642
816,York,8162241,Headlands Primary School,262,18620,10862,7758
816,York,8162386,Bishopthorpe Infant School,108,17080,9963,7117
816,York,8163002,Saint Barnabas Church of England Voluntary Controlled Primary School,136,17360,10127,7233
816,York,8163003,St Pauls Church of England Voluntary Controlled Primary School,146,17460,10185,7275
816,York,8163152,Elvington Church of England Voluntary Controlled Primary School,116,17160,10010,7150
816,York,8163156,St Oswalds Church of England Voluntary Controlled Primary School,256,18560,10827,7733
816,York,8163158,Lord Deramores Primary School,176,17760,10360,7400
816,York,8163159,Naburn Church of England Primary School,66,16660,9718,6942
816,York,8163222,St Marys Church of England Voluntary Controlled Primary School,102,17020,9928,7092
816,York,8163401,St Aelreds Roman Catholic Voluntary Aided Primary School,172,17720,10337,7383
816,York,8163402,St Georges Roman Catholic Primary School York,156,17560,10243,7317
816,York,8163403,St Wilfrids York Roman Catholic Primary School,231,18310,10681,7629
816,York,8163904,Our Lady Queen of Martyrs Roman Catholic Voluntary Aided Primary School,328,19280,11247,8033
821,Luton,8212001,Waulud Primary School,340,19400,11317,8083
821,Luton,8212002,Leagrave Primary School,402,20020,11678,8342
821,Luton,8212004,Bushmead Primary School,686,22860,13335,9525
821,Luton,8212006,Ramridge Primary School,341,19410,11323,8087
821,Luton,8212225,Denbigh Primary School,566,21660,12635,9025
821,Luton,8212229,Farley Junior School,353,19530,11393,8137
821,Luton,8212231,Ferrars Junior School,353,19530,11393,8137
821,Luton,8212237,Maidenhall Primary School,606,22060,12868,9192
821,Luton,8212239,Norton Road Primary School,338,19380,11305,8075
821,Luton,8212243,St Matthews Primary School,712,23120,13487,9633
821,Luton,8212244,Stopsley Community Primary School,455,20550,11988,8562
821,Luton,8212246,Sundon Park Junior School,282,18820,10978,7842
821,Luton,8212247,Cheynes Infant School,154,17540,10232,7308
821,Luton,8212249,Tennyson Road Primary School,418,20180,11772,8408
821,Luton,8212250,The Meads Primary School,471,20710,12081,8629
821,Luton,8212252,William Austin Junior School,595,21950,12804,9146
821,Luton,8212254,Warden Hill Junior School,462,20620,12028,8592
821,Luton,8212256,Putteridge Primary School,494,20940,12215,8725
821,Luton,8212259,Downside Primary School,882,24820,14478,10342
821,Luton,8212262,Warden Hill Infant School,235,18350,10704,7646
821,Luton,8212263,Surrey Street Primary School,449,20490,11953,8537
821,Luton,8212264,Foxdell Infant School,170,17700,10325,7375
821,Luton,8212266,Pirton Hill Primary School,420,20200,11783,8417
821,Luton,8212267,Someries Junior School,239,18390,10728,7662
821,Luton,8212270,Foxdell Junior School,349,19490,11369,8121
821,Luton,8212271,Hillborough Junior School,356,19560,11410,8150
821,Luton,8212272,Icknield Primary School,523,21230,12384,8846
821,Luton,8212274,Hillborough Infant School,180,17800,10383,7417
821,Luton,8212276,Someries Infant School,120,17200,10033,7167
821,Luton,8212278,William Austin Infant School,272,18720,10920,7800
821,Luton,8212283,Wigmore Primary School,419,20190,11778,8412
821,Luton,8212293,Bramingham Primary School,354,19540,11398,8142
821,Luton,8212295,Beech Hill Community Primary School,718,23180,13522,9658
821,Luton,8213354,Wenlock CofE Junior School,306,19060,11118,7942
821,Luton,8213356,St Josephs Catholic Primary School,708,23080,13463,9617
821,Luton,8213361,Sacred Heart Primary School,348,19480,11363,8117
821,Luton,8213363,Beechwood Primary School,708,23080,13463,9617
821,Luton,8215201,Crawley Green Infant School,175,17750,10354,7396
821,Luton,8217014,Richmond Hill School,178,17780,10372,7408
821,Luton,8217016,Lady Zia Wernher School,96,16960,9893,7067
822,Bedford,8222006,Livingstone Primary School,305,19050,11113,7937
822,Bedford,8222007,Edith Cavell Primary School,196,17960,10477,7483
822,Bedford,8222009,Castle Newnham School,417,20170,11766,8404
822,Bedford,8222013,Priory Primary School,136,17360,10127,7233
822,Bedford,8222035,Sheerhatch Primary School,121,17210,10039,7171
822,Bedford,8222036,Eileen Wade Primary School,44,16440,9590,6850
822,Bedford,8222041,Cotton End Primary School,77,16770,9783,6987
822,Bedford,8222048,Pinchmill Primary School,57,16570,9666,6904
822,Bedford,8222061,Bedford Road Primary School,274,18740,10932,7808
822,Bedford,8222062,Camestone School,291,18910,11031,7879
822,Bedford,8222063,Kempston Rural Lower School,217,18170,10599,7571
822,Bedford,8222064,Balliol Primary School,288,18880,11013,7867
822,Bedford,8222128,Broadmead Lower School,106,17060,9952,7108
822,Bedford,8222135,Thurleigh Primary School,61,16610,9689,6921
822,Bedford,8222141,Wilstead Primary School,141,17410,10156,7254
822,Bedford,8222144,Wootton Lower School,343,19430,11334,8096
822,Bedford,8222156,Kings Oak Primary School,675,22750,13271,9479
822,Bedford,8222163,Brickhill Primary School,265,18650,10879,7771
822,Bedford,8222173,Hazeldene School,275,18750,10938,7812
822,Bedford,8222183,Scott Primary School,348,19480,11363,8117
822,Bedford,8222287,Kymbrook Primary School,57,16570,9666,6904
822,Bedford,8223011,Renhold VC Primary School,136,17360,10127,7233
822,Bedford,8223018,Carlton CofE Primary School,64,16640,9707,6933
822,Bedford,8223020,Bromham CofE Primary School,306,19060,11118,7942
822,Bedford,8223023,Milton Ernest CofE Primary School,53,16530,9643,6887
822,Bedford,8223024,Great Denham Primary School,364,19640,11457,8183
822,Bedford,8223300,St James Church of England VA Primary School,103,17030,9934,7096
822,Bedford,8223326,Christopher Reeves CofE VA Primary School,60,16600,9683,6917
822,Bedford,8223327,Ravensden CofE VA Primary School,52,16520,9637,6883
822,Bedford,8223328,Riseley CofE Primary School,193,17930,10459,7471
822,Bedford,8223332,Wilden CofE VA Primary School,51,16510,9631,6879
822,Bedford,8223334,St Lawrence Church of England Primary School,117,17170,10016,7154
822,Bedford,8223352,Lakeview School,336,19360,11293,8067
822,Bedford,8224050,Castle Newnham School,154,17540,10232,7308
822,Bedford,8224072,Westfield School,145,17450,10179,7271
822,Bedford,8225205,Turvey Primary School,55,16550,9654,6896
822,Bedford,8227012,Ridgeway School,29,16290,9503,6787
823,Central Bedfordshire,8232001,Maple Tree Lower School,134,17340,10115,7225
823,Central Bedfordshire,8232002,Aspley Guise Lower School,107,17070,9958,7112
823,Central Bedfordshire,8232003,Swallowfield Lower School,234,18340,10698,7642
823,Central Bedfordshire,8232032,Slip End Village School,138,17380,10138,7242
823,Central Bedfordshire,8232033,Campton Lower School,100,17000,9917,7083
823,Central Bedfordshire,8232038,Dunstable Icknield Lower School,234,18340,10698,7642
823,Central Bedfordshire,8232049,Flitwick Lower School,205,18050,10529,7521
823,Central Bedfordshire,8232055,Haynes Lower School,100,17000,9917,7083
823,Central Bedfordshire,8232056,Derwent Lower School,100,17000,9917,7083
823,Central Bedfordshire,8232057,Houghton Conquest Lower School,74,16740,9765,6975
823,Central Bedfordshire,8232058,Houghton Regis Primary School,231,18310,10681,7629
823,Central Bedfordshire,8232059,Husborne Crawley Lower School,44,16440,9590,6850
823,Central Bedfordshire,8232067,Beaudesert Lower School,182,17820,10395,7425
823,Central Bedfordshire,8232070,Thomas Johnson Lower School,51,16510,9631,6879
823,Central Bedfordshire,8232072,Stondon Lower School,112,17120,9987,7133
823,Central Bedfordshire,8232110,Church End Lower School,302,19020,11095,7925
823,Central Bedfordshire,8232111,Shelton Lower School,40,16400,9567,6833
823,Central Bedfordshire,8232112,Maulden Lower School,117,17170,10016,7154
823,Central Bedfordshire,8232117,Potton Lower School,202,18020,10512,7508
823,Central Bedfordshire,8232118,Ridgmont Lower School,35,16350,9538,6812
823,Central Bedfordshire,8232119,Laburnum Lower School,119,17190,10028,7162
823,Central Bedfordshire,8232121,Shefford Lower School,345,19450,11346,8104
823,Central Bedfordshire,8232122,Shillington Lower School,98,16980,9905,7075
823,Central Bedfordshire,8232124,Southill Lower School,51,16510,9631,6879
823,Central Bedfordshire,8232125,Stanbridge Lower School,79,16790,9794,6996
823,Central Bedfordshire,8232129,Roecroft Lower School,326,19260,11235,8025
823,Central Bedfordshire,8232136,Chalton Lower School,44,16440,9590,6850
823,Central Bedfordshire,8232143,Woburn Lower School,46,16460,9602,6858
823,Central Bedfordshire,8232146,Russell Lower School,296,18960,11060,7900
823,Central Bedfordshire,8232152,Watling Lower School,138,17380,10138,7242
823,Central Bedfordshire,8232166,Thornhill Primary School,158,17580,10255,7325
823,Central Bedfordshire,8232174,Kingsmoor Lower School,126,17260,10068,7192
823,Central Bedfordshire,8232176,The Mary Bassett Lower School,232,18320,10687,7633
823,Central Bedfordshire,8232177,Leedon Lower School,261,18610,10856,7754
823,Central Bedfordshire,8232184,Heathwood Lower School,116,17160,10010,7150
823,Central Bedfordshire,8232188,Linslade Lower School,157,17570,10249,7321
823,Central Bedfordshire,8232189,Dovery Down Lower School,119,17190,10028,7162
823,Central Bedfordshire,8232201,Clipstone Brook Lower School,182,17820,10395,7425
823,Central Bedfordshire,8232202,Robert Peel Primary School,222,18220,10628,7592
823,Central Bedfordshire,8232203,Southcott Lower School,214,18140,10582,7558
823,Central Bedfordshire,8232209,Hawthorn Park Community Primary,317,19170,11183,7987
823,Central Bedfordshire,8232213,Templefield Lower School,215,18150,10588,7562
823,Central Bedfordshire,8232218,Hockliffe Lower School,44,16440,9590,6850
823,Central Bedfordshire,8232279,Tithe Farm Primary School,213,18130,10576,7554
823,Central Bedfordshire,8232282,Ramsey Manor Lower School,237,18370,10716,7654
823,Central Bedfordshire,8232289,Greenleas School,456,20560,11993,8567
823,Central Bedfordshire,8233001,St Andrews CofE VC Lower School,515,21150,12338,8812
823,Central Bedfordshire,8233006,Dunton CofE VC Lower School,57,16570,9666,6904
823,Central Bedfordshire,8233012,St Swithuns Church of England VC Primary School,142,17420,10162,7258
823,Central Bedfordshire,8233013,Silsoe CofE VC Lower School,156,17560,10243,7317
823,Central Bedfordshire,8233015,Studham CofE Village School,50,16500,9625,6875
823,Central Bedfordshire,8233017,Wrestlingworth CofE VC Lower School,52,16520,9637,6883
823,Central Bedfordshire,8233302,John Donne Church of England Primary School,46,16460,9602,6858
823,Central Bedfordshire,8233307,St Marys VA CofE Lower School,88,16880,9847,7033
823,Central Bedfordshire,8233310,St Leonards Heath and Reach VA Lower School,84,16840,9823,7017
823,Central Bedfordshire,8233313,Pulford CofE VA Lower School,174,17740,10348,7392
823,Central Bedfordshire,8233323,Northill CofE VA Lower School,54,16540,9648,6892
823,Central Bedfordshire,8233331,Sutton CofE VA Lower School,54,16540,9648,6892
823,Central Bedfordshire,8233351,Fairfield Park Lower School,255,18550,10821,7729
823,Central Bedfordshire,8233353,Caddington Village School,305,19050,11113,7937
823,Central Bedfordshire,8234054,Parkfields Middle School,229,18290,10669,7621
823,Central Bedfordshire,8234092,Potton Middle School,151,17510,10214,7296
823,Central Bedfordshire,8234120,Leighton Middle School,295,18950,11054,7896
823,Central Bedfordshire,8234502,Edward Peake CofE VC Middle School,247,18470,10774,7696
823,Central Bedfordshire,8235201,Westoning Lower School,88,16880,9847,7033
823,Central Bedfordshire,8235202,Ashton St Peters VA C of E School,175,17750,10354,7396
823,Central Bedfordshire,8235204,Moggerhanger Lower School,49,16490,9619,6871
823,Central Bedfordshire,8237009,Ivel Valley School,77,16770,9783,6987
823,Central Bedfordshire,8237017,The Chiltern School,101,17010,9923,7087
825,Buckinghamshire,8251112,The Buckinghamshire Primary Pupil Referral Unit,12,12000,7000,5000
825,Buckinghamshire,8252000,The Disraeli School and Childrens Centre,460,20600,12017,8583
825,Buckinghamshire,8252001,Oak Green School,414,20140,11748,8392
825,Buckinghamshire,8252002,Buckingham Park Church of England Primary School,326,19260,11235,8025
825,Buckinghamshire,8252005,Cedar Park School,180,17800,10383,7417
825,Buckinghamshire,8252006,Millbrook Combined School,413,20130,11743,8387
825,Buckinghamshire,8252007,The Mary Towerton School At Studley Green,31,16310,9514,6796
825,Buckinghamshire,8252008,Bledlow Ridge School,125,17250,10063,7187
825,Buckinghamshire,8252009,The Downley School,360,19600,11433,8167
825,Buckinghamshire,8252016,Chalfont St Giles Infant School and Nursery,116,17160,10010,7150
825,Buckinghamshire,8252019,Cheddington Combined School,178,17780,10372,7408
825,Buckinghamshire,8252020,Chenies School,82,16820,9812,7008
825,Buckinghamshire,8252021,Newtown School,120,17200,10033,7167
825,Buckinghamshire,8252022,Dagnall VA Church of England School,14,14000,8167,5833
825,Buckinghamshire,8252025,East Claydon Church of England School,24,16240,9473,6767
825,Buckinghamshire,8252027,Denham Village Infant School,16,16000,9333,6667
825,Buckinghamshire,8252030,Drayton Parslow Village School,30,16300,9508,6792
825,Buckinghamshire,8252031,Dropmore Infant School,36,16360,9543,6817
825,Buckinghamshire,8252033,Edlesborough School,177,17770,10366,7404
825,Buckinghamshire,8252037,Fulmer Infant School,44,16440,9590,6850
825,Buckinghamshire,8252038,Roundwood Primary School,146,17460,10185,7275
825,Buckinghamshire,8252040,Haddenham Community Infant School,60,16600,9683,6917
825,Buckinghamshire,8252049,Marsh School,119,17190,10028,7162
825,Buckinghamshire,8252055,West Wycombe Combined School,150,17500,10208,7292
825,Buckinghamshire,8252059,Hyde Heath Infant School,44,16440,9590,6850
825,Buckinghamshire,8252061,The Iver Village Junior School,210,18100,10558,7542
825,Buckinghamshire,8252065,Jordans School,44,16440,9590,6850
825,Buckinghamshire,8252068,Ley Hill School,181,17810,10389,7421
825,Buckinghamshire,8252071,Little Kingshill Combined School,182,17820,10395,7425
825,Buckinghamshire,8252084,Prestwood Infant School,120,17200,10033,7167
825,Buckinghamshire,8252107,Steeple Claydon School,143,17430,10168,7262
825,Buckinghamshire,8252108,Stoke Mandeville Combined School,177,17770,10366,7404
825,Buckinghamshire,8252113,Thornborough Infant School,20,16200,9450,6750
825,Buckinghamshire,8252115,Tylers Green First School,120,17200,10033,7167
825,Buckinghamshire,8252126,Booker Hill School,179,17790,10378,7412
825,Buckinghamshire,8252132,Ash Hill Primary School,179,17790,10378,7412
825,Buckinghamshire,8252142,Farnham Common Junior School,235,18350,10704,7646
825,Buckinghamshire,8252143,Woodside Junior School,241,18410,10739,7671
825,Buckinghamshire,8252150,Holmer Green First School and Pre-School,118,17180,10022,7158
825,Buckinghamshire,8252151,Chalfont St Peter Infant School,118,17180,10022,7158
825,Buckinghamshire,8252152,Broughton Junior School,240,18400,10733,7667
825,Buckinghamshire,8252153,Little Chalfont Primary School,199,17990,10494,7496
825,Buckinghamshire,8252157,Carrington Junior School,230,18300,10675,7625
825,Buckinghamshire,8252162,Haydon Abbey School and Pre-School,390,19900,11608,8292
825,Buckinghamshire,8252167,Grendon Underwood Combined School,162,17620,10278,7342
825,Buckinghamshire,8252168,Iver Heath Junior School,234,18340,10698,7642
825,Buckinghamshire,8252175,Bedgrove Infant School,236,18360,10710,7650
825,Buckinghamshire,8252176,Carrington Infant School,124,17240,10057,7183
825,Buckinghamshire,8252179,Broughton Infant School,117,17170,10016,7154
825,Buckinghamshire,8252181,Elmhurst School,336,19360,11293,8067
825,Buckinghamshire,8252182,Chalfont St Giles Junior School,232,18320,10687,7633
825,Buckinghamshire,8252184,Oakridge School,315,19150,11171,7979
825,Buckinghamshire,8252186,Butlers Court School,359,19590,11428,8162
825,Buckinghamshire,8252189,The John Hampden School,165,17650,10296,7354
825,Buckinghamshire,8252191,Chestnut Lane School,120,17200,10033,7167
825,Buckinghamshire,8252196,Manor Farm Community Infant School,146,17460,10185,7275
825,Buckinghamshire,8252197,Chartridge Combined School,180,17800,10383,7417
825,Buckinghamshire,8252199,Juniper Hill School,361,19610,11439,8171
825,Buckinghamshire,8252200,Holmer Green Junior School,241,18410,10739,7671
825,Buckinghamshire,8252203,Tylers Green Middle School,254,18540,10815,7725
825,Buckinghamshire,8252204,Prestwood Junior School,232,18320,10687,7633
825,Buckinghamshire,8252213,Elmtree Infant and Nursery School,120,17200,10033,7167
825,Buckinghamshire,8252219,Thomas Hickman School,351,19510,11381,8129
825,Buckinghamshire,8252220,Burford School,368,19680,11480,8200
825,Buckinghamshire,8252225,Bearbrook Combined School,418,20180,11772,8408
825,Buckinghamshire,8252228,Lane End Primary School,130,17300,10092,7208
825,Buckinghamshire,8252233,Hannah Ball School,150,17500,10208,7292
825,Buckinghamshire,8252235,Claytons Primary School,267,18670,10891,7779
825,Buckinghamshire,8252242,Hughenden Primary School,152,17520,10220,7300
825,Buckinghamshire,8252245,Buckingham Primary School,410,20100,11725,8375
825,Buckinghamshire,8252250,Aston Clinton School,335,19350,11288,8062
825,Buckinghamshire,8252251,Whitchurch Combined School,181,17810,10389,7421
825,Buckinghamshire,8252254,Widmer End Combined School,185,17850,10413,7437
825,Buckinghamshire,8252255,Spinfield School,184,17840,10407,7433
825,Buckinghamshire,8252261,Long Crendon School,180,17800,10383,7417
825,Buckinghamshire,8252263,Manor Farm Community Junior School,236,18360,10710,7650
825,Buckinghamshire,8252269,Stokenchurch Primary School,423,20230,11801,8429
825,Buckinghamshire,8252270,Iver Heath Infant School and Nursery,117,17170,10016,7154
825,Buckinghamshire,8252271,Farnham Common Infant School,118,17180,10022,7158
825,Buckinghamshire,8252276,Haddenham Junior School,286,18860,11002,7858
825,Buckinghamshire,8252280,Turnfurlong Junior School,361,19610,11439,8171
825,Buckinghamshire,8252282,Elangeni School,241,18410,10739,7671
825,Buckinghamshire,8252286,Ashmead Combined School,521,21210,12373,8837
825,Buckinghamshire,8252288,William Harding School,578,21780,12705,9075
825,Buckinghamshire,8252289,Turnfurlong Infant School,176,17760,10360,7400
825,Buckinghamshire,8252292,Robertswood School,337,19370,11299,8071
825,Buckinghamshire,8252315,Iver Village Infant School,116,17160,10010,7150
825,Buckinghamshire,8252317,Waddesdon Village Primary School,188,17880,10430,7450
825,Buckinghamshire,8252333,Halton Community Combined School,174,17740,10348,7392
825,Buckinghamshire,8252335,Naphill and Walters Ash School,335,19350,11288,8062
825,Buckinghamshire,8252345,Holtspur School & Pre-School,204,18040,10523,7517
825,Buckinghamshire,8252352,Highworth Combined School and Nursery,356,19560,11410,8150
825,Buckinghamshire,8252354,The Stoke Poges School,368,19680,11480,8200
825,Buckinghamshire,8252507,Foxes Piece School,197,17970,10483,7487
825,Buckinghamshire,8253008,St James and St John CofE Primary School,135,17350,10121,7229
825,Buckinghamshire,8253012,Marsh Gibbon CofE Primary School,150,17500,10208,7292
825,Buckinghamshire,8253014,North Marston Church of England School,88,16880,9847,7033
825,Buckinghamshire,8253017,St Michaels Church of England Combined School,188,17880,10430,7450
825,Buckinghamshire,8253018,Whaddon CofE First School,25,16250,9479,6771
825,Buckinghamshire,8253020,St Marys Church of England School,390,19900,11608,8292
825,Buckinghamshire,8253022,Bierton Church of England Combined School,248,18480,10780,7700
825,Buckinghamshire,8253025,High Ash Church of England Primary School,245,18450,10763,7687
825,Buckinghamshire,8253028,Stone Church of England Combined School,170,17700,10325,7375
825,Buckinghamshire,8253029,Wendover Church of England Junior School,377,19770,11533,8237
825,Buckinghamshire,8253030,Weston Turville Church of England School,178,17780,10372,7408
825,Buckinghamshire,8253031,Wingrave Church of England Combined School,149,17490,10203,7287
825,Buckinghamshire,8253033,St Georges Church of England Infant School,120,17200,10033,7167
825,Buckinghamshire,8253035,Coleshill Church of England Infant School,38,16380,9555,6825
825,Buckinghamshire,8253037,Lee Common Church of England School,36,16360,9543,6817
825,Buckinghamshire,8253038,Curzon Church of England Combined School,132,17320,10103,7217
825,Buckinghamshire,8253044,Marlow Church of England Infant School,120,17200,10033,7167
825,Buckinghamshire,8253046,Monks Risborough CofE Primary School,176,17760,10360,7400
825,Buckinghamshire,8253053,St Marys Farnham Royal CofE Primary School,264,18640,10873,7767
825,Buckinghamshire,8253056,Twyford C of E School,79,16790,9794,6996
825,Buckinghamshire,8253057,Maids Moreton Church of England School,30,16300,9508,6792
825,Buckinghamshire,8253061,Newton Longville Church of England Primary School,178,17780,10372,7408
825,Buckinghamshire,8253065,Westcott Church of England School,68,16680,9730,6950
825,Buckinghamshire,8253068,Mursley Church of England School,31,16310,9514,6796
825,Buckinghamshire,8253072,Hawridge and Cholesbury Church of England School,158,17580,10255,7325
825,Buckinghamshire,8253073,Haddenham St Marys Church of England School,102,17020,9928,7092
825,Buckinghamshire,8253074,Quainton Church of England School,159,17590,10261,7329
825,Buckinghamshire,8253100,Oakley Church of England Combined School,84,16840,9823,7017
825,Buckinghamshire,8253101,Winslow Church of England Combined School,311,19110,11148,7962
825,Buckinghamshire,8253102,St Peters Church of England Primary School,180,17800,10383,7417
825,Buckinghamshire,8253305,Swanbourne Church of England VA School,119,17190,10028,7162
825,Buckinghamshire,8253309,Cuddington and Dinton CofE School,152,17520,10220,7300
825,Buckinghamshire,8253315,Marsworth Church of England Infant School,10,10000,5833,4167
825,Buckinghamshire,8253320,St Marys CofE Primary School Amersham,289,18890,11019,7871
825,Buckinghamshire,8253325,Little Missenden Church of England School,23,16230,9468,6762
825,Buckinghamshire,8253328,St Mary and All Saints CofE Primary School,359,19590,11428,8162
825,Buckinghamshire,8253329,Cadmore End CofE School,50,16500,9625,6875
825,Buckinghamshire,8253330,Frieth Church of England Combined School,113,17130,9993,7137
825,Buckinghamshire,8253333,Hazlemere Church of England Combined School,191,17910,10448,7462
825,Buckinghamshire,8253334,High Wycombe Church of England Combined School,176,17760,10360,7400
825,Buckinghamshire,8253335,Ibstone CofE Primary School,32,16320,9520,6800
825,Buckinghamshire,8253337,Little Marlow CofE School,59,16590,9678,6912
825,Buckinghamshire,8253339,Radnage Church of England Primary School,77,16770,9783,6987
825,Buckinghamshire,8253340,Speen CofE VA School,23,16230,9468,6762
825,Buckinghamshire,8253342,St Pauls Church of England Combined School Wooburn,187,17870,10424,7446
825,Buckinghamshire,8253347,Holy Trinity Church of England (Aided) School,340,19400,11317,8083
825,Buckinghamshire,8253361,St Peters Catholic Primary School,170,17700,10325,7375
825,Buckinghamshire,8253367,St Edwards Catholic Junior School,256,18560,10827,7733
825,Buckinghamshire,8253371,St Josephs Catholic Primary School,341,19410,11323,8087
825,Buckinghamshire,8253372,St Josephs Catholic Infant School,119,17190,10028,7162
825,Buckinghamshire,8253375,Our Ladys Catholic Primary School,188,17880,10430,7450
825,Buckinghamshire,8253376,St Louis Catholic Primary School,242,18420,10745,7675
825,Buckinghamshire,8253377,Kings Wood School and Nursery,358,19580,11422,8158
825,Buckinghamshire,8254701,St Michaels Catholic School,354,19540,11398,8142
825,Buckinghamshire,8255200,Brookmead School,289,18890,11019,7871
825,Buckinghamshire,8255201,Overstone Combined School,224,18240,10640,7600
825,Buckinghamshire,8255204,Castlefield School,496,20960,12227,8733
825,Buckinghamshire,8255205,Brushwood Junior School,278,18780,10955,7825
825,Buckinghamshire,8255206,Loudwater Combined School,178,17780,10372,7408
825,Buckinghamshire,8255208,Danesfield School,361,19610,11439,8171
825,Buckinghamshire,8257013,Chiltern Wood School,153,17530,10226,7304
825,Buckinghamshire,8257018,Heritage House School,16,16000,9333,6667
825,Buckinghamshire,8257023,Furze Down School,36,16360,9543,6817
825,Buckinghamshire,8257028,Booker Park Community School,208,18080,10547,7533
825,Buckinghamshire,8257035,Westfield School,47,16470,9608,6862
826,Milton Keynes,8261107,Milton Keynes Primary Pupil Referral Unit,7,7000,4083,2917
826,Milton Keynes,8262000,Wavendon Gate School,357,19570,11416,8154
826,Milton Keynes,8262001,Merebrook Infant School,86,16860,9835,7025
826,Milton Keynes,8262002,Portfields Primary School,634,22340,13032,9308
826,Milton Keynes,8262005,Brooksward School,237,18370,10716,7654
826,Milton Keynes,8262006,Howe Park School,164,17640,10290,7350
826,Milton Keynes,8262007,Long Meadow School,369,19690,11486,8204
826,Milton Keynes,8262012,Christ the Sower Ecumenical Primary School (VA),355,19550,11404,8146
826,Milton Keynes,8262015,Castlethorpe First School,31,16310,9514,6796
826,Milton Keynes,8262017,Broughton Fields Primary School,358,19580,11422,8158
826,Milton Keynes,8262035,Emberton School,6,6000,3500,2500
826,Milton Keynes,8262042,Hanslope Primary School,208,18080,10547,7533
826,Milton Keynes,8262043,Haversham Village School,47,16470,9608,6862
826,Milton Keynes,8262062,Oldbrook First School,93,16930,9876,7054
826,Milton Keynes,8262067,Lavendon School,142,17420,10162,7258
826,Milton Keynes,8262112,Russell Street School,143,17430,10168,7262
826,Milton Keynes,8262121,Bushfield School,422,20220,11795,8425
826,Milton Keynes,8262122,Wyvern School,215,18150,10588,7562
826,Milton Keynes,8262185,Holne Chase Primary School,244,18440,10757,7683
826,Milton Keynes,8262238,Barleyhurst Park Primary,176,17760,10360,7400
826,Milton Keynes,8262247,Pepper Hill School,89,16890,9853,7037
826,Milton Keynes,8262272,Greenleys First School,104,17040,9940,7100
826,Milton Keynes,8262284,Langland Community School,276,18760,10943,7817
826,Milton Keynes,8262285,Falconhurst School,291,18910,11031,7879
826,Milton Keynes,8262294,Moorland Primary School,165,17650,10296,7354
826,Milton Keynes,8262299,Southwood School,220,18200,10617,7583
826,Milton Keynes,8262301,Stanton School,333,19330,11276,8054
826,Milton Keynes,8262303,Great Linford Primary School,302,19020,11095,7925
826,Milton Keynes,8262305,Greenleys Junior School,210,18100,10558,7542
826,Milton Keynes,8262306,Wood End First School,48,16480,9613,6867
826,Milton Keynes,8262309,Bradwell Village School,324,19240,11223,8017
826,Milton Keynes,8262313,Downs Barn School,57,16570,9666,6904
826,Milton Keynes,8262316,Germander Park School,63,16630,9701,6929
826,Milton Keynes,8262320,The Willows School and Early Years Centre,74,16740,9765,6975
826,Milton Keynes,8262322,Priory Common School,106,17060,9952,7108
826,Milton Keynes,8262323,Giffard Park Primary School,318,19180,11188,7992
826,Milton Keynes,8262324,Heelands School,96,16960,9893,7067
826,Milton Keynes,8262326,Ashbrook School,120,17200,10033,7167
826,Milton Keynes,8262327,Summerfield School,289,18890,11019,7871
826,Milton Keynes,8262330,Willen Primary School,332,19320,11270,8050
826,Milton Keynes,8262334,Holmwood School,115,17150,10004,7146
826,Milton Keynes,8262336,Caroline Haslett Primary School,369,19690,11486,8204
826,Milton Keynes,8262337,Green Park School,269,18690,10903,7787
826,Milton Keynes,8262346,Cedars Primary School,260,18600,10850,7750
826,Milton Keynes,8262347,Glastonbury Thorn School,165,17650,10296,7354
826,Milton Keynes,8262348,Abbeys Primary School,244,18440,10757,7683
826,Milton Keynes,8262351,Drayton Park School,258,18580,10838,7742
826,Milton Keynes,8262353,Emerson Valley School,462,20620,12028,8592
826,Milton Keynes,8262506,Loughton Manor First School,177,17770,10366,7404
826,Milton Keynes,8263000,Cold Harbour Church of England School,262,18620,10862,7758
826,Milton Keynes,8263003,Newton Blossomville Church of England School,11,11000,6417,4583
826,Milton Keynes,8263004,North Crawley CofE School,20,16200,9450,6750
826,Milton Keynes,8263005,Sherington Church of England School,18,16180,9438,6742
826,Milton Keynes,8263006,Stoke Goldington Church of England School,17,16170,9433,6737
826,Milton Keynes,8263058,St Marys Wavendon CofE Primary,84,16840,9823,7017
826,Milton Keynes,8263066,St Andrews CofE Infant School,22,16220,9462,6758
826,Milton Keynes,8263348,St Mary and St Giles Church of England School,393,19930,11626,8304
826,Milton Keynes,8263369,St Thomas Aquinas Catholic Primary School,242,18420,10745,7675
826,Milton Keynes,8263376,Giles Brook Primary School,359,19590,11428,8162
826,Milton Keynes,8263377,Bishop Parker Catholic School,172,17720,10337,7383
826,Milton Keynes,8263378,St Monicas Catholic Primary School,327,19270,11241,8029
826,Milton Keynes,8263379,St Mary Magdalene Catholic Primary School,286,18860,11002,7858
826,Milton Keynes,8263383,St Bernadettes Catholic Primary School,357,19570,11416,8154
826,Milton Keynes,8263384,Bow Brickhill CofE VA Primary School,89,16890,9853,7037
826,Milton Keynes,8263389,Tickford Park Primary School,342,19420,11328,8092
826,Milton Keynes,8263390,Newton Leys Primary School,117,17170,10016,7154
826,Milton Keynes,8263391,Brooklands Farm Primary School,756,23560,13743,9817
826,Milton Keynes,8263392,Priory Rise School,480,20800,12133,8667
826,Milton Keynes,8267009,White Spire School,23,16230,9468,6762
826,Milton Keynes,8267015,Romans Field School,46,16460,9602,6858
826,Milton Keynes,8267021,The Walnuts School,90,16900,9858,7042
826,Milton Keynes,8267026,Slated Row School,60,16600,9683,6917
826,Milton Keynes,8267034,The Redway School,94,16940,9882,7058
830,Derbyshire,8302000,Leys Junior School,161,17610,10273,7337
830,Derbyshire,8302002,Croft Infant School,120,17200,10033,7167
830,Derbyshire,8302003,Woodbridge Junior School,175,17750,10354,7396
830,Derbyshire,8302006,Riddings Infant and Nursery School,117,17170,10016,7154
830,Derbyshire,8302007,Riddings Junior School,225,18250,10646,7604
830,Derbyshire,8302010,Swanwick Primary School,375,19750,11521,8229
830,Derbyshire,8302011,Brampton Primary School,278,18780,10955,7825
830,Derbyshire,8302012,Gorseybrigg Primary School and Nursery,184,17840,10407,7433
830,Derbyshire,8302013,Chapel-en-le-Frith CofE VC Primary School,333,19330,11276,8054
830,Derbyshire,8302017,Ashover Primary School,173,17730,10343,7387
830,Derbyshire,8302018,Aston-on-Trent Primary School,174,17740,10348,7392
830,Derbyshire,8302019,Bramley Vale Primary School,108,17080,9963,7117
830,Derbyshire,8302021,Bamford Primary School,72,16720,9753,6967
830,Derbyshire,8302022,Barlborough Primary School,187,17870,10424,7446
830,Derbyshire,8302041,Blackwell Community Primary and Nursery School,97,16970,9899,7071
830,Derbyshire,8302043,Newton Primary School,131,17310,10098,7212
830,Derbyshire,8302044,Westhouses Primary School,78,16780,9788,6992
830,Derbyshire,8302045,New Bolsover Primary and Nursery School,189,17890,10436,7454
830,Derbyshire,8302046,Brockley Primary School,101,17010,9923,7087
830,Derbyshire,8302048,Bolsover Infant School,149,17490,10203,7287
830,Derbyshire,8302049,Bradwell Junior School,46,16460,9602,6858
830,Derbyshire,8302050,Cutthorpe Primary School,80,16800,9800,7000
830,Derbyshire,8302051,Wigley Primary School,43,16430,9584,6846
830,Derbyshire,8302052,Brassington Primary School,51,16510,9631,6879
830,Derbyshire,8302053,Firfield Primary School,350,19500,11375,8125
830,Derbyshire,8302057,Henry Bradley Infant School,108,17080,9963,7117
830,Derbyshire,8302058,Burbage Primary School,304,19040,11107,7933
830,Derbyshire,8302060,Buxton Junior School,223,18230,10634,7596
830,Derbyshire,8302061,Buxton Infant School,112,17120,9987,7133
830,Derbyshire,8302062,Harpur Hill Primary School,290,18900,11025,7875
830,Derbyshire,8302068,Combs Infant School,16,16000,9333,6667
830,Derbyshire,8302072,Buxworth Primary School,82,16820,9812,7008
830,Derbyshire,8302076,Holmgate Primary School and Nursery,179,17790,10378,7412
830,Derbyshire,8302079,Clowne Junior School,359,19590,11428,8162
830,Derbyshire,8302080,Clowne Infant and Nursery School,178,17780,10372,7408
830,Derbyshire,8302082,Crich Junior School,82,16820,9812,7008
830,Derbyshire,8302083,Curbar Primary School,58,16580,9672,6908
830,Derbyshire,8302084,Lea Primary School,105,17050,9946,7104
830,Derbyshire,8302085,Doveridge Primary School,81,16810,9806,7004
830,Derbyshire,8302086,Draycott Community Primary School,206,18060,10535,7525
830,Derbyshire,8302089,Dronfield Junior School,364,19640,11457,8183
830,Derbyshire,8302091,Dronfield Infant School,170,17700,10325,7375
830,Derbyshire,8302092,William Levick Primary School,148,17480,10197,7283
830,Derbyshire,8302095,Birk Hill Infant School,77,16770,9783,6987
830,Derbyshire,8302097,Marsh Lane Primary School,116,17160,10010,7150
830,Derbyshire,8302101,Renishaw Primary School,168,17680,10313,7367
830,Derbyshire,8302102,Ridgeway Primary School,174,17740,10348,7392
830,Derbyshire,8302103,Egginton Primary School,62,16620,9695,6925
830,Derbyshire,8302104,Creswell Junior School,242,18420,10745,7675
830,Derbyshire,8302105,Etwall Primary School,241,18410,10739,7671
830,Derbyshire,8302106,Grindleford Primary School,53,16530,9643,6887
830,Derbyshire,8302107,Findern Primary School,163,17630,10284,7346
830,Derbyshire,8302109,Padfield Community Primary School,100,17000,9917,7083
830,Derbyshire,8302113,Grassmoor Primary School,180,17800,10383,7417
830,Derbyshire,8302115,Hayfield Primary School,156,17560,10243,7317
830,Derbyshire,8302124,Marlpool Junior School,162,17620,10278,7342
830,Derbyshire,8302125,Marlpool Infant School,39,16390,9561,6829
830,Derbyshire,8302126,Coppice Primary School,185,17850,10413,7437
830,Derbyshire,8302131,Penny Acres Primary School,49,16490,9619,6871
830,Derbyshire,8302132,Hope Primary School,47,16470,9608,6862
830,Derbyshire,8302135,Chaucer Infant School,108,17080,9963,7117
830,Derbyshire,8302138,Cotmanhay Junior School,262,18620,10862,7758
830,Derbyshire,8302139,Cotmanhay Infant School,131,17310,10098,7212
830,Derbyshire,8302141,Granby Junior School,320,19200,11200,8000
830,Derbyshire,8302142,Hallam Fields Junior School,238,18380,10722,7658
830,Derbyshire,8302143,Kensington Junior School,220,18200,10617,7583
830,Derbyshire,8302145,Field House Infant School,116,17160,10010,7150
830,Derbyshire,8302146,Charlotte Nursery and Infant School,167,17670,10308,7362
830,Derbyshire,8302149,Kilburn Infant and Nursery School,71,16710,9748,6962
830,Derbyshire,8302150,Killamarsh Junior School,164,17640,10290,7350
830,Derbyshire,8302151,Killamarsh Infant School,72,16720,9753,6967
830,Derbyshire,8302153,Little Eaton Primary School,184,17840,10407,7433
830,Derbyshire,8302157,Harrington Junior School,227,18270,10658,7612
830,Derbyshire,8302159,Parklands Infant and Nursery School,120,17200,10033,7167
830,Derbyshire,8302160,Grange Primary School,353,19530,11393,8137
830,Derbyshire,8302161,Longmoor Primary School,289,18890,11019,7871
830,Derbyshire,8302169,Marston Montgomery Primary School,29,16290,9503,6787
830,Derbyshire,8302172,Darley Dale Primary School,178,17780,10372,7408
830,Derbyshire,8302173,Tansley Primary School,64,16640,9707,6933
830,Derbyshire,8302174,Melbourne Junior School,260,18600,10850,7750
830,Derbyshire,8302175,Melbourne Infant School,133,17330,10109,7221
830,Derbyshire,8302177,Morley Primary School,71,16710,9748,6962
830,Derbyshire,8302178,Morton Primary School,85,16850,9829,7021
830,Derbyshire,8302179,New Mills Primary School,161,17610,10273,7337
830,Derbyshire,8302180,Hague Bar Primary School,84,16840,9823,7017
830,Derbyshire,8302181,Newtown Primary School,62,16620,9695,6925
830,Derbyshire,8302182,Thornsett Primary School,72,16720,9753,6967
830,Derbyshire,8302185,Ashbrook Junior School,159,17590,10261,7329
830,Derbyshire,8302186,Overseal Primary School,178,17780,10372,7408
830,Derbyshire,8302187,Parwich Primary School,33,16330,9526,6804
830,Derbyshire,8302190,Pilsley Primary School,175,17750,10354,7396
830,Derbyshire,8302191,Park House Primary School,185,17850,10413,7437
830,Derbyshire,8302196,Anthony Bek Community Primary School,157,17570,10249,7321
830,Derbyshire,8302201,Ripley Junior School,306,19060,11118,7942
830,Derbyshire,8302202,Ripley Infant School,116,17160,10010,7150
830,Derbyshire,8302210,Ladycross Infant School,148,17480,10197,7283
830,Derbyshire,8302211,Scarcliffe Primary School,76,16760,9777,6983
830,Derbyshire,8302213,Palterton Primary School,83,16830,9818,7012
830,Derbyshire,8302219,Brookfield Primary School,149,17490,10203,7287
830,Derbyshire,8302223,Shirland Primary School,172,17720,10337,7383
830,Derbyshire,8302224,Stonebroom Primary and Nursery School,138,17380,10138,7242
830,Derbyshire,8302226,The Green Infant School,113,17130,9993,7137
830,Derbyshire,8302227,The Brigg Infant School,107,17070,9958,7112
830,Derbyshire,8302228,Glebe Junior School,427,20270,11824,8446
830,Derbyshire,8302229,South Wingfield Primary School,81,16810,9806,7004
830,Derbyshire,8302239,Staveley Junior School,153,17530,10226,7304
830,Derbyshire,8302242,Speedwell Infant School,79,16790,9794,6996
830,Derbyshire,8302243,Duckmanton Primary School,151,17510,10214,7296
830,Derbyshire,8302244,Sudbury Primary School,51,16510,9631,6879
830,Derbyshire,8302245,Arkwright Primary School,84,16840,9823,7017
830,Derbyshire,8302251,Church Gresley Infant and Nursery School,179,17790,10378,7412
830,Derbyshire,8302253,Newhall Community Junior School,343,19430,11334,8096
830,Derbyshire,8302254,Newhall Infant School,168,17680,10313,7367
830,Derbyshire,8302255,Stanton Primary School,87,16870,9841,7029
830,Derbyshire,8302257,Town End Junior School,187,17870,10424,7446
830,Derbyshire,8302258,Tibshelf Infant School,80,16800,9800,7000
830,Derbyshire,8302259,Tupton Primary and Nursery School,176,17760,10360,7400
830,Derbyshire,8302260,Unstone Junior School,45,16450,9596,6854
830,Derbyshire,8302262,Unstone St Marys Infant School,30,16300,9508,6792
830,Derbyshire,8302265,Walton Holymoorside Primary School,302,19020,11095,7925
830,Derbyshire,8302266,Wessington Primary School,54,16540,9648,6892
830,Derbyshire,8302268,Whaley Bridge Primary School,222,18220,10628,7592
830,Derbyshire,8302269,Furness Vale Primary School,73,16730,9759,6971
830,Derbyshire,8302270,Whitwell Primary School,224,18240,10640,7600
830,Derbyshire,8302272,Hodthorpe Primary School,65,16650,9713,6937
830,Derbyshire,8302274,Deer Park Primary School,299,18990,11078,7912
830,Derbyshire,8302275,Wirksworth Junior School,141,17410,10156,7254
830,Derbyshire,8302276,Wirksworth Infant School,28,16280,9497,6783
830,Derbyshire,8302277,Middleton Community Primary School,87,16870,9841,7029
830,Derbyshire,8302278,Woodville Infant School,166,17660,10302,7358
830,Derbyshire,8302279,Peak Dale Primary School,60,16600,9683,6917
830,Derbyshire,8302283,Cavendish Junior School,103,17030,9934,7096
830,Derbyshire,8302285,Spire Nursery and Infant School,93,16930,9876,7054
830,Derbyshire,8302286,Spire Junior School,165,17650,10296,7354
830,Derbyshire,8302288,Hasland Junior School,380,19800,11550,8250
830,Derbyshire,8302289,Hasland Infant School,198,17980,10488,7492
830,Derbyshire,8302290,Hady Primary School,235,18350,10704,7646
830,Derbyshire,8302293,Highfield Hall Primary School,333,19330,11276,8054
830,Derbyshire,8302295,Old Hall Junior School,262,18620,10862,7758
830,Derbyshire,8302296,Abercrombie Primary School,184,17840,10407,7433
830,Derbyshire,8302299,William Rhodes Primary School,166,17660,10302,7358
830,Derbyshire,8302306,The Park Infant & Nursery School,131,17310,10098,7212
830,Derbyshire,8302307,Brockwell Nursery and Infant School,120,17200,10033,7167
830,Derbyshire,8302308,Westfield Infant School,141,17410,10156,7254
830,Derbyshire,8302310,Dallimore Primary School,235,18350,10704,7646
830,Derbyshire,8302314,Mickley Infant School,22,16220,9462,6758
830,Derbyshire,8302315,Eureka Primary School,118,17180,10022,7158
830,Derbyshire,8302317,Ashbourne Primary School,278,18780,10955,7825
830,Derbyshire,8302321,Heath Fields Primary School,206,18060,10535,7525
830,Derbyshire,8302326,Holmesdale Infant School,100,17000,9917,7083
830,Derbyshire,8302328,Ladywood Primary School,239,18390,10728,7662
830,Derbyshire,8302329,The Park Junior School,237,18370,10716,7654
830,Derbyshire,8302332,Northfield Junior School,145,17450,10179,7271
830,Derbyshire,8302333,Ashbourne Hilltop Primary and Nursery School,76,16760,9777,6983
830,Derbyshire,8302336,Copthorne Community Infant School,50,16500,9625,6875
830,Derbyshire,8302338,Ashbrook Infant School,100,17000,9917,7083
830,Derbyshire,8302344,Duffield the Meadows Primary School,272,18720,10920,7800
830,Derbyshire,8302349,Brockwell Junior School,255,18550,10821,7729
830,Derbyshire,8302351,Hadfield Infant School,128,17280,10080,7200
830,Derbyshire,8302356,Elmsleigh Infant and Nursery School,109,17090,9969,7121
830,Derbyshire,8302358,Lenthall Infant and Nursery School,53,16530,9643,6887
830,Derbyshire,8302359,Hunloke Park Primary School,177,17770,10366,7404
830,Derbyshire,8302361,Dronfield Stonelow Junior School,139,17390,10144,7246
830,Derbyshire,8302362,Fairfield Infant and Nursery School,86,16860,9835,7025
830,Derbyshire,8302368,Willington Primary School,183,17830,10401,7429
830,Derbyshire,8302371,Waingroves Primary School,177,17770,10366,7404
830,Derbyshire,8302372,Norbriggs Primary School,163,17630,10284,7346
830,Derbyshire,8302373,Simmondley Primary School,225,18250,10646,7604
830,Derbyshire,8302375,Larklands Infant School,112,17120,9987,7133
830,Derbyshire,8302376,Chaucer Junior School,232,18320,10687,7633
830,Derbyshire,8302377,Lons Infant School,56,16560,9660,6900
830,Derbyshire,8302511,Heage Primary School,155,17550,10238,7312
830,Derbyshire,8302618,Stenson Fields Primary Community School,332,19320,11270,8050
830,Derbyshire,8302621,Model Village Primary School,168,17680,10313,7367
830,Derbyshire,8302622,Long Row Primary School,259,18590,10844,7746
830,Derbyshire,8302623,Ambergate Primary School,66,16660,9718,6942
830,Derbyshire,8302624,Pottery Primary School,280,18800,10967,7833
830,Derbyshire,8302625,Milford Primary School,82,16820,9812,7008
830,Derbyshire,8302626,Herbert Strutt Primary School,163,17630,10284,7346
830,Derbyshire,8302630,Whaley Thorns Primary School,87,16870,9841,7029
830,Derbyshire,8302631,Hollingwood Primary School,265,18650,10879,7771
830,Derbyshire,8303002,St Oswalds CofE Primary School,103,17030,9934,7096
830,Derbyshire,8303006,Bakewell CofE Infant School,46,16460,9602,6858
830,Derbyshire,8303007,Barlow CofE Primary School,75,16750,9771,6979
830,Derbyshire,8303008,Sale and Davys Church of England Primary School,94,16940,9882,7058
830,Derbyshire,8303009,St Annes CofE Primary School,124,17240,10057,7183
830,Derbyshire,8303015,Bradley CofE Primary School,25,16250,9479,6771
830,Derbyshire,8303016,Bradwell CofE (Controlled) Infant School,13,13000,7583,5417
830,Derbyshire,8303017,Brailsford CofE Primary School,79,16790,9794,6996
830,Derbyshire,8303018,Breadsall CofE VC Primary School,94,16940,9882,7058
830,Derbyshire,8303019,Fairfield Endowed CofE (C) Junior School,203,18030,10518,7512
830,Derbyshire,8303022,Castleton CofE Primary School,10,10000,5833,4167
830,Derbyshire,8303024,Dove Holes CofE Primary School,54,16540,9648,6892
830,Derbyshire,8303026,Clifton CofE Primary School,65,16650,9713,6937
830,Derbyshire,8303027,Coton-in-the-Elms Cof E Primary School,98,16980,9905,7075
830,Derbyshire,8303030,Edale CofE Primary School,7,7000,4083,2917
830,Derbyshire,8303032,Creswell CofE Controlled Infant and Nursery,136,17360,10127,7233
830,Derbyshire,8303033,Elton CofE Primary School,17,16170,9433,6737
830,Derbyshire,8303034,Eyam CofE Primary School,63,16630,9701,6929
830,Derbyshire,8303035,St Lukes CofE Primary School,166,17660,10302,7358
830,Derbyshire,8303036,St James CofE Controlled Primary School,241,18410,10739,7671
830,Derbyshire,8303037,Great Hucklow CE Primary,40,16400,9567,6833
830,Derbyshire,8303038,Rowsley CofE (Controlled) Primary School,51,16510,9631,6879
830,Derbyshire,8303039,Earl Sterndale CofE Primary School,25,16250,9479,6771
830,Derbyshire,8303040,Biggin CofE Primary School,38,16380,9555,6825
830,Derbyshire,8303041,Hartington CofE Primary School,13,13000,7583,5417
830,Derbyshire,8303042,Hartshorne CofE Primary School,88,16880,9847,7033
830,Derbyshire,8303046,Corfield CofE Infant School,57,16570,9666,6904
830,Derbyshire,8303048,Langley Mill CofE Infant School and Nursery,68,16680,9730,6950
830,Derbyshire,8303050,Mundy CofE Junior School,187,17870,10424,7446
830,Derbyshire,8303055,Horsley CofE (Controlled) Primary School,69,16690,9736,6954
830,Derbyshire,8303056,Hulland CofE Primary School,57,16570,9666,6904
830,Derbyshire,8303060,Kirk Ireton C of E Primary School,45,16450,9596,6854
830,Derbyshire,8303061,Kirk Langley CofE Primary School,66,16660,9718,6942
830,Derbyshire,8303062,Kniveton CofE Primary School,60,16600,9683,6917
830,Derbyshire,8303064,Longford CofE Primary School,65,16650,9713,6937
830,Derbyshire,8303065,Mapperley CofE Controlled Primary School,55,16550,9654,6896
830,Derbyshire,8303069,Cromford Church of England Primary School,51,16510,9631,6879
830,Derbyshire,8303070,Matlock Bath Holy Trinity CofE Controlled Primary School,39,16390,9561,6829
830,Derbyshire,8303071,South Darley CofE Primary School,54,16540,9648,6892
830,Derbyshire,8303073,Monyash CofE Primary School,23,16230,9468,6762
830,Derbyshire,8303074,Netherseal St Peters CofE (C) Primary School,65,16650,9713,6937
830,Derbyshire,8303075,Norbury CofE Primary School,58,16580,9672,6908
830,Derbyshire,8303076,Long Lane Church of England Primary School,29,16290,9503,6787
830,Derbyshire,8303077,Osmaston CofE (VC) Primary School,123,17230,10051,7179
830,Derbyshire,8303079,Peak Forest Church of England Voluntary Controlled Primary School,25,16250,9479,6771
830,Derbyshire,8303080,St Johns CofE Primary School,279,18790,10961,7829
830,Derbyshire,8303082,Risley Lower Grammar CE (VC) Primary School,114,17140,9998,7142
830,Derbyshire,8303083,Rosliston CofE Primary School,82,16820,9812,7008
830,Derbyshire,8303086,Richardson Endowed Primary School,180,17800,10383,7417
830,Derbyshire,8303087,St Andrews CofE Primary School,91,16910,9864,7046
830,Derbyshire,8303088,Stanley Common CofE Primary School,56,16560,9660,6900
830,Derbyshire,8303090,Stanton-in-Peak CofE Primary School,44,16440,9590,6850
830,Derbyshire,8303092,Woodthorpe CofE Primary School,116,17160,10010,7150
830,Derbyshire,8303093,Stoney Middleton CofE (C) Primary School,13,13000,7583,5417
830,Derbyshire,8303094,Stretton Handley Church of England Primary School,36,16360,9543,6817
830,Derbyshire,8303095,St Georges CofE Controlled Primary School,170,17700,10325,7375
830,Derbyshire,8303098,Mugginton CofE Primary School,40,16400,9567,6833
830,Derbyshire,8303099,Winster CofE Primary School,34,16340,9532,6808
830,Derbyshire,8303100,Wirksworth CofE Infant School,59,16590,9678,6912
830,Derbyshire,8303101,Woodville CofE Junior School,332,19320,11270,8050
830,Derbyshire,8303105,Crich Carr CofE Primary School,34,16340,9532,6808
830,Derbyshire,8303106,Crich Church of England Infant School,29,16290,9503,6787
830,Derbyshire,8303107,Duke of Norfolk CofE Primary School,269,18690,10903,7787
830,Derbyshire,8303110,St Andrews CofE Junior School,225,18250,10646,7604
830,Derbyshire,8303151,Bakewell Methodist Junior School,73,16730,9759,6971
830,Derbyshire,8303156,Church Broughton CofE Primary School,92,16920,9870,7050
830,Derbyshire,8303157,Taxal and Fernilee CofE Primary School,182,17820,10395,7425
830,Derbyshire,8303161,St Johns CofE Primary School and Nursery,410,20100,11725,8375
830,Derbyshire,8303162,Calow CofE VC Primary School,160,17600,10267,7333
830,Derbyshire,8303163,Charlesworth Voluntary Controlled Primary School,80,16800,9800,7000
830,Derbyshire,8303164,Codnor Community Primary School Church of England Controlled,205,18050,10529,7521
830,Derbyshire,8303306,Carsington and Hopton Primary School,35,16350,9538,6812
830,Derbyshire,8303312,Fritchley CofE (Aided) Primary & Nursery School,54,16540,9648,6892
830,Derbyshire,8303315,Denby Free CofE VA Primary School,114,17140,9998,7142
830,Derbyshire,8303316,Camms CofE (Aided) Primary School,164,17640,10290,7350
830,Derbyshire,8303317,Fitzherbert CofE (Aided) Primary School,40,16400,9567,6833
830,Derbyshire,8303319,Dinting Church of England Voluntary Aided Primary School,113,17130,9993,7137
830,Derbyshire,8303321,Hathersage St Michaels CofE (Aided) Primary School,131,17310,10098,7212
830,Derbyshire,8303324,Litton CofE Primary School,40,16400,9567,6833
830,Derbyshire,8303325,Longstone CofE Primary School,105,17050,9946,7104
830,Derbyshire,8303326,Bonsall CofE (A) Primary School,84,16840,9823,7017
830,Derbyshire,8303330,Newton Solney CofE (Aided) Infant School,46,16460,9602,6858
830,Derbyshire,8303331,Pilsley CofE Primary School,60,16600,9683,6917
830,Derbyshire,8303337,Taddington and Priestcliffe School,49,16490,9619,6871
830,Derbyshire,8303338,Bishop Pursglove CofE (A) Primary School,95,16950,9888,7062
830,Derbyshire,8303342,Weston-on-Trent CofE (VA) Primary School,100,17000,9917,7083
830,Derbyshire,8303502,St Marys Catholic Primary,360,19600,11433,8167
830,Derbyshire,8303523,St Andrews CofE Methodist (Aided) Primary School,170,17700,10325,7375
830,Derbyshire,8303538,Tintwistle CofE (Aided) Primary School,84,16840,9823,7017
830,Derbyshire,8303540,Youlgrave All Saints CofE Voluntary Aided Primary School,69,16690,9736,6954
830,Derbyshire,8303546,Brooklands Primary School,337,19370,11299,8071
830,Derbyshire,8303547,North Wingfield Primary and Nursery School,197,17970,10483,7487
830,Derbyshire,8303549,St Josephs Catholic and CofE (VA) Primary School,122,17220,10045,7175
830,Derbyshire,8303551,Sharley Park Community Primary School,349,19490,11369,8121
830,Derbyshire,8305200,Belmont Primary School,346,19460,11352,8108
830,Derbyshire,8305202,Repton Primary School,190,17900,10442,7458
830,Derbyshire,8305204,Linton Primary School,226,18260,10652,7608
830,Derbyshire,8305207,The Curzon CofE Primary School,113,17130,9993,7137
830,Derbyshire,8305208,Fairmeadows Foundation Primary School,176,17760,10360,7400
830,Derbyshire,8305211,Chinley Primary School,188,17880,10430,7450
830,Derbyshire,8307000,Holly House Special School,11,11000,6417,4583
830,Derbyshire,8307005,Brackenfield Special School,23,16230,9468,6762
830,Derbyshire,8307006,Ashgate Croft School,46,16460,9602,6858
830,Derbyshire,8307009,Swanwick School and Sports College,12,12000,7000,5000
830,Derbyshire,8307012,Stubbin Wood School,42,16420,9578,6842
830,Derbyshire,8307018,Alfreton Park Community Special School,31,16310,9514,6796
831,Derby,8311104,Newtons Walk,29,16290,9503,6787
831,Derby,8312001,Roe Farm Primary School,334,19340,11282,8058
831,Derby,8312003,Parkview Primary School,177,17770,10366,7404
831,Derby,8312005,Ashgate Primary School,281,18810,10973,7837
831,Derby,8312006,Homefields Primary School,257,18570,10833,7737
831,Derby,8312405,Becket Primary School,172,17720,10337,7383
831,Derby,8312409,Dale Community Primary School,465,20650,12046,8604
831,Derby,8312424,Pear Tree Infant School,179,17790,10378,7412
831,Derby,8312429,Rosehill Infant and Nursery School,99,16990,9911,7079
831,Derby,8312432,Brackensdale Primary School,400,20000,11667,8333
831,Derby,8312436,Markeaton Primary School,327,19270,11241,8029
831,Derby,8312439,Portway Infant School,179,17790,10378,7412
831,Derby,8312443,Alvaston Infant and Nursery School,178,17780,10372,7408
831,Derby,8312444,Shelton Infant School,141,17410,10156,7254
831,Derby,8312449,Cavendish Close Infant School,165,17650,10296,7354
831,Derby,8312452,Meadow Farm Community Primary School,155,17550,10238,7312
831,Derby,8312456,Carlyle Infant and Nursery School,121,17210,10039,7171
831,Derby,8312457,Gayton Junior School,367,19670,11474,8196
831,Derby,8312458,Ridgeway Infant School,179,17790,10378,7412
831,Derby,8312459,Wren Park Primary School,335,19350,11288,8062
831,Derby,8312462,Ravensdale Infant and Nursery School,179,17790,10378,7412
831,Derby,8312463,Ravensdale Junior School,353,19530,11393,8137
831,Derby,8312469,Silverhill Primary School,362,19620,11445,8175
831,Derby,8312471,Oakwood Junior School,346,19460,11352,8108
831,Derby,8312473,Oakwood Infant and Nursery School,179,17790,10378,7412
831,Derby,8312505,Redwood Primary School,495,20950,12221,8729
831,Derby,8312512,Brookfield Primary School,185,17850,10413,7437
831,Derby,8312522,Lawn Primary School,370,19700,11492,8208
831,Derby,8312627,Mickleover Primary School,360,19600,11433,8167
831,Derby,8313526,St James Church of England Aided Infant School,59,16590,9678,6912
831,Derby,8313532,St Werburghs Church of England VA Primary School,266,18660,10885,7775
831,Derby,8313534,St Peters Church of England Aided Junior School,252,18520,10803,7717
831,Derby,8313535,St James Church of England Aided Junior School,298,18980,11072,7908
831,Derby,8314177,The Bemrose School,234,18340,10698,7642
831,Derby,8315209,Shelton Junior School,267,18670,10891,7779
831,Derby,8317024,St Giles School,106,17060,9952,7108
831,Derby,8317026,Ivy House School,35,16350,9538,6812
838,Dorset,8381100,The Forum Centre,1,1000,583,417
838,Dorset,8381105,The Compass,4,4000,2333,1667
838,Dorset,8382000,Trinity CofE VA First School,113,17130,9993,7137
838,Dorset,8382002,Downlands Community School,206,18060,10535,7525
838,Dorset,8382005,Broadmayne First School,112,17120,9987,7133
838,Dorset,8382008,Charmouth Primary School,134,17340,10115,7225
838,Dorset,8382009,Cheselbourne Village School,29,16290,9503,6787
838,Dorset,8382015,Damers First School,354,19540,11398,8142
838,Dorset,8382017,Gillingham Primary School,321,19210,11206,8004
838,Dorset,8382020,Ferndown First School,242,18420,10745,7675
838,Dorset,8382022,Hazelbury Bryan Primary School,77,16770,9783,6987
838,Dorset,8382030,Stower Provost Community School,70,16700,9742,6958
838,Dorset,8382032,Sturminster Marshall First School,105,17050,9946,7104
838,Dorset,8382034,William Barnes Primary School,180,17800,10383,7417
838,Dorset,8382035,Swanage Primary School,159,17590,10261,7329
838,Dorset,8382040,Wimborne First School,248,18480,10780,7700
838,Dorset,8382042,Bovington Primary School,238,18380,10722,7658
838,Dorset,8382045,Parley First School,238,18380,10722,7658
838,Dorset,8382050,Rushcombe First School,248,18480,10780,7700
838,Dorset,8382209,Wyke Regis Infant School and Nursery,178,17780,10372,7408
838,Dorset,8382213,Bincombe Valley Primary School,262,18620,10862,7758
838,Dorset,8382214,Radipole Primary School,381,19810,11556,8254
838,Dorset,8382216,Southill Primary School,186,17860,10418,7442
838,Dorset,8382253,Wyke Primary School,175,17750,10354,7396
838,Dorset,8382257,Henbury View First School,124,17240,10057,7183
838,Dorset,8382262,The Prince of Wales School,125,17250,10063,7187
838,Dorset,8383001,Stoborough Church of England Primary School,174,17740,10348,7392
838,Dorset,8383005,St Georges Church of England School Bourton,98,16980,9905,7075
838,Dorset,8383009,Cerne Abbas Church of England Voluntary Controlled First School,50,16500,9625,6875
838,Dorset,8383017,St James Church of England Voluntary Controlled First School,99,16990,9911,7079
838,Dorset,8383021,Maiden Newton Greenford Church of England Primary School,133,17330,10109,7221
838,Dorset,8383025,Pamphill Voluntary Controlled Church of England First School,55,16550,9654,6896
838,Dorset,8383030,Thorncombe St Marys Church of England Voluntary Controlled Primary School,56,16560,9660,6900
838,Dorset,8383045,All Saints Church of England Voluntary Controlled Primary School,81,16810,9806,7004
838,Dorset,8383047,Pimperne Church of England VC Primary School,175,17750,10354,7396
838,Dorset,8383051,Broadwindsor Church of England Voluntary Controlled Primary School,85,16850,9829,7021
838,Dorset,8383157,St Marys Church of England First School Charminster,152,17520,10220,7300
838,Dorset,8383202,Wyke Regis Church of England Junior School,359,19590,11428,8162
838,Dorset,8383210,Manor Park Church of England First School,344,19440,11340,8100
838,Dorset,8383314,St Nicholas Church of England Voluntary Aided Primary School Child Okeford,129,17290,10086,7204
838,Dorset,8383317,Cranborne Church of England Voluntary Aided First School,103,17030,9934,7096
838,Dorset,8383319,Durweston CofE VA Primary School,116,17160,10010,7150
838,Dorset,8383321,Sticklands Church of England Voluntary Aided Primary School,79,16790,9794,6996
838,Dorset,8383323,Milton-on-Stour Church of England Primary School,123,17230,10051,7179
838,Dorset,8383325,Hampreston Church of England Voluntary Aided First School,121,17210,10039,7171
838,Dorset,8383331,St Georges Church of England Primary School Langton Matravers,84,16840,9823,7017
838,Dorset,8383332,Thorners Church of England School Litton Cheney,65,16650,9713,6937
838,Dorset,8383337,St Gregorys Church of England Primary School Marnhull,123,17230,10051,7179
838,Dorset,8383342,Parrett and Axe Church of England Voluntary Aided Primary School,99,16990,9911,7079
838,Dorset,8383345,Salway Ash Church of England Voluntary Aided Primary School,102,17020,9928,7092
838,Dorset,8383348,Okeford Fitzpaine Church of England Voluntary Aided School,26,16260,9485,6775
838,Dorset,8383352,Powerstock Church of England Voluntary Aided Primary School,44,16440,9590,6850
838,Dorset,8383364,Symondsbury Church of England Voluntary Aided Primary School,92,16920,9870,7050
838,Dorset,8383372,Sandford St Martins Church of England Voluntary Aided Primary School,327,19270,11241,8029
838,Dorset,8383376,Wimborne St Giles Church of England First School and Nursery,38,16380,9555,6825
838,Dorset,8383377,Winterbourne Valley Church of England Aided First School,42,16420,9578,6842
838,Dorset,8383381,Wool Church of England Voluntary Aided Primary School,80,16800,9800,7000
838,Dorset,8383407,St Mary the Virgin CofE VA Primary School,170,17700,10325,7375
838,Dorset,8383408,Conifers Primary School,352,19520,11387,8133
838,Dorset,8383651,Portesham Church of England Primary School,96,16960,9893,7067
838,Dorset,8383652,St Nicholas and St Laurence Church of England Primary School Broadwey,180,17800,10383,7417
838,Dorset,8383693,The Abbey CofE VA Primary School Shaftesbury,168,17680,10313,7367
838,Dorset,8383696,St Michaels Church of England Voluntary Aided Primary School Lyme Regis,119,17190,10028,7162
838,Dorset,8383700,Holy Trinity Church of England VC Primary School & Community Nursery,532,21320,12437,8883
838,Dorset,8383701,St Georges Community Primary School,385,19850,11579,8271
838,Dorset,8383702,Lulworth and Winfrith CofE VC Primary School,87,16870,9841,7029
838,Dorset,8384020,Cranborne Middle School,225,18250,10646,7604
838,Dorset,8384033,West Moors Middle School,107,17070,9958,7112
838,Dorset,8384184,Ferndown Middle School,297,18970,11066,7904
838,Dorset,8385201,Stalbridge Church of England Primary School,171,17710,10331,7379
838,Dorset,8385203,Shillingstone Church of England Voluntary Aided Primary School,86,16860,9835,7025
838,Dorset,8385950,Beaucroft Foundation School,63,16630,9701,6929
838,Dorset,8385953,Westfield Arts College,70,16700,9742,6958
838,Dorset,8387007,Mountjoy School,26,16260,9485,6775
838,Dorset,8387019,Yewstock School,51,16510,9631,6879
839,Bournemouth Christchurch and Poole,8393699,Highcliffe St Mark Primary School,499,20990,12244,8746
839,Bournemouth Christchurch and Poole,8393690,The Priory Church of England Primary School,188,17880,10430,7450
839,Bournemouth Christchurch and Poole,8393691,St Josephs Catholic Primary School Christchurch,186,17860,10418,7442
839,Bournemouth Christchurch and Poole,8392241,Christchurch Infant School,240,18400,10733,7667
839,Bournemouth Christchurch and Poole,8392243,Somerford Primary School,298,18980,11072,7908
839,Bournemouth Christchurch and Poole,8392245,Mudeford Community Infants School,120,17200,10033,7167
839,Bournemouth Christchurch and Poole,8392247,Mudeford Junior School,264,18640,10873,7767
839,Bournemouth Christchurch and Poole,8393207,Burton Church of England Primary School,305,19050,11113,7937
839,Bournemouth Christchurch and Poole,8393614,Hillbourne Primary School,261,18610,10856,7754
839,Bournemouth Christchurch and Poole,8397005,Winchelsea School,50,16500,9625,6875
839,Bournemouth Christchurch and Poole,8393679,St Katharines Church of England Primary School,444,20440,11923,8517
839,Bournemouth Christchurch and Poole,8393684,Corpus Christi Catholic Primary School,374,19740,11515,8225
839,Bournemouth Christchurch and Poole,8395200,St Walburgas Catholic Primary School,420,20200,11783,8417
839,Bournemouth Christchurch and Poole,8397012,Linwood School,104,17040,9940,7100
840,Durham,8402000,Ropery Walk Primary School,213,18130,10576,7554
840,Durham,8402001,Middlestone Moor Primary School,216,18160,10593,7567
840,Durham,8402003,North Park Primary School,170,17700,10325,7375
840,Durham,8402004,Seascape Primary School,202,18020,10512,7508
840,Durham,8402005,Pelton Community Primary School,239,18390,10728,7662
840,Durham,8402043,Westlea Primary School,195,17950,10471,7479
840,Durham,8402105,Edmondsley Primary School,144,17440,10173,7267
840,Durham,8402107,Lumley Junior School,159,17590,10261,7329
840,Durham,8402108,Lumley Infant and Nursery School,83,16830,9818,7012
840,Durham,8402114,West Pelton Primary School,57,16570,9666,6904
840,Durham,8402116,Nettlesworth Primary School,81,16810,9806,7004
840,Durham,8402125,Red Rose Primary School,226,18260,10652,7608
840,Durham,8402126,Woodlea Primary School,176,17760,10360,7400
840,Durham,8402133,Cestria Primary School,360,19600,11433,8167
840,Durham,8402146,Bournmoor Primary School,94,16940,9882,7058
840,Durham,8402185,Cotherstone Primary School,45,16450,9596,6854
840,Durham,8402205,Beamish Primary School,54,16540,9648,6892
840,Durham,8402208,Collierley Primary School,120,17200,10033,7167
840,Durham,8402210,Catchgate Primary School,193,17930,10459,7471
840,Durham,8402212,Annfield Plain Junior School,136,17360,10127,7233
840,Durham,8402213,Annfield Plain Infant School,75,16750,9771,6979
840,Durham,8402217,East Stanley School,197,17970,10483,7487
840,Durham,8402232,Stanley Burnside Primary School,169,17690,10319,7371
840,Durham,8402234,Burnopfield Primary School,316,19160,11177,7983
840,Durham,8402257,Shotley Bridge Primary School,316,19160,11177,7983
840,Durham,8402259,Leadgate Primary School,161,17610,10273,7337
840,Durham,8402261,Burnhope Primary School,62,16620,9695,6925
840,Durham,8402266,Castleside Primary School,112,17120,9987,7133
840,Durham,8402269,The Grove Primary School,139,17390,10144,7246
840,Durham,8402272,Delves Lane Primary School,269,18690,10903,7787
840,Durham,8402276,Moorside Primary School,87,16870,9841,7029
840,Durham,8402277,Consett Junior School,195,17950,10471,7479
840,Durham,8402278,Consett Infant School,114,17140,9998,7142
840,Durham,8402301,Hamsterley Primary School,38,16380,9555,6825
840,Durham,8402302,Hunwick Primary School,145,17450,10179,7271
840,Durham,8402307,Tow Law Millennium Primary School,72,16720,9753,6967
840,Durham,8402308,Crook Primary School,311,19110,11148,7962
840,Durham,8402311,Peases West Primary School,80,16800,9800,7000
840,Durham,8402313,Stanley (Crook) Primary School,114,17140,9998,7142
840,Durham,8402316,Sunnybrow Primary School,72,16720,9753,6967
840,Durham,8402318,Howden-le-Wear Primary School,105,17050,9946,7104
840,Durham,8402319,Frosterley Primary School,29,16290,9503,6787
840,Durham,8402321,Rookhope Primary School,11,11000,6417,4583
840,Durham,8402322,St Johns Chapel Primary School,17,16170,9433,6737
840,Durham,8402324,Wearhead Primary School,25,16250,9479,6771
840,Durham,8402326,Willington Primary School,174,17740,10348,7392
840,Durham,8402328,Witton-le-Wear Primary School,74,16740,9765,6975
840,Durham,8402329,Wolsingham Primary School,170,17700,10325,7375
840,Durham,8402330,Oakley Cross Primary School and Nursery,115,17150,10004,7146
840,Durham,8402351,Byers Green Primary School,88,16880,9847,7033
840,Durham,8402357,Bluebell Meadow Primary School,247,18470,10774,7696
840,Durham,8402361,Kirk Merrington Primary School,107,17070,9958,7112
840,Durham,8402362,Cassop Primary School,118,17180,10022,7158
840,Durham,8402368,Ferryhill Station Primary School,72,16720,9753,6967
840,Durham,8402370,West Cornforth Primary School,149,17490,10203,7287
840,Durham,8402372,Coxhoe Primary School,252,18520,10803,7717
840,Durham,8402374,Kelloe Primary School,72,16720,9753,6967
840,Durham,8402385,Dean Bank Primary and Nursery School,134,17340,10115,7225
840,Durham,8402388,Bowburn Junior School,177,17770,10366,7404
840,Durham,8402389,Bowburn Infant School,97,16970,9899,7071
840,Durham,8402394,Ox Close Primary School,241,18410,10739,7671
840,Durham,8402399,Fishburn Primary School,130,17300,10092,7208
840,Durham,8402400,Broom Cottages Primary & Nursery School,226,18260,10652,7608
840,Durham,8402401,Etherley Lane Primary School,263,18630,10868,7762
840,Durham,8402409,Ramshaw Primary School,67,16670,9724,6946
840,Durham,8402410,Forest of Teesdale Primary School,8,8000,4667,3333
840,Durham,8402411,Aycliffe Village Primary School,126,17260,10068,7192
840,Durham,8402413,Butterknowle Primary School,28,16280,9497,6783
840,Durham,8402417,Escomb Primary School,177,17770,10366,7404
840,Durham,8402419,St Helen Auckland Community Primary School,128,17280,10080,7200
840,Durham,8402423,Thornhill Primary School,178,17780,10372,7408
840,Durham,8402426,Toft Hill Primary School,163,17630,10284,7346
840,Durham,8402428,Woodland Primary School,39,16390,9561,6829
840,Durham,8402430,Middleton-in-Teesdale Nursery and Primary School,108,17080,9963,7117
840,Durham,8402433,Cockton Hill Junior School,210,18100,10558,7542
840,Durham,8402434,Cockton Hill Infant School,119,17190,10028,7162
840,Durham,8402438,Timothy Hackworth Primary School,352,19520,11387,8133
840,Durham,8402440,Cockfield Primary School,88,16880,9847,7033
840,Durham,8402442,Montalbo Nursery & Primary School,116,17160,10010,7150
840,Durham,8402453,New Brancepeth Primary School,87,16870,9841,7029
840,Durham,8402455,Langley Moor Primary School,167,17670,10308,7362
840,Durham,8402462,Witton Gilbert Primary School,167,17670,10308,7362
840,Durham,8402470,Pittington Primary School,168,17680,10313,7367
840,Durham,8402472,Ludworth Primary School,69,16690,9736,6954
840,Durham,8402473,Sherburn Primary School,145,17450,10179,7271
840,Durham,8402475,West Rainton Primary School,109,17090,9969,7121
840,Durham,8402477,Bearpark Primary School,87,16870,9841,7029
840,Durham,8402481,Nevilles Cross Primary School,250,18500,10792,7708
840,Durham,8402488,Durham Newton Hall Infants School,119,17190,10028,7162
840,Durham,8402497,Esh Winning Primary School,180,17800,10383,7417
840,Durham,8402498,Belmont Cheveley Park Primary School,170,17700,10325,7375
840,Durham,8402499,Laurel Avenue Community Primary School,73,16730,9759,6971
840,Durham,8402509,Hesleden Primary School,99,16990,9911,7079
840,Durham,8402516,Deaf Hill Primary School,118,17180,10022,7158
840,Durham,8402523,Thornley Primary School,152,17520,10220,7300
840,Durham,8402526,Wheatley Hill Community Primary School,147,17470,10191,7279
840,Durham,8402531,Wingate Infants School,301,19010,11089,7921
840,Durham,8402532,Cotsford Junior School,115,17150,10004,7146
840,Durham,8402534,Cotsford Infant School,42,16420,9578,6842
840,Durham,8402536,Shotton Primary School,274,18740,10932,7808
840,Durham,8402540,Acre Rigg Infant School,131,17310,10098,7212
840,Durham,8402563,Sedgefield Primary School,170,17700,10325,7375
840,Durham,8402593,Sedgefield Hardwick Primary School,182,17820,10395,7425
840,Durham,8402704,Copeland Road Primary School,125,17250,10063,7187
840,Durham,8402705,St Andrews Primary School,93,16930,9876,7054
840,Durham,8402706,Byerley Park Primary School,182,17820,10395,7425
840,Durham,8402708,Horndale Infants School,67,16670,9724,6946
840,Durham,8402729,Langley Park Primary School,136,17360,10127,7233
840,Durham,8402733,Yohden Primary School,144,17440,10173,7267
840,Durham,8402734,Howletch Lane Primary School,316,19160,11177,7983
840,Durham,8402737,Blackhall Primary School,188,17880,10430,7450
840,Durham,8402742,Vane Road Primary School,346,19460,11352,8108
840,Durham,8402743,Sugar Hill Primary School,349,19490,11369,8121
840,Durham,8402744,Roseberry Primary and Nursery School,137,17370,10133,7237
840,Durham,8402745,Bullion Lane Primary School,224,18240,10640,7600
840,Durham,8402746,Easington Colliery Primary School,442,20420,11912,8508
840,Durham,8402747,Durham Gilesgate Primary School,159,17590,10261,7329
840,Durham,8402748,Finchale Primary School,182,17820,10395,7425
840,Durham,8402749,Benfieldside Primary School,201,18010,10506,7504
840,Durham,8402750,King Street Primary School,186,17860,10418,7442
840,Durham,8402751,Framwellgate Moor Primary School,182,17820,10395,7425
840,Durham,8402943,Newker Primary School,355,19550,11404,8146
840,Durham,8403031,Chester-Le-Street CofE (Controlled) Primary School,286,18860,11002,7858
840,Durham,8403063,Ebchester CofE Primary School,75,16750,9771,6979
840,Durham,8403085,St Stephens Church of England Primary School,172,17720,10337,7383
840,Durham,8403087,Stanhope Barrington CofE Primary School,101,17010,9923,7087
840,Durham,8403121,Green Lane Church of England Controlled Primary School,195,17950,10471,7479
840,Durham,8403123,St Annes CofE Primary School,184,17840,10407,7433
840,Durham,8403130,Evenwood CofE Primary School,68,16680,9730,6950
840,Durham,8403131,Gainford CofE Primary School,64,16640,9707,6933
840,Durham,8403134,Ingleton CofE Primary School,58,16580,9672,6908
840,Durham,8403141,Staindrop CofE (Controlled) Primary School,152,17520,10220,7300
840,Durham,8403161,Belmont CofE (Controlled) Primary School,228,18280,10663,7617
840,Durham,8403165,St Oswalds Church of England Aided Primary and Nursery School,102,17020,9928,7092
840,Durham,8403167,Shincliffe CofE (Controlled) Primary School,175,17750,10354,7396
840,Durham,8403168,St Margarets Church of England Primary School,361,19610,11439,8171
840,Durham,8403182,Easington CofE Primary School,101,17010,9923,7087
840,Durham,8403183,Hutton Henry CofE (Controlled) Primary School,55,16550,9654,6896
840,Durham,8403213,Lanchester Endowed Parochial Primary School,283,18830,10984,7846
840,Durham,8403300,St Cuthberts Roman Catholic Voluntary Aided Primary School New Seaham,176,17760,10360,7400
840,Durham,8403301,St Mary Magdalens Roman Catholic Voluntary Aided Primary School Seaham,240,18400,10733,7667
840,Durham,8403303,Bowes Hutchinsons CofE (Aided) School,42,16420,9578,6842
840,Durham,8403343,St Cuthberts Roman Catholic Voluntary Aided Primary School,183,17830,10401,7429
840,Durham,8403344,St Bedes Roman Catholic Voluntary Aided Primary School Sacriston,79,16790,9794,6996
840,Durham,8403346,St Benets Roman Catholic Voluntary Aided Primary School,180,17800,10383,7417
840,Durham,8403381,St Josephs Roman Catholic Voluntary Aided Primary School Stanley,179,17790,10378,7412
840,Durham,8403382,St Patricks Roman Catholic Voluntary Aided Primary School Dipton,146,17460,10185,7275
840,Durham,8403384,St Marys Roman Catholic Voluntary Aided Primary School South Moor,113,17130,9993,7137
840,Durham,8403401,St Marys Roman Catholic Voluntary Aided Primary School Blackhill,180,17800,10383,7417
840,Durham,8403403,St Pius X Roman Catholic Voluntary Aided Primary School,84,16840,9823,7017
840,Durham,8403404,St Patricks Roman Catholic Voluntary Aided Primary School Consett,349,19490,11369,8121
840,Durham,8403406,Esh CofE (Aided) Primary School,73,16730,9759,6971
840,Durham,8403407,St Michaels Roman Catholic Voluntary Aided Primary School Esh Laude,159,17590,10261,7329
840,Durham,8403409,Our Lady and St Josephs Roman Catholic Voluntary Aided Primary School Brooms,103,17030,9934,7096
840,Durham,8403411,Bishop Ian Ramsey CofE Primary School,173,17730,10343,7387
840,Durham,8403413,All Saints Catholic Voluntary Aided Primary School,157,17570,10249,7321
840,Durham,8403421,St Cuthberts Roman Catholic Voluntary Aided Primary School,163,17630,10284,7346
840,Durham,8403425,Our Lady and St Thomas Roman Catholic Voluntary Aided Primary,100,17000,9917,7083
840,Durham,8403441,St Michaels C of E Primary School,98,16980,9905,7075
840,Durham,8403442,St Williams Roman Catholic Voluntary Aided Primary School,102,17020,9928,7092
840,Durham,8403444,St Charles Roman Catholic Voluntary Aided Primary School,178,17780,10372,7408
840,Durham,8403461,St Marys Roman Catholic Voluntary Aided Primary School Barnard Castle,84,16840,9823,7017
840,Durham,8403462,St Wilfrids Roman Catholic Voluntary Aided Primary School,173,17730,10343,7387
840,Durham,8403465,St Chads Roman Catholic Voluntary Aided Primary School,74,16740,9765,6975
840,Durham,8403469,St Josephs Roman Catholic Voluntary Aided Primary School Coundon,104,17040,9940,7100
840,Durham,8403470,St Marys Roman Catholic Voluntary Aided Primary School Newton Aycliffe,170,17700,10325,7375
840,Durham,8403472,St Francis Church of England Aided Junior School,127,17270,10074,7196
840,Durham,8403481,St Patricks Roman Catholic Voluntary Aided Primary School Langley Moor,81,16810,9806,7004
840,Durham,8403483,Our Lady Queen of Martyrs Roman Catholic Voluntary Aided Primary School Newhouse,81,16810,9806,7004
840,Durham,8403485,St Hilds College Church of England Aided Primary School Durham,151,17510,10214,7296
840,Durham,8403486,St Godrics Roman Catholic Voluntary Aided Primary School Durham,185,17850,10413,7437
840,Durham,8403488,St Josephs Roman Catholic Voluntary Aided Primary School Ushaw Moor,90,16900,9858,7042
840,Durham,8403489,St Josephs Roman Catholic Voluntary Aided Primary School Durham,117,17170,10016,7154
840,Durham,8403491,Blue Coat CofE (Aided) Junior School,247,18470,10774,7696
840,Durham,8403492,St Thomas More Roman Catholic Voluntary Aided Primary,85,16850,9829,7021
840,Durham,8403501,St Josephs Catholic Primary School Murton,117,17170,10016,7154
840,Durham,8403502,St Godrics Roman Catholic Voluntary Aided Primary School Thornley,94,16940,9882,7058
840,Durham,8403504,Our Lady of Lourdes Roman Catholic Voluntary Aided Primary,135,17350,10121,7229
840,Durham,8403505,St Marys Roman Catholic Voluntary Aided Primary School Wingate,49,16490,9619,6871
840,Durham,8403506,St Josephs Roman Catholic Voluntary Aided Primary School Blackhall,60,16600,9683,6917
840,Durham,8403507,Our Lady Star of the Sea Roman Catholic Voluntary Aided Primary,96,16960,9893,7067
840,Durham,8403510,Our Lady of the Rosary Roman Catholic Voluntary Aided Primary,237,18370,10716,7654
840,Durham,8403511,Blessed John Duckett Roman Catholic Voluntary Aided Primary,50,16500,9625,6875
840,Durham,8403513,St Johns Church of England Aided Primary School Shildon,177,17770,10366,7404
840,Durham,8403516,Prince Bishops Community Primary School,163,17630,10284,7346
840,Durham,8403518,Woodham Burn Community Primary School,187,17870,10424,7446
840,Durham,8403519,Silver Tree Primary School,157,17570,10249,7321
840,Durham,8403520,Seaview Primary School,250,18500,10792,7708
840,Durham,8403522,Tanfield Lea Community Primary School,241,18410,10739,7671
840,Durham,8403523,Woodhouse Community Primary School,173,17730,10343,7387
840,Durham,8403524,Seaham Trinity Primary School,329,19290,11253,8037
840,Durham,8403525,Brandon Primary School,226,18260,10652,7608
840,Durham,8403527,Shotton Hall Primary School,297,18970,11066,7904
840,Durham,8407013,Croft Community School,46,16460,9602,6858
840,Durham,8407014,Walworth School,68,16680,9730,6950
840,Durham,8407028,Villa Real School,48,16480,9613,6867
840,Durham,8407032,Durham Trinity School & Sports College,88,16880,9847,7033
840,Durham,8407034,Evergreen Primary School,162,17620,10278,7342
841,Darlington,8412669,Red Hall Primary School,143,17430,10168,7262
841,Darlington,8413309,St Teresas RC Primary School,257,18570,10833,7737
841,Darlington,8413515,Whinfield Primary School,514,21140,12332,8808
841,Darlington,8413517,Harrowgate Hill Primary School,514,21140,12332,8808
845,East Sussex,8452005,Peacehaven Heights Primary School,345,19450,11346,8104
845,East Sussex,8452050,Alfriston School,90,16900,9858,7042
845,East Sussex,8452054,Brede Primary School,106,17060,9952,7108
845,East Sussex,8452055,Broad Oak Community Primary School,103,17030,9934,7096
845,East Sussex,8452056,Chiddingly Primary School,87,16870,9841,7029
845,East Sussex,8452057,Ashdown Primary School,381,19810,11556,8254
845,East Sussex,8452059,Grovelands Community Primary School,542,21420,12495,8925
845,East Sussex,8452060,Hamsey Community Primary School,80,16800,9800,7000
845,East Sussex,8452061,Hankham Primary School,125,17250,10063,7187
845,East Sussex,8452062,Hellingly Community Primary School,209,18090,10553,7537
845,East Sussex,8452071,Laughton Community Primary School,86,16860,9835,7025
845,East Sussex,8452072,Wallands Community Primary School,372,19720,11503,8217
845,East Sussex,8452073,Western Road Community Primary School,175,17750,10354,7396
845,East Sussex,8452074,Maynards Green Community Primary School,187,17870,10424,7446
845,East Sussex,8452076,Park Mead Primary School,104,17040,9940,7100
845,East Sussex,8452078,Plumpton Primary School,88,16880,9847,7033
845,East Sussex,8452082,Punnetts Town Community Primary School,86,16860,9835,7025
845,East Sussex,8452083,Ringmer Primary and Nursery School,224,18240,10640,7600
845,East Sussex,8452084,Rotherfield Primary School,174,17740,10348,7392
845,East Sussex,8452087,Seaford Primary School,415,20150,11754,8396
845,East Sussex,8452088,Telscombe Cliffs Community Primary School,529,21290,12419,8871
845,East Sussex,8452089,Westfield School,184,17840,10407,7433
845,East Sussex,8452090,Willingdon Primary School,395,19950,11638,8312
845,East Sussex,8452091,St Michaels Primary School,75,16750,9771,6979
845,East Sussex,8452092,Wivelsfield Primary School,163,17630,10284,7346
845,East Sussex,8452094,Chyngton School,367,19670,11474,8196
845,East Sussex,8452095,Chantry Community Primary School,179,17790,10378,7412
845,East Sussex,8452099,Little Common School,539,21390,12478,8912
845,East Sussex,8452103,Denton Community Primary School and Nursery,215,18150,10588,7562
845,East Sussex,8452104,Cradle Hill Community Primary School,412,20120,11737,8383
845,East Sussex,8452105,Polegate Primary School,392,19920,11620,8300
845,East Sussex,8452107,Manor Primary School,346,19460,11352,8108
845,East Sussex,8452112,Harbour Primary and Nursery School,395,19950,11638,8312
845,East Sussex,8452120,Sandown Primary School,395,19950,11638,8312
845,East Sussex,8452131,Tollgate Community Junior School,434,20340,11865,8475
845,East Sussex,8452135,Roselands Infants School,180,17800,10383,7417
845,East Sussex,8452136,Motcombe Infants School,251,18510,10798,7712
845,East Sussex,8452137,Pashley Down Infant School,176,17760,10360,7400
845,East Sussex,8452142,West Rise Community Infant School,181,17810,10389,7421
845,East Sussex,8452143,West Rise Junior School,333,19330,11276,8054
845,East Sussex,8452145,Stafford Junior School,383,19830,11568,8262
845,East Sussex,8452149,Rocks Park Primary School,180,17800,10383,7417
845,East Sussex,8452151,Bourne Primary School,372,19720,11503,8217
845,East Sussex,8452153,Meridian Community Primary School and Nursery,372,19720,11503,8217
845,East Sussex,8452160,Parkside Community Primary School,179,17790,10378,7412
845,East Sussex,8452162,Stone Cross School,365,19650,11463,8187
845,East Sussex,8452166,Harlands Primary School,174,17740,10348,7392
845,East Sussex,8452169,The Haven Voluntary Aided CofE/Methodist Primary School,378,19780,11538,8242
845,East Sussex,8453002,Barcombe Church of England Primary School,110,17100,9975,7125
845,East Sussex,8453003,Battle and Langton Church of England Primary School,405,20050,11696,8354
845,East Sussex,8453004,Beckley Church of England Primary School,90,16900,9858,7042
845,East Sussex,8453006,All Saints Church of England Primary School Bexhill,177,17770,10366,7404
845,East Sussex,8453009,Burwash CofE School,157,17570,10249,7321
845,East Sussex,8453011,Buxted CofE Primary School,165,17650,10296,7354
845,East Sussex,8453012,Catsfield Church of England Primary School,96,16960,9893,7067
845,East Sussex,8453013,Chailey St Peters Church of England Primary School,123,17230,10051,7179
845,East Sussex,8453015,Cross-in-Hand Church of England Primary School,241,18410,10739,7671
845,East Sussex,8453016,Crowhurst CofE Primary School,99,16990,9911,7079
845,East Sussex,8453017,Dallington Church of England Primary School,91,16910,9864,7046
845,East Sussex,8453018,Danehill Church of England Primary School,66,16660,9718,6942
845,East Sussex,8453019,Ditchling (St Margarets) Church of England Primary School,130,17300,10092,7208
845,East Sussex,8453022,East Hoathly CofE Primary School,86,16860,9835,7025
845,East Sussex,8453023,Etchingham Church of England Primary School,91,16910,9864,7046
845,East Sussex,8453026,Fletching Church of England Primary School,58,16580,9672,6908
845,East Sussex,8453028,Forest Row Church of England Primary School,183,17830,10401,7429
845,East Sussex,8453029,Frant Church of England Primary School,91,16910,9864,7046
845,East Sussex,8453032,Herstmonceux Church of England Primary School,176,17760,10360,7400
845,East Sussex,8453033,High Hurstwood Church of England Primary School,88,16880,9847,7033
845,East Sussex,8453035,Hurst Green Church of England Primary School and Nursery,93,16930,9876,7054
845,East Sussex,8453040,South Malling CofE Primary and Nursery School,240,18400,10733,7667
845,East Sussex,8453041,Southover CofE Primary School,348,19480,11363,8117
845,East Sussex,8453042,Bonners CofE School,95,16950,9888,7062
845,East Sussex,8453043,Mayfield Church of England Primary School,128,17280,10080,7200
845,East Sussex,8453045,Netherfield CofE Primary School,121,17210,10039,7171
845,East Sussex,8453046,Ninfield Church of England Primary School,133,17330,10109,7221
845,East Sussex,8453047,Northiam Church of England Primary School,77,16770,9783,6987
845,East Sussex,8453048,Nutley Church of England Primary School,76,16760,9777,6983
845,East Sussex,8453049,Peasmarsh Church of England Primary School,75,16750,9771,6979
845,East Sussex,8453050,Pevensey and Westham CofE Primary School,349,19490,11369,8121
845,East Sussex,8453051,St Michaels Church of England Primary School,86,16860,9835,7025
845,East Sussex,8453055,Salehurst Church of England Primary School,175,17750,10354,7396
845,East Sussex,8453058,Sedlescombe CofE Primary School,190,17900,10442,7458
845,East Sussex,8453062,Stonegate Church of England Primary School,88,16880,9847,7033
845,East Sussex,8453063,Ticehurst and Flimwell Church of England Primary School,94,16940,9882,7058
845,East Sussex,8453068,Firle Church of England Primary School,76,16760,9777,6983
845,East Sussex,8453071,Five Ashes CofE Primary School,35,16350,9538,6812
845,East Sussex,8453072,Icklesham Church of England Primary School,105,17050,9946,7104
845,East Sussex,8453074,Newick Church of England Primary School,189,17890,10436,7454
845,East Sussex,8453076,Bodiam Church of England Primary School,91,16910,9864,7046
845,East Sussex,8453077,Iford and Kingston Church of England Primary School,176,17760,10360,7400
845,East Sussex,8453080,Staplecross Methodist Primary School,91,16910,9864,7046
845,East Sussex,8453081,Wadhurst CofE Primary School,260,18600,10850,7750
845,East Sussex,8453092,St Andrews Church of England Infants School,179,17790,10378,7412
845,East Sussex,8453320,Blackboys Church of England Primary School,96,16960,9893,7067
845,East Sussex,8453322,St Johns Church of England Primary School,179,17790,10378,7412
845,East Sussex,8453323,Framfield Church of England Primary School,89,16890,9853,7037
845,East Sussex,8453324,Guestling Bradshaw Church of England Primary School,189,17890,10436,7454
845,East Sussex,8453325,St Marks Church of England Primary School,74,16740,9765,6975
845,East Sussex,8453326,St Mary the Virgin Church of England Primary School,80,16800,9800,7000
845,East Sussex,8453327,All Saints and St Richards Church of England Primary School,77,16770,9783,6987
845,East Sussex,8453330,Little Horsted Church of England Primary School,91,16910,9864,7046
845,East Sussex,8453331,Mark Cross Church of England Aided Primary School,88,16880,9847,7033
845,East Sussex,8453332,Groombridge St Thomas Church of England Primary School,177,17770,10366,7404
845,East Sussex,8453335,Holy Cross Church of England Primary School,101,17010,9923,7087
845,East Sussex,8453336,St Thomas Church of England Aided Primary School,131,17310,10098,7212
845,East Sussex,8453338,St Peter and St Paul CofE Primary School,361,19610,11439,8171
845,East Sussex,8453339,St Mary Magdalene Catholic Primary School,217,18170,10599,7571
845,East Sussex,8453340,St Marys Catholic Primary School,172,17720,10337,7383
845,East Sussex,8453342,St Pancras Catholic Primary School,114,17140,9998,7142
845,East Sussex,8453343,St Philips Catholic Primary School,177,17770,10366,7404
845,East Sussex,8453353,St Mary Star of the Sea Catholic Primary School,194,17940,10465,7475
845,East Sussex,8453354,Sacred Heart Catholic Primary School Hastings,177,17770,10366,7404
845,East Sussex,8453360,St Johns Meads Church of England Primary School,191,17910,10448,7462
845,East Sussex,8453362,St Thomas A Becket Catholic Primary School,417,20170,11766,8404
845,East Sussex,8457021,Grove Park School,43,16430,9584,6846
846,Brighton and Hove,8461105,Brighton and Hove Pupil Referral Unit,15,15000,8750,6250
846,Brighton and Hove,8462001,Carden Nursery and Primary School,282,18820,10978,7842
846,Brighton and Hove,8462002,Moulsecoomb Primary School,218,18180,10605,7575
846,Brighton and Hove,8462007,Coombe Road Primary School,172,17720,10337,7383
846,Brighton and Hove,8462009,Downs Junior School,511,21110,12314,8796
846,Brighton and Hove,8462010,Downs Infant School,239,18390,10728,7662
846,Brighton and Hove,8462017,Hertford Infant and Nursery School,101,17010,9923,7087
846,Brighton and Hove,8462018,Middle Street Primary School,179,17790,10378,7412
846,Brighton and Hove,8462021,Patcham Junior School,371,19710,11498,8212
846,Brighton and Hove,8462022,Patcham Infant School,174,17740,10348,7392
846,Brighton and Hove,8462026,St Lukes Primary School,538,21380,12472,8908
846,Brighton and Hove,8462028,Stanford Junior School,341,19410,11323,8087
846,Brighton and Hove,8462029,Stanford Infant School,174,17740,10348,7392
846,Brighton and Hove,8462036,Westdene Primary School,574,21740,12682,9058
846,Brighton and Hove,8462037,Carlton Hill Primary School,181,17810,10389,7421
846,Brighton and Hove,8462040,Balfour Primary School,735,23350,13621,9729
846,Brighton and Hove,8462043,Hertford Junior School,182,17820,10395,7425
846,Brighton and Hove,8462044,Coldean Primary School,313,19130,11159,7971
846,Brighton and Hove,8462065,Goldstone Primary School,583,21830,12734,9096
846,Brighton and Hove,8462066,Hangleton Primary School,536,21360,12460,8900
846,Brighton and Hove,8462070,Hove Junior School,820,24200,14117,10083
846,Brighton and Hove,8462079,St Peters Community Primary School,154,17540,10232,7308
846,Brighton and Hove,8462080,Benfield Primary School,209,18090,10553,7537
846,Brighton and Hove,8462081,Brackenbury Primary School,168,17680,10313,7367
846,Brighton and Hove,8462093,West Blatchington Primary and Nursery School,202,18020,10512,7508
846,Brighton and Hove,8462096,West Hove Infant School,435,20350,11871,8479
846,Brighton and Hove,8462100,Mile Oak Primary School,457,20570,11999,8571
846,Brighton and Hove,8462114,Peter Gladwin Primary School,158,17580,10255,7325
846,Brighton and Hove,8462119,Brunswick Primary School,774,23740,13848,9892
846,Brighton and Hove,8462155,Elm Grove Primary School,370,19700,11492,8208
846,Brighton and Hove,8462156,Queens Park Primary School,351,19510,11381,8129
846,Brighton and Hove,8462157,Saltdean Primary School,467,20670,12058,8612
846,Brighton and Hove,8462158,Woodingdean Primary School,343,19430,11334,8096
846,Brighton and Hove,8462163,Bevendean Primary School,291,18910,11031,7879
846,Brighton and Hove,8462164,Rudyard Kipling Primary School & Nursery,320,19200,11200,8000
846,Brighton and Hove,8462165,Fairlight Primary School,330,19300,11258,8042
846,Brighton and Hove,8463304,St Margarets CofE Primary School Rottingdean,177,17770,10366,7404
846,Brighton and Hove,8463305,St Bartholomews CofE Primary School,143,17430,10168,7262
846,Brighton and Hove,8463308,St Martins CofE Primary School,169,17690,10319,7371
846,Brighton and Hove,8463311,St John the Baptist Catholic Primary School,176,17760,10360,7400
846,Brighton and Hove,8463313,St Mary Magdalen Catholic Primary School,168,17680,10313,7367
846,Brighton and Hove,8463314,St Josephs Catholic Primary School,126,17260,10068,7192
846,Brighton and Hove,8463315,St Pauls CofE Primary School and Nursery,173,17730,10343,7387
846,Brighton and Hove,8463316,Our Lady of Lourdes RC School,170,17700,10325,7375
846,Brighton and Hove,8463317,St Marks CofE Primary School,159,17590,10261,7329
846,Brighton and Hove,8463318,St Bernadettes Catholic Primary School,187,17870,10424,7446
846,Brighton and Hove,8463328,Aldrington CofE Primary School,314,19140,11165,7975
846,Brighton and Hove,8463329,St Andrews CofE (Aided) Primary School,466,20660,12052,8608
846,Brighton and Hove,8463333,St Nicolas CofE Primary School,328,19280,11247,8033
846,Brighton and Hove,8463341,Cottesmore St Marys Catholic Primary School,373,19730,11509,8221
846,Brighton and Hove,8463344,St Marys Catholic Primary School,181,17810,10389,7421
846,Brighton and Hove,8467006,Downs View Special School,51,16510,9631,6879
846,Brighton and Hove,8467018,Hill Park School,75,16750,9771,6979
850,Hampshire,8502000,Alton Infant School,110,17100,9975,7125
850,Hampshire,8502001,Anstey Junior School,249,18490,10786,7704
850,Hampshire,8502002,Balksbury Junior School,351,19510,11381,8129
850,Hampshire,8502003,Portway Junior School,378,19780,11538,8242
850,Hampshire,8502004,Anton Junior School,257,18570,10833,7737
850,Hampshire,8502005,Ashley Infant School,134,17340,10115,7225
850,Hampshire,8502006,Awbridge Primary School,126,17260,10068,7192
850,Hampshire,8502007,Portway Infant School,182,17820,10395,7425
850,Hampshire,8502008,Winklebury Junior School,199,17990,10494,7496
850,Hampshire,8502009,Knightwood Primary School,363,19630,11451,8179
850,Hampshire,8502010,Wellington Community Primary School,346,19460,11352,8108
850,Hampshire,8502011,Great Binfields Primary School,295,18950,11054,7896
850,Hampshire,8502012,Oakridge Infant School,175,17750,10354,7396
850,Hampshire,8502013,South View Junior School,225,18250,10646,7604
850,Hampshire,8502014,Beaulieu Village Primary School,94,16940,9882,7058
850,Hampshire,8502015,Elvetham Heath Primary School,544,21440,12507,8933
850,Hampshire,8502016,Cherrywood Community Primary School,161,17610,10273,7337
850,Hampshire,8502017,Micheldever CofE Primary School,85,16850,9829,7021
850,Hampshire,8502018,Stoke Park Infant School,169,17690,10319,7371
850,Hampshire,8502019,Bishops Waltham Infant School,120,17200,10033,7167
850,Hampshire,8502020,Sharps Copse Primary and Nursery School,264,18640,10873,7767
850,Hampshire,8502022,Bordon Infant School,120,17200,10033,7167
850,Hampshire,8502023,Braishfield Primary School,82,16820,9812,7008
850,Hampshire,8502025,Broughton Primary School,86,16860,9835,7025
850,Hampshire,8502026,Burghclere Primary School,97,16970,9899,7071
850,Hampshire,8502027,Buriton Primary School,78,16780,9788,6992
850,Hampshire,8502028,Burley Primary School,92,16920,9870,7050
850,Hampshire,8502030,Stoke Park Junior School,368,19680,11480,8200
850,Hampshire,8502031,Cornerstone CofE (VA) Primary School,131,17310,10098,7212
850,Hampshire,8502033,Chandlers Ford Infant School,121,17210,10039,7171
850,Hampshire,8502034,Merdon Junior School,261,18610,10856,7754
850,Hampshire,8502035,Cheriton Primary School,84,16840,9823,7017
850,Hampshire,8502036,North Baddesley Infant School,149,17490,10203,7287
850,Hampshire,8502040,Clanfield Junior School,268,18680,10897,7783
850,Hampshire,8502041,Cliddesden Primary School,93,16930,9876,7054
850,Hampshire,8502042,Manor Church of England Infant School,57,16570,9666,6904
850,Hampshire,8502046,Crondall Primary School,167,17670,10308,7362
850,Hampshire,8502047,Curdridge Primary School,92,16920,9870,7050
850,Hampshire,8502049,Crofton Anne Dale Junior School,379,19790,11544,8246
850,Hampshire,8502053,Droxford Junior School,165,17650,10296,7354
850,Hampshire,8502054,Denmead Infant School,178,17780,10372,7408
850,Hampshire,8502055,Wildground Junior School,196,17960,10477,7483
850,Hampshire,8502056,Fryern Junior School,236,18360,10710,7650
850,Hampshire,8502057,Wildground Infant School,88,16880,9847,7033
850,Hampshire,8502061,The Crescent Primary School,476,20760,12110,8650
850,Hampshire,8502062,Cherbourg Primary School,343,19430,11334,8096
850,Hampshire,8502063,Shakespeare Infant School,174,17740,10348,7392
850,Hampshire,8502067,Wallisdean Junior School,224,18240,10640,7600
850,Hampshire,8502069,Uplands Primary School,264,18640,10873,7767
850,Hampshire,8502071,Fair Oak Infant School,269,18690,10903,7787
850,Hampshire,8502074,Redlands Primary School,265,18650,10879,7771
850,Hampshire,8502076,Wallisdean Infant School,117,17170,10016,7154
850,Hampshire,8502085,Grateley Primary School,83,16830,9818,7012
850,Hampshire,8502086,Greatham Primary School,151,17510,10214,7296
850,Hampshire,8502089,Waterside Primary School,171,17710,10331,7379
850,Hampshire,8502090,Hale Primary School,87,16870,9841,7029
850,Hampshire,8502091,Hamble Primary School,282,18820,10978,7842
850,Hampshire,8502092,Hambledon Primary School,96,16960,9893,7067
850,Hampshire,8502094,Oakwood Infant School,168,17680,10313,7367
850,Hampshire,8502095,Fairfield Infant School,178,17780,10372,7408
850,Hampshire,8502100,Riders Junior School,308,19080,11130,7950
850,Hampshire,8502101,Riders Infant School,172,17720,10337,7383
850,Hampshire,8502103,Trosnant Junior School,225,18250,10646,7604
850,Hampshire,8502104,Trosnant Infant School,147,17470,10191,7279
850,Hampshire,8502105,Hawley Primary School,269,18690,10903,7787
850,Hampshire,8502106,Mill Rythe Junior School,294,18940,11048,7892
850,Hampshire,8502107,Barncroft Primary School,349,19490,11369,8121
850,Hampshire,8502111,Tiptoe Primary School,113,17130,9993,7137
850,Hampshire,8502113,Hythe Primary School,271,18710,10914,7796
850,Hampshire,8502115,Freegrounds Infant School,179,17790,10378,7412
850,Hampshire,8502116,Bosmere Junior School,356,19560,11410,8150
850,Hampshire,8502117,Itchen Abbas Primary School,78,16780,9788,6992
850,Hampshire,8502119,Ashford Hill Primary School,110,17100,9975,7125
850,Hampshire,8502120,Kings Worthy Primary School,366,19660,11468,8192
850,Hampshire,8502125,Langrish Primary School,180,17800,10383,7417
850,Hampshire,8502127,Liss Junior School,216,18160,10593,7567
850,Hampshire,8502128,Locks Heath Junior School,480,20800,12133,8667
850,Hampshire,8502137,New Milton Infant School,177,17770,10366,7404
850,Hampshire,8502140,New Milton Junior School,368,19680,11480,8200
850,Hampshire,8502147,Newtown Soberton Infant School,45,16450,9596,6854
850,Hampshire,8502148,North Waltham Primary School,141,17410,10156,7254
850,Hampshire,8502155,Buryfields Infant School,140,17400,10150,7250
850,Hampshire,8502157,Owslebury Primary School,73,16730,9759,6971
850,Hampshire,8502161,Northern Junior School,165,17650,10296,7354
850,Hampshire,8502162,Petersfield Infant School,236,18360,10710,7650
850,Hampshire,8502167,Purbrook Infant School,178,17780,10372,7408
850,Hampshire,8502168,Wicor Primary School,378,19780,11538,8242
850,Hampshire,8502169,Springwood Infant School,97,16970,9899,7071
850,Hampshire,8502170,Herne Junior School,458,20580,12005,8575
850,Hampshire,8502175,Ringwood Junior School,377,19770,11533,8237
850,Hampshire,8502176,Cupernham Junior School,347,19470,11358,8112
850,Hampshire,8502180,St Mary Bourne Primary School,118,17180,10022,7158
850,Hampshire,8502181,Sheet Primary School,96,16960,9893,7067
850,Hampshire,8502182,Shipton Bellinger Primary School,150,17500,10208,7292
850,Hampshire,8502183,Sopley Primary School,92,16920,9870,7050
850,Hampshire,8502186,Stockbridge Primary School,104,17040,9940,7100
850,Hampshire,8502190,Tadley Community Primary School,305,19050,11113,7937
850,Hampshire,8502193,Titchfield Primary School,164,17640,10290,7350
850,Hampshire,8502194,Lydlynch Infant School,116,17160,10010,7150
850,Hampshire,8502196,Eling Infant School and Nursery,77,16770,9783,6987
850,Hampshire,8502197,Foxhills Junior School,354,19540,11398,8142
850,Hampshire,8502200,Wallop Primary School,117,17170,10016,7154
850,Hampshire,8502202,Wellow School,174,17740,10348,7392
850,Hampshire,8502203,Wherwell Primary School,119,17190,10028,7162
850,Hampshire,8502206,Stanmore Primary School,287,18870,11008,7862
850,Hampshire,8502211,Winnall Primary School,145,17450,10179,7271
850,Hampshire,8502213,Padnell Junior School,315,19150,11171,7979
850,Hampshire,8502214,Padnell Infant School,178,17780,10372,7408
850,Hampshire,8502215,Hart Plain Infant School,115,17150,10004,7146
850,Hampshire,8502216,Crofton Anne Dale Infant School,180,17800,10383,7417
850,Hampshire,8502217,Fryern Infant School,176,17760,10360,7400
850,Hampshire,8502220,Vigo Primary School,391,19910,11614,8296
850,Hampshire,8502223,Winklebury Infant School,117,17170,10016,7154
850,Hampshire,8502224,Shamblehurst Primary School,404,20040,11690,8350
850,Hampshire,8502226,Anton Infant School,120,17200,10033,7167
850,Hampshire,8502227,Oakridge Junior School,241,18410,10739,7671
850,Hampshire,8502228,South View Infant and Nursery School,133,17330,10109,7221
850,Hampshire,8502229,Church Crookham Junior School,503,21030,12268,8762
850,Hampshire,8502230,Orchard Infant School,180,17800,10383,7417
850,Hampshire,8502237,Hiltingbury Infant School,180,17800,10383,7417
850,Hampshire,8502238,Frogmore Infant School,93,16930,9876,7054
850,Hampshire,8502239,Horndean Infant School,182,17820,10395,7425
850,Hampshire,8502241,Pennington Infant School,116,17160,10010,7150
850,Hampshire,8502242,Westfields Junior School,387,19870,11591,8279
850,Hampshire,8502243,Wootey Infant School,99,16990,9911,7079
850,Hampshire,8502246,Mengham Infant School,137,17370,10133,7237
850,Hampshire,8502248,Orchard Junior School,399,19990,11661,8329
850,Hampshire,8502249,Locks Heath Infant School,239,18390,10728,7662
850,Hampshire,8502252,Harrison Primary School,538,21380,12472,8908
850,Hampshire,8502254,Warren Park Primary School,361,19610,11439,8171
850,Hampshire,8502255,Sun Hill Infant School,114,17140,9998,7142
850,Hampshire,8502257,Westfields Infant School,171,17710,10331,7379
850,Hampshire,8502263,Fair Oak Junior School,554,21540,12565,8975
850,Hampshire,8502265,North Baddesley Junior School,254,18540,10815,7725
850,Hampshire,8502266,Poulner Junior School,313,19130,11159,7971
850,Hampshire,8502267,Freegrounds Junior School,351,19510,11381,8129
850,Hampshire,8502268,Merton Junior School,280,18800,10967,7833
850,Hampshire,8502269,Heatherside Infant School,220,18200,10617,7583
850,Hampshire,8502270,Fleet Infant School,226,18260,10652,7608
850,Hampshire,8502271,Merton Infant School,156,17560,10243,7317
850,Hampshire,8502272,Castle Hill Primary School,339,19390,11311,8079
850,Hampshire,8502273,Bishops Waltham Junior School,230,18300,10675,7625
850,Hampshire,8502274,Hiltingbury Junior School,385,19850,11579,8271
850,Hampshire,8502276,Crofton Hammond Infant School,120,17200,10033,7167
850,Hampshire,8502278,Heatherside Junior School,379,19790,11544,8246
850,Hampshire,8502282,Sarisbury Infant School,182,17820,10395,7425
850,Hampshire,8502283,Bishopswood Junior School,230,18300,10675,7625
850,Hampshire,8502284,Knights Enham Junior School,220,18200,10617,7583
850,Hampshire,8502285,Manor Field Junior School,186,17860,10418,7442
850,Hampshire,8502286,Kempshott Junior School,360,19600,11433,8167
850,Hampshire,8502287,Marnel Junior School,393,19930,11626,8304
850,Hampshire,8502288,Weyford Nursery and Primary School,320,19200,11200,8000
850,Hampshire,8502289,Ranvilles Junior School,235,18350,10704,7646
850,Hampshire,8502290,Tweseldown Infant School,237,18370,10716,7654
850,Hampshire,8502291,Liss Infant School,115,17150,10004,7146
850,Hampshire,8502297,Purbrook Junior School,379,19790,11544,8246
850,Hampshire,8502298,Marnel Community Infant School,240,18400,10733,7667
850,Hampshire,8502299,Foxhills Infant School,175,17750,10354,7396
850,Hampshire,8502300,The Butts Primary School,203,18030,10518,7512
850,Hampshire,8502301,Knights Enham Nursery and Infant School,119,17190,10028,7162
850,Hampshire,8502304,Bursledon Junior School(CA),260,18600,10850,7750
850,Hampshire,8502306,Ranvilles Infant School,121,17210,10039,7171
850,Hampshire,8502309,Northern Infant School,105,17050,9946,7104
850,Hampshire,8502310,Poulner Infant School,139,17390,10144,7246
850,Hampshire,8502312,Halterworth Community Primary School,378,19780,11538,8242
850,Hampshire,8502313,Park Gate Primary School,354,19540,11398,8142
850,Hampshire,8502314,South Wonston Primary School,279,18790,10961,7829
850,Hampshire,8502315,Bishopswood Infant School,140,17400,10150,7250
850,Hampshire,8502316,Kempshott Infant School,179,17790,10378,7412
850,Hampshire,8502317,Wootey Junior School,184,17840,10407,7433
850,Hampshire,8502318,Roman Way Primary School,226,18260,10652,7608
850,Hampshire,8502319,Old Basing Infant School,178,17780,10372,7408
850,Hampshire,8502320,Rucstall Primary School,185,17850,10413,7437
850,Hampshire,8502321,Castle Hill Infant School,120,17200,10033,7167
850,Hampshire,8502322,Scantabout Primary School,187,17870,10424,7446
850,Hampshire,8502323,Denmead Junior School,283,18830,10984,7846
850,Hampshire,8502324,Tavistock Infant School,171,17710,10331,7379
850,Hampshire,8502325,Hook Junior School,391,19910,11614,8296
850,Hampshire,8502326,Olivers Battery Primary School,191,17910,10448,7462
850,Hampshire,8502328,Oakley Infant School,119,17190,10028,7162
850,Hampshire,8502329,Cupernham Infant School,176,17760,10360,7400
850,Hampshire,8502330,Calmore Infant School,120,17200,10033,7167
850,Hampshire,8502332,Lymington Junior School,256,18560,10827,7733
850,Hampshire,8502335,Mengham Junior School,198,17980,10488,7492
850,Hampshire,8502336,Bidbury Junior School,223,18230,10634,7596
850,Hampshire,8502339,Velmead Junior School,394,19940,11632,8308
850,Hampshire,8502341,Manor Field Infant School,111,17110,9981,7129
850,Hampshire,8502342,Liphook Infant School,180,17800,10383,7417
850,Hampshire,8502344,Chalk Ridge Primary School,334,19340,11282,8058
850,Hampshire,8502345,Crofton Hammond Junior School,239,18390,10728,7662
850,Hampshire,8502346,Potley Hill Primary School,264,18640,10873,7767
850,Hampshire,8502347,Kings Copse Primary School,175,17750,10354,7396
850,Hampshire,8502348,Netley Abbey Junior School,323,19230,11218,8012
850,Hampshire,8502354,Balksbury Infant School,179,17790,10378,7412
850,Hampshire,8502357,Petersgate Infant School,140,17400,10150,7250
850,Hampshire,8502361,Springwood Junior School,172,17720,10337,7383
850,Hampshire,8502367,Fordingbridge Junior School,247,18470,10774,7696
850,Hampshire,8502372,Fordingbridge Infant School,94,16940,9882,7058
850,Hampshire,8502373,Netley Abbey Infant School,175,17750,10354,7396
850,Hampshire,8502376,Greenfields Junior School,265,18650,10879,7771
850,Hampshire,8502377,Shakespeare Junior School,360,19600,11433,8167
850,Hampshire,8502378,Marchwood Junior School,308,19080,11130,7950
850,Hampshire,8502382,Colden Common Primary School,295,18950,11054,7896
850,Hampshire,8502383,Mayhill Junior School,217,18170,10599,7571
850,Hampshire,8502384,Woolton Hill Junior School,180,17800,10383,7417
850,Hampshire,8502387,Norwood Primary School,257,18570,10833,7737
850,Hampshire,8502388,Red Barn Community Primary School,209,18090,10553,7537
850,Hampshire,8502389,Newlands Primary School,177,17770,10366,7404
850,Hampshire,8502392,Four Lanes Infant School,203,18030,10518,7512
850,Hampshire,8502395,Castle Primary School,361,19610,11439,8171
850,Hampshire,8502396,Bidbury Infant School,117,17170,10016,7154
850,Hampshire,8502470,Hatch Warren Infant School,178,17780,10372,7408
850,Hampshire,8502510,Cove Junior School,291,18910,11031,7879
850,Hampshire,8502511,Cove Infant School,120,17200,10033,7167
850,Hampshire,8502512,Tower Hill Primary School,259,18590,10844,7746
850,Hampshire,8502516,Marlborough Infant School,78,16780,9788,6992
850,Hampshire,8502517,South Farnborough Infant School,179,17790,10378,7412
850,Hampshire,8502519,North Farnborough Infant School,128,17280,10080,7200
850,Hampshire,8502520,Manor Junior School,344,19440,11340,8100
850,Hampshire,8502521,Grange Community Junior School,227,18270,10658,7612
850,Hampshire,8502523,Talavera Junior School,337,19370,11299,8071
850,Hampshire,8502524,Manor Infant School,179,17790,10378,7412
850,Hampshire,8502526,Talavera Infant School,185,17850,10413,7437
850,Hampshire,8502530,Parsonage Farm Nursery and Infant School,111,17110,9981,7129
850,Hampshire,8502531,South Farnborough Junior School,396,19960,11643,8317
850,Hampshire,8502533,Guillemont Junior School,307,19070,11124,7946
850,Hampshire,8502534,Pinewood Infant School,65,16650,9713,6937
850,Hampshire,8502606,Elson Junior School,357,19570,11416,8154
850,Hampshire,8502607,Elson Infant School,179,17790,10378,7412
850,Hampshire,8502610,Lee-on-the-Solent Junior School,358,19580,11422,8158
850,Hampshire,8502612,Haselworth Primary School,108,17080,9963,7117
850,Hampshire,8502613,Woodcot Primary School,172,17720,10337,7383
850,Hampshire,8502617,Rowner Infant School,112,17120,9987,7133
850,Hampshire,8502618,Alverstoke Community Infant School,124,17240,10057,7183
850,Hampshire,8502619,Grange Junior School,302,19020,11095,7925
850,Hampshire,8502620,Grange Infant School,155,17550,10238,7312
850,Hampshire,8502621,Alver Valley Junior School,143,17430,10168,7262
850,Hampshire,8502622,Peel Common Infant School and Nursery Unit,115,17150,10004,7146
850,Hampshire,8502623,Alver Valley Infant and Nursery School,95,16950,9888,7062
850,Hampshire,8502624,Peel Common Junior School,207,18070,10541,7529
850,Hampshire,8502625,Gomer Infant School,120,17200,10033,7167
850,Hampshire,8502627,Brockhurst Primary School,313,19130,11159,7971
850,Hampshire,8502630,Lee-On-the-Solent Infant and Nursery School,181,17810,10389,7421
850,Hampshire,8502717,Orchard Lea Infant School,119,17190,10028,7162
850,Hampshire,8502718,Orchard Lea Junior School,235,18350,10704,7646
850,Hampshire,8502722,Wellstead Primary School,301,19010,11089,7921
850,Hampshire,8502723,Hook Infant School,191,17910,10448,7462
850,Hampshire,8502725,Kings Furlong Infant School and Nursery,176,17760,10360,7400
850,Hampshire,8502726,Kings Furlong Junior School,262,18620,10862,7758
850,Hampshire,8502727,Fairfields Primary School,352,19520,11387,8133
850,Hampshire,8502728,Park Primary School,180,17800,10383,7417
850,Hampshire,8502729,Alderwood School,524,21240,12390,8850
850,Hampshire,8502732,Park View Primary School,413,20130,11743,8387
850,Hampshire,8502735,Fernhill Primary School,119,17190,10028,7162
850,Hampshire,8502736,Harestock Primary School,220,18200,10617,7583
850,Hampshire,8502737,Weeke Primary School,356,19560,11410,8150
850,Hampshire,8502739,Hazel Wood Infant School,158,17580,10255,7325
850,Hampshire,8502740,Hart Plain Junior School,211,18110,10564,7546
850,Hampshire,8502742,Southwood Infant School,73,16730,9759,6971
850,Hampshire,8502749,Four Lanes Community Junior School,325,19250,11229,8021
850,Hampshire,8502750,Queens Inclosure Primary School,358,19580,11422,8158
850,Hampshire,8502752,Berrywood Primary School,550,21500,12542,8958
850,Hampshire,8502753,Woodlea Primary School,141,17410,10156,7254
850,Hampshire,8502761,Hatch Warren Junior School,342,19420,11328,8092
850,Hampshire,8502763,Nightingale Primary School,384,19840,11573,8267
850,Hampshire,8502767,Emsworth Primary School,236,18360,10710,7650
850,Hampshire,8502774,Morelands Primary School,275,18750,10938,7812
850,Hampshire,8502775,Mill Hill Primary School,124,17240,10057,7183
850,Hampshire,8502776,Bedenham Primary School,246,18460,10768,7692
850,Hampshire,8502777,Holbrook Primary School,216,18160,10593,7567
850,Hampshire,8502778,Whiteley Primary School,534,21340,12448,8892
850,Hampshire,8503000,Abbotts Ann Church of England Primary School,98,16980,9905,7075
850,Hampshire,8503001,Saint Lawrence Church of England Primary School,170,17700,10325,7375
850,Hampshire,8503003,Ampfield Church of England Primary School,51,16510,9631,6879
850,Hampshire,8503004,Andover Church of England Primary School,176,17760,10360,7400
850,Hampshire,8503009,Barton Stacey Church of England Primary School,99,16990,9911,7079
850,Hampshire,8503012,Binsted Church of England Primary School,94,16940,9882,7058
850,Hampshire,8503014,Botley Church of England Controlled Primary School,296,18960,11060,7900
850,Hampshire,8503018,Breamore Church of England Primary School,102,17020,9928,7092
850,Hampshire,8503019,Brockenhurst Church of England Primary School,183,17830,10401,7429
850,Hampshire,8503020,Bursledon Church of England Infant School,159,17590,10261,7329
850,Hampshire,8503022,Bramley Church of England Primary School,318,19180,11188,7992
850,Hampshire,8503023,Bentley Church of England Primary School,181,17810,10389,7421
850,Hampshire,8503027,Catherington Church of England Infant School,58,16580,9672,6908
850,Hampshire,8503029,Chawton Church of England Primary School,94,16940,9882,7058
850,Hampshire,8503032,Copythorne CofE Infant School,55,16550,9654,6896
850,Hampshire,8503040,Durley Church of England Controlled Primary School,103,17030,9934,7096
850,Hampshire,8503046,East Meon Church of England Controlled Primary School,79,16790,9794,6996
850,Hampshire,8503050,Ecchinswell and Sydmonton Church of England Primary School,76,16760,9777,6983
850,Hampshire,8503052,St James Church of England Controlled Primary School,199,17990,10494,7496
850,Hampshire,8503061,Four Marks Church of England Primary School,257,18570,10833,7737
850,Hampshire,8503062,Froxfield Church of England Primary School,82,16820,9812,7008
850,Hampshire,8503067,Grayshott Church of England Controlled Primary School,177,17770,10366,7404
850,Hampshire,8503081,Horndean Church of England Junior School,489,20890,12186,8704
850,Hampshire,8503082,Hurstbourne Tarrant Church of England Primary School,93,16930,9876,7054
850,Hampshire,8503083,Hyde Church of England Primary School,39,16390,9561,6829
850,Hampshire,8503088,Kingsclere Church of England Primary School,223,18230,10634,7596
850,Hampshire,8503089,Kings Somborne Church of England Primary School,68,16680,9730,6950
850,Hampshire,8503095,St John the Baptist Church of England Primary School,338,19380,11305,8075
850,Hampshire,8503096,Long Sutton Church of England Primary School,109,17090,9969,7121
850,Hampshire,8503100,Marchwood Church of England Infant School,160,17600,10267,7333
850,Hampshire,8503101,Medstead Church of England Primary School,178,17780,10372,7408
850,Hampshire,8503102,Meonstoke Church of England Infant School,52,16520,9637,6883
850,Hampshire,8503110,Netley Marsh Church of England Infant School,59,16590,9678,6912
850,Hampshire,8503112,Nursling Church of England Primary School,165,17650,10296,7354
850,Hampshire,8503118,Otterbourne Church of England Primary School,195,17950,10471,7479
850,Hampshire,8503119,Overton Church of England Primary School,354,19540,11398,8142
850,Hampshire,8503120,Oakley Church of England Junior School,258,18580,10838,7742
850,Hampshire,8503124,Pennington Church of England Junior School,173,17730,10343,7387
850,Hampshire,8503126,Preston Candover Church of England Primary School,123,17230,10051,7179
850,Hampshire,8503132,Ringwood Church of England Infant School,179,17790,10378,7412
850,Hampshire,8503136,Rowlands Castle St Johns Church of England Controlled Primary School,179,17790,10378,7412
850,Hampshire,8503137,Rownhams St Johns Church of England Primary School,269,18690,10903,7787
850,Hampshire,8503138,Ropley Church of England Primary School,144,17440,10173,7267
850,Hampshire,8503142,Sarisbury Church of England Junior School,369,19690,11486,8204
850,Hampshire,8503143,St John the Baptist Church of England Primary School,243,18430,10751,7679
850,Hampshire,8503144,Sherborne St John Church of England Primary School,99,16990,9911,7079
850,Hampshire,8503146,South Baddesley Church of England Primary School,117,17170,10016,7154
850,Hampshire,8503147,Sparsholt Church of England Primary School,117,17170,10016,7154
850,Hampshire,8503149,St Lukes Church of England Primary School,179,17790,10378,7412
850,Hampshire,8503150,Steep Church of England Voluntary Controlled Primary School,83,16830,9818,7012
850,Hampshire,8503156,Twyford St Marys Church of England Primary School,142,17420,10162,7258
850,Hampshire,8503163,Vernham Dean Gillums Church of England Primary School,62,16620,9695,6925
850,Hampshire,8503168,West Meon Church of England Voluntary Controlled Primary School,46,16460,9602,6858
850,Hampshire,8503169,West Tytherley Church of England Primary School,54,16540,9648,6892
850,Hampshire,8503170,Whitchurch Church of England Primary School,375,19750,11521,8229
850,Hampshire,8503171,Wickham Church of England Primary School,200,18000,10500,7500
850,Hampshire,8503172,All Saints Church of England Primary School,159,17590,10261,7329
850,Hampshire,8503176,Western Church of England Primary School,415,20150,11754,8396
850,Hampshire,8503177,St Thomas Church of England Infant School Woolton Hill,88,16880,9847,7033
850,Hampshire,8503181,St Bede Church of England Primary School,388,19880,11597,8283
850,Hampshire,8503183,Liphook Church of England Controlled Junior School,363,19630,11451,8179
850,Hampshire,8503184,Saint James Church of England Primary School,408,20080,11713,8367
850,Hampshire,8503185,St Michaels Church of England Controlled Infant School,173,17730,10343,7387
850,Hampshire,8503186,St Michaels Church of England Controlled Junior School,329,19290,11253,8037
850,Hampshire,8503190,Leesland Church of England Controlled Junior School,314,19140,11165,7975
850,Hampshire,8503191,Leesland Church of England Controlled Infant School,176,17760,10360,7400
850,Hampshire,8503192,Newtown Church of England Voluntary Controlled Primary School,322,19220,11212,8008
850,Hampshire,8503196,Rowledge Church of England Controlled Primary School,189,17890,10436,7454
850,Hampshire,8503197,Bartley Church of England Junior School,383,19830,11568,8262
850,Hampshire,8503199,Chiltern Primary School,192,17920,10453,7467
850,Hampshire,8503213,Whitewater Church of England Primary School,112,17120,9987,7133
850,Hampshire,8503300,Amport Church of England Primary School,79,16790,9794,6996
850,Hampshire,8503301,Appleshaw St Peters CofE Primary School,93,16930,9876,7054
850,Hampshire,8503305,St Marys Church of England Voluntary Aided Junior School,358,19580,11422,8158
850,Hampshire,8503308,St Marys Bentworth Church of England Primary School,94,16940,9882,7058
850,Hampshire,8503310,St Matthews Church of England Aided Primary School,166,17660,10302,7358
850,Hampshire,8503311,William Gilpin Church of England Primary School,111,17110,9981,7129
850,Hampshire,8503318,Compton All Saints Church of England Primary School,102,17020,9928,7092
850,Hampshire,8503321,Dogmersfield Church of England Primary School,114,17140,9998,7142
850,Hampshire,8503325,St Martins East Woodhay Church of England Voluntary Aided Primary School,111,17110,9981,7129
850,Hampshire,8503326,Charles Kingsleys Church of England Primary School,184,17840,10407,7433
850,Hampshire,8503330,All Saints Church of England Aided Junior School,514,21140,12332,8808
850,Hampshire,8503341,Hatherden Church of England Primary School,77,16770,9783,6987
850,Hampshire,8503344,Andrews Endowed Church of England Primary School,169,17690,10319,7371
850,Hampshire,8503345,John Keble Church of England Primary School,179,17790,10378,7412
850,Hampshire,8503346,St Albans Church of England Aided Primary School,193,17930,10459,7471
850,Hampshire,8503356,Lockerley Church of England Endowed Primary School,78,16780,9788,6992
850,Hampshire,8503357,Longparish Church of England Primary School,87,16870,9841,7029
850,Hampshire,8503358,Lymington Church of England Infant School,117,17170,10016,7154
850,Hampshire,8503360,St Michael and All Angels CofE Infant School,60,16600,9683,6917
850,Hampshire,8503382,Romsey Abbey Church of England Primary School,170,17700,10325,7375
850,Hampshire,8503389,Silchester Church of England Primary School,164,17640,10290,7350
850,Hampshire,8503390,Smannell and Enham Church of England (Aided) Primary School,87,16870,9841,7029
850,Hampshire,8503392,Swanmore Church of England Aided Primary School,357,19570,11416,8154
850,Hampshire,8503395,Upham Church of England Aided Primary School,78,16780,9788,6992
850,Hampshire,8503396,Clatford Church of England Primary School,175,17750,10354,7396
850,Hampshire,8503399,St Faiths Church of England Primary School,129,17290,10086,7204
850,Hampshire,8503401,Kimpton Thruxton and Fyfield Church of England Primary School,163,17630,10284,7346
850,Hampshire,8503404,St Judes Catholic Primary School,166,17660,10302,7358
850,Hampshire,8503407,St Thomas Mores Catholic Primary School Havant,274,18740,10932,7808
850,Hampshire,8503409,Our Lady and St Joseph Catholic Primary School,96,16960,9893,7067
850,Hampshire,8503414,St Annes Catholic Primary School,224,18240,10640,7600
850,Hampshire,8503415,St Bedes Catholic Primary School,358,19580,11422,8158
850,Hampshire,8503417,St Peters Catholic Primary School Winchester,359,19590,11428,8162
850,Hampshire,8503418,St John the Baptist Catholic Primary School Andover,184,17840,10407,7433
850,Hampshire,8503419,St Swithun Wells Catholic Primary School Chandlers Ford,201,18010,10506,7504
850,Hampshire,8503426,Western Downland Church of England Aided Primary School,161,17610,10273,7337
850,Hampshire,8503500,St Peters Church of England Aided Junior School,229,18290,10669,7621
850,Hampshire,8503501,St Marks Church of England Aided Primary School,93,16930,9876,7054
850,Hampshire,8503551,St Patricks Catholic Primary School,187,17870,10424,7446
850,Hampshire,8503553,St Bernadettes Catholic Primary School,292,18920,11037,7883
850,Hampshire,8503600,Alverstoke Church of England Aided Junior School,306,19060,11118,7942
850,Hampshire,8503602,St Johns Gosport Church of England Voluntary Aided Primary School,325,19250,11229,8021
850,Hampshire,8503650,St Marys Catholic Primary School,217,18170,10599,7571
850,Hampshire,8503660,Selborne Church of England Primary School,85,16850,9829,7021
850,Hampshire,8503661,St Johns Church of England Voluntary Aided Primary School,264,18640,10873,7767
850,Hampshire,8503663,St Francis Church of England Primary School,378,19780,11538,8242
850,Hampshire,8503665,St Marks Church of England Primary School,541,21410,12489,8921
850,Hampshire,8503666,Crookham Church of England Aided Infant School,120,17200,10033,7167
850,Hampshire,8503667,Cadland Primary School,305,19050,11113,7937
850,Hampshire,8503668,Romsey Primary School,174,17740,10348,7392
850,Hampshire,8503669,Burnham Copse Primary School,258,18580,10838,7742
850,Hampshire,8503670,Woodcroft Primary,151,17510,10214,7296
850,Hampshire,8503671,Cranford Park Primary,180,17800,10383,7417
850,Hampshire,8503672,Endeavour Primary School,342,19420,11328,8092
850,Hampshire,8503673,Pilgrims Cross CofE Aided Primary School,260,18600,10850,7750
850,Hampshire,8504012,The Westgate School,180,17800,10383,7417
850,Hampshire,8505202,Abbotswood Junior School,592,21920,12787,9133
850,Hampshire,8505203,Calmore Junior School,210,18100,10558,7542
850,Hampshire,8505206,Hordle CofE (VA) Primary School,281,18810,10973,7837
850,Hampshire,8505208,Ashley Junior School,260,18600,10850,7750
850,Hampshire,8505209,St Peters Catholic Primary School Waterlooville,372,19720,11503,8217
850,Hampshire,8505210,Mill Rythe Infant School,139,17390,10144,7246
850,Hampshire,8507000,Henry Tyndale School,78,16780,9788,6992
850,Hampshire,8507009,Riverside Community Special School,93,16930,9876,7054
850,Hampshire,8507015,Norman Gate School,61,16610,9689,6921
850,Hampshire,8507016,Maple Ridge School,93,16930,9876,7054
850,Hampshire,8507018,Heathfield Special School,109,17090,9969,7121
850,Hampshire,8507020,Icknield School,32,16320,9520,6800
850,Hampshire,8507023,Rachel Madocks School,23,16230,9468,6762
850,Hampshire,8507026,Limington House School,40,16400,9567,6833
850,Hampshire,8507033,St Francis Special School,15,15000,8750,6250
850,Hampshire,8507041,Forest Park School,75,16750,9771,6979
850,Hampshire,8507051,The Waterloo School,67,16670,9724,6946
850,Hampshire,8507053,Saxon Wood School,23,16230,9468,6762
850,Hampshire,8507067,Wolverdene Special School,58,16580,9672,6908
850,Hampshire,8507073,Samuel Cody Specialist Sports College,4,4000,2333,1667
850,Hampshire,8507076,Shepherds Down Special School,117,17170,10016,7154
850,Hampshire,8507079,Hollywater School,37,16370,9549,6821
851,Portsmouth,8512006,Milton Park Primary School,349,19490,11369,8121
851,Portsmouth,8512008,Copnor Primary School,590,21900,12775,9125
851,Portsmouth,8512637,Bramble Infant School and Nursery,115,17150,10004,7146
851,Portsmouth,8512648,Devonshire Infant School,124,17240,10057,7183
851,Portsmouth,8512665,Cumberland Infant School,114,17140,9998,7142
851,Portsmouth,8512673,Medina Primary School,175,17750,10354,7396
851,Portsmouth,8512680,Southsea Infant School,120,17200,10033,7167
851,Portsmouth,8512689,Cottage Grove Primary School,358,19580,11422,8158
851,Portsmouth,8512699,Wimborne Infant School,139,17390,10144,7246
851,Portsmouth,8512705,Wimborne Junior School,361,19610,11439,8171
851,Portsmouth,8512714,Fernhurst Junior School,350,19500,11375,8125
851,Portsmouth,8512716,Craneswater Junior School,442,20420,11912,8508
851,Portsmouth,8512719,Manor Infant School,159,17590,10261,7329
851,Portsmouth,8512765,Portsdown Primary School,326,19260,11235,8025
851,Portsmouth,8513212,St Judes CofE Primary School,349,19490,11369,8121
851,Portsmouth,8513214,St Georges Beneficial Church of England (Voluntary Controlled) Primary School,262,18620,10862,7758
851,Portsmouth,8513420,Corpus Christi Catholic Primary School,267,18670,10891,7779
851,Portsmouth,8513422,St Johns Cathedral Catholic Primary School,181,17810,10389,7421
851,Portsmouth,8513423,St Swithuns Catholic Primary School,270,18700,10908,7792
851,Portsmouth,8514303,Mayfield School,180,17800,10383,7417
851,Portsmouth,8515207,St Pauls Catholic Primary School,325,19250,11229,8021
851,Portsmouth,8517472,The Harbour School,10,10000,5833,4167
851,Portsmouth,8517750,Willows Centre for Children,6,6000,3500,2500
852,Southampton,8521100,Compass School,4,4000,2333,1667
852,Southampton,8522000,Bassett Green Primary School,469,20690,12069,8621
852,Southampton,8522001,Valentine Primary School,629,22290,13003,9287
852,Southampton,8522003,Newlands Primary School,347,19470,11358,8112
852,Southampton,8522004,Sinclair Primary and Nursery School,175,17750,10354,7396
852,Southampton,8522401,Mansel Park Primary School,327,19270,11241,8029
852,Southampton,8522405,Bevois Town Primary School,323,19230,11218,8012
852,Southampton,8522406,Bitterne Manor Primary School,211,18110,10564,7546
852,Southampton,8522407,Bitterne Park Primary School,562,21620,12612,9008
852,Southampton,8522409,Mount Pleasant Junior School,338,19380,11305,8075
852,Southampton,8522410,Maytree Nursery and Infants School,171,17710,10331,7379
852,Southampton,8522423,St Denys Primary School,177,17770,10366,7404
852,Southampton,8522424,St Johns Primary and Nursery School,247,18470,10774,7696
852,Southampton,8522428,St Monica Primary School,537,21370,12466,8904
852,Southampton,8522431,Swaythling Primary School,178,17780,10372,7408
852,Southampton,8522432,Woolston Infant School,120,17200,10033,7167
852,Southampton,8522440,Banister Primary School,333,19330,11276,8054
852,Southampton,8522441,Mansbridge Primary School,186,17860,10418,7442
852,Southampton,8522448,Redbridge Primary School,172,17720,10337,7383
852,Southampton,8522455,Moorlands Primary School,318,19180,11188,7992
852,Southampton,8522462,Weston Shore Infant School,51,16510,9631,6879
852,Southampton,8522463,Townhill Junior School,330,19300,11258,8042
852,Southampton,8522471,Oakwood Primary School,351,19510,11381,8129
852,Southampton,8522754,Fairisle Infant and Nursery School,213,18130,10576,7554
852,Southampton,8522757,Fairisle Junior School,332,19320,11270,8050
852,Southampton,8522769,Foundry Lane Primary School,501,21010,12256,8754
852,Southampton,8522770,Shirley Warren Primary & Nursery School,340,19400,11317,8083
852,Southampton,8522771,Mason Moor Primary School,232,18320,10687,7633
852,Southampton,8523200,Bitterne CE Primary School,353,19530,11393,8137
852,Southampton,8523203,St Marks Church of England Voluntary Controlled Primary School,399,19990,11661,8329
852,Southampton,8523205,St Marys Church of England Voluntary Controlled Primary School,492,20920,12203,8717
852,Southampton,8523655,Highfield Church of England Primary School,269,18690,10903,7787
852,Southampton,8523657,Holy Family Catholic Primary School,354,19540,11398,8142
852,Southampton,8523658,St Patricks Catholic Primary School,356,19560,11410,8150
852,Southampton,8527035,Springwell School,136,17360,10127,7233
852,Southampton,8527037,The Cedar School,37,16370,9549,6821
852,Southampton,8527040,Vermont School,31,16310,9514,6796
855,Leicestershire,8551102,Oakfield School,10,10000,5833,4167
855,Leicestershire,8552001,The Latimer Primary School Anstey,272,18720,10920,7800
855,Leicestershire,8552003,Greenfield Primary School,528,21280,12413,8867
855,Leicestershire,8552007,Moira Primary School,176,17760,10360,7400
855,Leicestershire,8552017,Buckminster Primary School,84,16840,9823,7017
855,Leicestershire,8552019,Burton-on-the-Wolds Primary School,140,17400,10150,7250
855,Leicestershire,8552020,Belvoirdale Community Primary School,256,18560,10827,7733
855,Leicestershire,8552023,Ellistown Community Primary School,186,17860,10418,7442
855,Leicestershire,8552024,Hugglescote Community Primary School,350,19500,11375,8125
855,Leicestershire,8552025,Woodstone Community Primary School,182,17820,10395,7425
855,Leicestershire,8552026,New Swannington Primary School,159,17590,10261,7329
855,Leicestershire,8552028,Griffydam Primary School,81,16810,9806,7004
855,Leicestershire,8552032,Desford Community Primary School,302,19020,11095,7925
855,Leicestershire,8552036,Foxton Primary School,82,16820,9812,7008
855,Leicestershire,8552042,Martinshaw Primary School,175,17750,10354,7396
855,Leicestershire,8552043,Heather Primary School,92,16920,9870,7050
855,Leicestershire,8552045,Westfield Junior School,384,19840,11573,8267
855,Leicestershire,8552046,Westfield Infant School,191,17910,10448,7462
855,Leicestershire,8552049,Barwell Infant School,126,17260,10068,7192
855,Leicestershire,8552051,Ibstock Junior School,251,18510,10798,7712
855,Leicestershire,8552053,Kegworth Primary School,163,17630,10284,7346
855,Leicestershire,8552056,Hemington Primary School,48,16480,9613,6867
855,Leicestershire,8552068,Little Bowden School,331,19310,11264,8046
855,Leicestershire,8552078,Newbold Verdon Primary School,217,18170,10599,7571
855,Leicestershire,8552082,Donisthorpe Primary School,175,17750,10354,7396
855,Leicestershire,8552090,Congerstone Primary School,132,17320,10103,7217
855,Leicestershire,8552096,Stathern Primary School,83,16830,9818,7012
855,Leicestershire,8552097,Newton Burgoland Primary School,78,16780,9788,6992
855,Leicestershire,8552104,Worthington School,63,16630,9701,6929
855,Leicestershire,8552115,Blaby Thistly Meadow Primary School,181,17810,10389,7421
855,Leicestershire,8552116,Thorpe Acre Junior School,152,17520,10220,7300
855,Leicestershire,8552120,Thorpe Acre Infant School,87,16870,9841,7029
855,Leicestershire,8552123,Elizabeth Woodville Primary School,186,17860,10418,7442
855,Leicestershire,8552137,Oxley Primary School Shepshed,235,18350,10704,7646
855,Leicestershire,8552142,Burbage Junior School,377,19770,11533,8237
855,Leicestershire,8552165,Booth Wood Primary School,197,17970,10483,7487
855,Leicestershire,8552170,Badgerbrook Primary School,357,19570,11416,8154
855,Leicestershire,8552177,Warren Hills Community Primary School,167,17670,10308,7362
855,Leicestershire,8552178,Orchard Community Primary School,234,18340,10698,7642
855,Leicestershire,8552180,Newlands Community Primary School,245,18450,10763,7687
855,Leicestershire,8552183,Sketchley Hill Primary School Burbage,372,19720,11503,8217
855,Leicestershire,8552193,Thythorn Field Community Primary School,175,17750,10354,7396
855,Leicestershire,8552319,Highgate Community Primary School,188,17880,10430,7450
855,Leicestershire,8552334,Dove Bank Primary School,97,16970,9899,7071
855,Leicestershire,8552345,The Hall School,363,19630,11451,8179
855,Leicestershire,8552354,Water Leys Primary School,357,19570,11416,8154
855,Leicestershire,8552373,Woodcote Primary School,164,17640,10290,7350
855,Leicestershire,8552375,Ravenhurst Primary School,495,20950,12221,8729
855,Leicestershire,8553010,Belton Church of England Primary School,82,16820,9812,7008
855,Leicestershire,8553011,Billesdon Church of England Primary School,87,16870,9841,7029
855,Leicestershire,8553016,St Hardulphs Church of England Primary School,60,16600,9683,6917
855,Leicestershire,8553017,Orchard Church of England Primary School Broughton Astley,167,17670,10308,7362
855,Leicestershire,8553018,Burbage Church of England Infant School,183,17830,10401,7429
855,Leicestershire,8553021,St Edwards Church of England Primary School,175,17750,10354,7396
855,Leicestershire,8553022,All Saints Church of England Primary School Coalville,187,17870,10424,7446
855,Leicestershire,8553024,Cossington Church of England Primary School,86,16860,9835,7025
855,Leicestershire,8553029,Diseworth Church of England Primary School,45,16450,9596,6854
855,Leicestershire,8553034,Fleckney Church of England Primary School,333,19330,11276,8054
855,Leicestershire,8553037,Great Glen St Cuthberts Church of England Primary School,210,18100,10558,7542
855,Leicestershire,8553039,Harby Church of England Primary School,71,16710,9748,6962
855,Leicestershire,8553042,St Marys Church of England Primary School Hinckley,266,18660,10885,7775
855,Leicestershire,8553043,Hose Church of England Primary School,48,16480,9613,6867
855,Leicestershire,8553047,St Denys Church of England Infant School Ibstock,161,17610,10273,7337
855,Leicestershire,8553053,Long Clawson Church of England Primary School,78,16780,9788,6992
855,Leicestershire,8553054,Long Whatton Church of England Primary School and Community Centre,83,16830,9818,7012
855,Leicestershire,8553066,Newbold Church of England Primary School,50,16500,9625,6875
855,Leicestershire,8553068,Packington Church of England Primary School,96,16960,9893,7067
855,Leicestershire,8553070,St Bartholomews Church of England Primary School,418,20180,11772,8408
855,Leicestershire,8553077,Scalford Church of England Primary School,61,16610,9689,6921
855,Leicestershire,8553080,Sheepy Magna Church of England Primary School,93,16930,9876,7054
855,Leicestershire,8553082,St Botolphs Church of England Primary School,241,18410,10739,7671
855,Leicestershire,8553090,Swithland St Leonards Church of England Primary School,78,16780,9788,6992
855,Leicestershire,8553101,Whitwick St John The Baptist Church of England Primary School,298,18980,11072,7908
855,Leicestershire,8553102,Witherley Church of England Primary School,96,16960,9893,7067
855,Leicestershire,8553103,Woodhouse Eaves St Pauls Church of England Primary School,186,17860,10418,7442
855,Leicestershire,8553104,Wymeswold Church of England Primary School,108,17080,9963,7117
855,Leicestershire,8553106,Hathern Church of England Primary School,122,17220,10045,7175
855,Leicestershire,8553107,Hallaton Church of England Primary School,108,17080,9963,7117
855,Leicestershire,8553209,Sherrier Church of England Primary School,332,19320,11270,8050
855,Leicestershire,8553212,Ashby-de-la-Zouch Church of England Primary School,274,18740,10932,7808
855,Leicestershire,8553300,Sir John Moore Church of England Primary School,117,17170,10016,7154
855,Leicestershire,8553307,Kilby St Marys Church of England Primary School,79,16790,9794,6996
855,Leicestershire,8553316,Snarestone Church of England Primary School,74,16740,9765,6975
855,Leicestershire,8553320,Thurlaston Church of England Primary School,79,16790,9794,6996
855,Leicestershire,8553345,Bishop Ellis Catholic Primary School Thurmaston,298,18980,11072,7908
855,Leicestershire,8557006,Ashmount School,89,16890,9853,7037
855,Leicestershire,8557215,Birch Wood (Melton Area Special School),39,16390,9561,6829
856,Leicester,8561100,Leicester City Primary PRU,9,9000,5250,3750
856,Leicester,8562000,Caldecote Community Primary School,453,20530,11976,8554
856,Leicester,8562210,Bridge Junior School,361,19610,11439,8171
856,Leicester,8562213,Catherine Infant School,222,18220,10628,7592
856,Leicester,8562214,Catherine Junior School,513,21130,12326,8804
856,Leicester,8562222,Evington Valley Primary School,276,18760,10943,7817
856,Leicester,8562228,Granby Primary School,392,19920,11620,8300
856,Leicester,8562231,Rushey Mead Primary School,493,20930,12209,8721
856,Leicester,8562238,Imperial Avenue Infant School,177,17770,10366,7404
856,Leicester,8562239,Inglehurst Infant School,146,17460,10185,7275
856,Leicester,8562240,Inglehurst Junior School,303,19030,11101,7929
856,Leicester,8562241,King Richard III Infant and Nursery School,120,17200,10033,7167
856,Leicester,8562250,Mayflower Primary School,366,19660,11468,8192
856,Leicester,8562264,Merrydale Infant School,180,17800,10383,7417
856,Leicester,8562267,St Marys Fields Primary School,395,19950,11638,8312
856,Leicester,8562268,Shaftesbury Junior School,240,18400,10733,7667
856,Leicester,8562282,Wyvern Primary School,356,19560,11410,8150
856,Leicester,8562283,Montrose School,364,19640,11457,8183
856,Leicester,8562287,Braunstone Frith Primary School,510,21100,12308,8792
856,Leicester,8562297,Folville Junior School,392,19920,11620,8300
856,Leicester,8562303,Shenton Primary School,432,20320,11853,8467
856,Leicester,8562304,Stokes Wood Primary School,382,19820,11562,8258
856,Leicester,8562305,Wolsey House Primary School,438,20380,11888,8492
856,Leicester,8562306,Buswells Lodge Primary School,354,19540,11398,8142
856,Leicester,8562317,Sandfield Close Primary School,357,19570,11416,8154
856,Leicester,8562320,Barley Croft Primary School,279,18790,10961,7829
856,Leicester,8562337,Abbey Primary Community School,551,21510,12548,8962
856,Leicester,8562339,Taylor Road Primary School,595,21950,12804,9146
856,Leicester,8562343,Linden Primary School,380,19800,11550,8250
856,Leicester,8562344,Eyres Monsell Primary School,236,18360,10710,7650
856,Leicester,8562346,Hazel Community Primary School,331,19310,11264,8046
856,Leicester,8562347,Charnwood Primary School,361,19610,11439,8171
856,Leicester,8562348,Mellor Community Primary School,498,20980,12238,8742
856,Leicester,8562352,Marriott Primary School,344,19440,11340,8100
856,Leicester,8562356,Whitehall Primary School,457,20570,11999,8571
856,Leicester,8562359,Spinney Hill Primary School,564,21640,12623,9017
856,Leicester,8562361,Scraptoft Valley Primary School,363,19630,11451,8179
856,Leicester,8562363,Beaumont Lodge Primary School,180,17800,10383,7417
856,Leicester,8562364,Parks Primary School,383,19830,11568,8262
856,Leicester,8562365,Fosse Primary School,341,19410,11323,8087
856,Leicester,8562371,Coleman Primary School,540,21400,12483,8917
856,Leicester,8562377,Herrick Primary School,332,19320,11270,8050
856,Leicester,8562378,Slater Primary School,125,17250,10063,7187
856,Leicester,8562379,Glebelands Primary School,237,18370,10716,7654
856,Leicester,8562381,Kestrels Field Primary School,415,20150,11754,8396
856,Leicester,8562385,Alderman Richard Hallam Primary School,691,22910,13364,9546
856,Leicester,8562386,Medway Community Primary School,549,21490,12536,8954
856,Leicester,8562387,Dovelands Primary School,444,20440,11923,8517
856,Leicester,8562388,Rolleston Primary School,352,19520,11387,8133
856,Leicester,8563201,Belgrave St Peters CofE Primary School,175,17750,10354,7396
856,Leicester,8563208,St Barnabas CofE Primary School,274,18740,10932,7808
856,Leicester,8563431,St John the Baptist CofE Primary School,418,20180,11772,8408
856,Leicester,8563435,Avenue Primary School,451,20510,11964,8546
856,Leicester,8567213,Nether Hall School,28,16280,9497,6783
856,Leicester,8567215,Millgate School,6,6000,3500,2500
856,Leicester,8567217,Oaklands School,97,16970,9899,7071
856,Leicester,8567218,Ellesmere College,51,16510,9631,6879
856,Leicester,8567220,Keyham Lodge School,16,16000,9333,6667
856,Leicester,8567221,West Gate School,61,16610,9689,6921
856,Leicester,8565951,The Childrens Hospital School,12,12000,7000,5000
857,Rutland,8573115,Oakham CofE Primary School,235,18350,10704,7646
857,Rutland,8573430,St Mary and St John CofE VA Primary School,140,17400,10150,7250
860,Staffordshire,8601105,Bridge Short Stay School,9,9000,5250,3750
860,Staffordshire,8602000,The Richard Heathcote Community Primary School,142,17420,10162,7258
860,Staffordshire,8602021,Dove CofE (VC) First School,72,16720,9753,6967
860,Staffordshire,8602123,Christ Church Primary School,266,18660,10885,7775
860,Staffordshire,8602132,Victoria Community School,289,18890,11019,7871
860,Staffordshire,8602138,Edge Hill Junior School,337,19370,11299,8071
860,Staffordshire,8602140,Tower View Primary School,317,19170,11183,7987
860,Staffordshire,8602150,The Richard Clarke First School,103,17030,9934,7096
860,Staffordshire,8602153,The Croft Primary School,172,17720,10337,7383
860,Staffordshire,8602157,Ravensmead Primary School,303,19030,11101,7929
860,Staffordshire,8602158,Wood Lane Primary School,84,16840,9823,7017
860,Staffordshire,8602164,Moor First School,87,16870,9841,7029
860,Staffordshire,8602166,Squirrel Hayes First School,87,16870,9841,7029
860,Staffordshire,8602177,Bridgtown Primary School,177,17770,10366,7404
860,Staffordshire,8602178,Chadsmoor Community Infants and Nursery School,115,17150,10004,7146
860,Staffordshire,8602180,Five Ways Primary School,548,21480,12530,8950
860,Staffordshire,8602184,West Hill Primary School,283,18830,10984,7846
860,Staffordshire,8602185,Redhill Primary School,143,17430,10168,7262
860,Staffordshire,8602190,Werrington Primary School,361,19610,11439,8171
860,Staffordshire,8602191,Cheadle Primary School,350,19500,11375,8125
860,Staffordshire,8602198,Manor Primary School,86,16860,9835,7025
860,Staffordshire,8602203,Millfield Primary School,351,19510,11381,8129
860,Staffordshire,8602207,St Stephens Primary School,251,18510,10798,7712
860,Staffordshire,8602208,Fulford Primary School,82,16820,9812,7008
860,Staffordshire,8602216,Thomas Barnes Primary School,87,16870,9841,7029
860,Staffordshire,8602218,Dove Bank Primary School,136,17360,10127,7233
860,Staffordshire,8602222,Talbot First School,32,16320,9520,6800
860,Staffordshire,8602226,Springhead Primary School,164,17640,10290,7350
860,Staffordshire,8602238,Henry Chadwick Primary School,81,16810,9806,7004
860,Staffordshire,8602239,Longwood Primary School,138,17380,10138,7242
860,Staffordshire,8602240,Green Lea First School,33,16330,9526,6804
860,Staffordshire,8602251,Hassell Primary School,254,18540,10815,7725
860,Staffordshire,8602256,May Bank Infants School,120,17200,10033,7167
860,Staffordshire,8602263,Westlands Primary School,181,17810,10389,7421
860,Staffordshire,8602273,Western Springs Primary School,82,16820,9812,7008
860,Staffordshire,8602276,Greysbrooke Primary School,178,17780,10372,7408
860,Staffordshire,8602277,Little Aston Primary School,194,17940,10465,7475
860,Staffordshire,8602293,Oakridge Primary School,194,17940,10465,7475
860,Staffordshire,8602294,Manor Hill First School,73,16730,9759,6971
860,Staffordshire,8602297,Coton Green Primary School,267,18670,10891,7779
860,Staffordshire,8602306,Bhylls Acre Primary School,175,17750,10354,7396
860,Staffordshire,8602309,Whittington Primary School,265,18650,10879,7771
860,Staffordshire,8602315,Springfields First School,130,17300,10092,7208
860,Staffordshire,8602321,Endon Hall Primary School,182,17820,10395,7425
860,Staffordshire,8602322,Ashcroft Infants School,80,16800,9800,7000
860,Staffordshire,8602326,Thomas Russell Junior School,252,18520,10803,7717
860,Staffordshire,8602327,Hayes Meadow Primary School,151,17510,10214,7296
860,Staffordshire,8602328,Woodcroft First School,167,17670,10308,7362
860,Staffordshire,8602332,Florendine Primary School,232,18320,10687,7633
860,Staffordshire,8602334,Wilnecote Junior School,292,18920,11037,7883
860,Staffordshire,8602335,Heathfields Infant School,143,17430,10168,7262
860,Staffordshire,8602336,The Woodlands Community Primary School,262,18620,10862,7758
860,Staffordshire,8602340,Willows Primary School,338,19380,11305,8075
860,Staffordshire,8602342,Glenthorne Community Primary School,197,17970,10483,7487
860,Staffordshire,8602344,Springcroft Primary School,182,17820,10395,7425
860,Staffordshire,8602345,Pirehill First School,236,18360,10710,7650
860,Staffordshire,8602346,Hanburys Farm Community Primary School,153,17530,10226,7304
860,Staffordshire,8602348,Oakhill Primary School,111,17110,9981,7129
860,Staffordshire,8602355,Chancel Primary School,182,17820,10395,7425
860,Staffordshire,8602360,The John Bamford Primary School,266,18660,10885,7775
860,Staffordshire,8602368,Lane Green First School,118,17180,10022,7158
860,Staffordshire,8602369,Jerome Primary School,183,17830,10401,7429
860,Staffordshire,8602370,Amington Heath Primary School and Nursery,92,16920,9870,7050
860,Staffordshire,8602372,Perton First School,216,18160,10593,7567
860,Staffordshire,8602386,Gorsemoor Primary School,456,20560,11993,8567
860,Staffordshire,8602393,Cheslyn Hay Primary School,354,19540,11398,8142
860,Staffordshire,8602394,Landywood Primary School,240,18400,10733,7667
860,Staffordshire,8602395,Moat Hall Primary School,287,18870,11008,7862
860,Staffordshire,8602396,Blakeley Heath Primary School,241,18410,10739,7671
860,Staffordshire,8602397,Westfield Primary School,320,19200,11200,8000
860,Staffordshire,8602399,Cooper Perry Primary School,187,17870,10424,7446
860,Staffordshire,8602400,Tillington Manor Primary School,230,18300,10675,7625
860,Staffordshire,8602403,St Leonards Primary School,175,17750,10354,7396
860,Staffordshire,8602404,Doxey Primary and Nursery School,150,17500,10208,7292
860,Staffordshire,8602406,Burton Manor Primary School,264,18640,10873,7767
860,Staffordshire,8602407,Castlechurch Primary School,300,19000,11083,7917
860,Staffordshire,8602409,Flash Ley Primary School,217,18170,10599,7571
860,Staffordshire,8602411,Chase Terrace Primary School,245,18450,10763,7687
860,Staffordshire,8602413,Fulfen Primary School,354,19540,11398,8142
860,Staffordshire,8602415,Highfields Primary School,175,17750,10354,7396
860,Staffordshire,8602416,Holly Grove Primary School,254,18540,10815,7725
860,Staffordshire,8602418,Ridgeway Primary School,351,19510,11381,8129
860,Staffordshire,8602424,Moorhill Primary School,332,19320,11270,8050
860,Staffordshire,8603000,Forsbrook CofE Controlled Primary School,183,17830,10401,7429
860,Staffordshire,8603025,All Saints CofE (C) Primary School,208,18080,10547,7533
860,Staffordshire,8603026,Hugo Meynell CofE (VC) Primary School,179,17790,10378,7412
860,Staffordshire,8603027,Barlaston CofE (C) First School,108,17080,9963,7117
860,Staffordshire,8603028,Berkswich CofE (VC) Primary School,187,17870,10424,7446
860,Staffordshire,8603029,Betley CofE VC Primary School,80,16800,9800,7000
860,Staffordshire,8603034,St Mary and St Chad CE (VC) First School,120,17200,10033,7167
860,Staffordshire,8603035,St Annes CofE (VC) Primary School,186,17860,10418,7442
860,Staffordshire,8603040,Chadsmoor CofE (VC) Junior School,235,18350,10704,7646
860,Staffordshire,8603043,St Andrews CofE (C) Primary School,56,16560,9660,6900
860,Staffordshire,8603046,St Pauls CofE (C) First School,109,17090,9969,7121
860,Staffordshire,8603050,St Leonards CofE (C) First School,46,16460,9602,6858
860,Staffordshire,8603051,Mary Howard CofE (VC) Primary School,47,16470,9608,6862
860,Staffordshire,8603069,St Johns CofE (C) Primary School,165,17650,10296,7354
860,Staffordshire,8603076,Christ Church CofE (C) Primary School,358,19580,11422,8158
860,Staffordshire,8603079,St Michaels CofE (C) Primary School,368,19680,11480,8200
860,Staffordshire,8603080,St Chads CofE (VC) Primary School,177,17770,10366,7404
860,Staffordshire,8603082,St Bartholomews CofE (C) School,14,14000,8167,5833
860,Staffordshire,8603084,St Peters CofE (VC) First School,39,16390,9561,6829
860,Staffordshire,8603086,The Henry Prince CofE (C) First School,29,16290,9503,6787
860,Staffordshire,8603091,St Chads CofE (C) Primary School,229,18290,10669,7621
860,Staffordshire,8603093,St Lukes CofE (C) Primary School,160,17600,10267,7333
860,Staffordshire,8603094,St Margarets CofE (VC) Junior School,240,18400,10733,7667
860,Staffordshire,8603098,St Chads CofE (VC) First School,95,16950,9888,7062
860,Staffordshire,8603110,All Saints CofE (C) First School,45,16450,9596,6854
860,Staffordshire,8603112,St Michaels CofE (C) First School,216,18160,10593,7567
860,Staffordshire,8603116,St Johns CofE (C) Primary School,75,16750,9771,6979
860,Staffordshire,8603117,Tittensor CofE (C) First School,54,16540,9648,6892
860,Staffordshire,8603118,All Saints CofE (VC) Primary School,84,16840,9823,7017
860,Staffordshire,8603128,St Johns CofE (C) Primary School,167,17670,10308,7362
860,Staffordshire,8603130,St Marys CofE (C) First School,73,16730,9759,6971
860,Staffordshire,8603134,Blackshaw Moor CofE (VC) First School,46,16460,9602,6858
860,Staffordshire,8603136,Sir John Offley CofE (VC) Primary School,120,17200,10033,7167
860,Staffordshire,8603137,Baldwins Gate CofE(VC) Primary School,103,17030,9934,7096
860,Staffordshire,8603139,Hob Hill CE/Methodist (VC) Primary School,178,17780,10372,7408
860,Staffordshire,8603141,Etching Hill CofE (C) Primary School,307,19070,11124,7946
860,Staffordshire,8603144,Holy Trinity CofE (C) Primary School,130,17300,10092,7208
860,Staffordshire,8603149,St Pauls CofE (C) Primary School,91,16910,9864,7046
860,Staffordshire,8603152,All Saints CofE (VC) Primary School,46,16460,9602,6858
860,Staffordshire,8603420,St Modwens Catholic Primary School,319,19190,11194,7996
860,Staffordshire,8603427,All Saints CofE (A) Primary School,69,16690,9736,6954
860,Staffordshire,8603430,St Peters CofE (A) Primary School,143,17430,10168,7262
860,Staffordshire,8603433,Church Eaton Endowed (VA) Primary School,61,16610,9689,6921
860,Staffordshire,8603438,Ilam CofE (VA) Primary School,43,16430,9584,6846
860,Staffordshire,8603442,Beresford Memorial CofE (A) First School,116,17160,10010,7150
860,Staffordshire,8603446,St Marys CofE (A) Primary School,59,16590,9678,6912
860,Staffordshire,8603447,St Michaels CofE (A) First School,115,17150,10004,7146
860,Staffordshire,8603449,St Marys CofE (A) First School,148,17480,10197,7283
860,Staffordshire,8603450,St Leonards CofE (A) Primary School,94,16940,9882,7058
860,Staffordshire,8603456,St Marys Catholic Primary School,177,17770,10366,7404
860,Staffordshire,8603458,St Joseph and St Theresa Catholic Primary,164,17640,10290,7350
860,Staffordshire,8603461,St Josephs Catholic Primary School,183,17830,10401,7429
860,Staffordshire,8603464,St Josephs Catholic Primary School,182,17820,10395,7425
860,Staffordshire,8603467,St Josephs Catholic Primary School,166,17660,10302,7358
860,Staffordshire,8603478,St Elizabeths Catholic Primary School,181,17810,10389,7421
860,Staffordshire,8603481,St Bernadettes Catholic Primary School,82,16820,9812,7008
860,Staffordshire,8603482,St Gabriels Catholic Primary School,347,19470,11358,8112
860,Staffordshire,8603483,St Christophers Catholic Primary School,181,17810,10389,7421
860,Staffordshire,8603484,SS Peter and Paul Catholic Primary School,100,17000,9917,7083
860,Staffordshire,8603485,St Thomas More Catholic Primary School,151,17510,10214,7296
860,Staffordshire,8603489,St Thomas CofE (A) Primary School,185,17850,10413,7437
860,Staffordshire,8603490,St Leonards CofE (VA) First School,30,16300,9508,6792
860,Staffordshire,8603492,St Lukes CofE Primary School,352,19520,11387,8133
860,Staffordshire,8603494,Chase View Community Primary School,158,17580,10255,7325
860,Staffordshire,8603497,The William Amory Primary School,168,17680,10313,7367
860,Staffordshire,8603499,Langdale Primary School,313,19130,11159,7971
860,Staffordshire,8603500,Riverview Primary School,307,19070,11124,7946
860,Staffordshire,8604142,Walton Priory Middle School,237,18370,10716,7654
860,Staffordshire,8604170,Perton Middle School,204,18040,10523,7517
860,Staffordshire,8604516,Brewood CofE (C) Middle School,206,18060,10535,7525
860,Staffordshire,8604517,Bilbrook CofE (VC) Middle School,40,16400,9567,6833
860,Staffordshire,8605202,Corbett VA CofE Primary School,90,16900,9858,7042
860,Staffordshire,8607000,Chasetown Community School,56,16560,9660,6900
860,Staffordshire,8607003,Horton Lodge Community Special School,37,16370,9549,6821
860,Staffordshire,8607032,Sherbrook Primary School,110,17100,9975,7125
860,Staffordshire,8607037,Marshlands School,77,16770,9783,6987
860,Staffordshire,8607042,Two Rivers Primary School,102,17020,9928,7092
861,Stoke-on-Trent,8611111,Merit Pupil Referral Unit,1,1000,583,417
861,Stoke-on-Trent,8612000,Priory CofE Primary School,343,19430,11334,8096
861,Stoke-on-Trent,8612002,Etruscan Primary School,314,19140,11165,7975
861,Stoke-on-Trent,8612033,Abbey Hulton Primary School,183,17830,10401,7429
861,Stoke-on-Trent,8612045,Waterside Primary School,272,18720,10920,7800
861,Stoke-on-Trent,8612054,Forest Park Primary School,356,19560,11410,8150
861,Stoke-on-Trent,8612059,The Willows Primary School,510,21100,12308,8792
861,Stoke-on-Trent,8612060,Oakhill Primary School,325,19250,11229,8021
861,Stoke-on-Trent,8612064,Blurton Primary School,322,19220,11212,8008
861,Stoke-on-Trent,8612066,Heron Cross Primary School,298,18980,11072,7908
861,Stoke-on-Trent,8612075,Clarice Cliff Primary School,348,19480,11363,8117
861,Stoke-on-Trent,8612100,Ball Green Primary School,269,18690,10903,7787
861,Stoke-on-Trent,8612101,Holden Lane Primary School,173,17730,10343,7387
861,Stoke-on-Trent,8612109,Hillside Primary School,179,17790,10378,7412
861,Stoke-on-Trent,8612116,Sandford Hill Primary School,362,19620,11445,8175
861,Stoke-on-Trent,8612425,Burnwood Community Primary School,470,20700,12075,8625
861,Stoke-on-Trent,8613016,St Pauls CofE (C) Primary School,262,18620,10862,7758
861,Stoke-on-Trent,8613301,St Marks CofE (A) Primary School,359,19590,11428,8162
861,Stoke-on-Trent,8613303,St Johns CofE (A) Primary School,259,18590,10844,7746
861,Stoke-on-Trent,8613311,Hanley St Lukes CofE Aided Primary School,361,19610,11439,8171
861,Stoke-on-Trent,8617005,Portland School and Specialist College,38,16380,9555,6825
861,Stoke-on-Trent,8617007,Abbey Hill School and Performing Arts College,98,16980,9905,7075
861,Stoke-on-Trent,8617008,Watermill School,79,16790,9794,6996
861,Stoke-on-Trent,8617011,Kemball Special School,87,16870,9841,7029
865,Wiltshire,8652003,Fynamore Primary School,356,19560,11410,8150
865,Wiltshire,8652004,Greentrees Primary School,358,19580,11422,8158
865,Wiltshire,8652005,Nursteed Community Primary School,182,17820,10395,7425
865,Wiltshire,8652008,Fitzmaurice Primary School,274,18740,10932,7808
865,Wiltshire,8652009,Bratton Primary School,130,17300,10092,7208
865,Wiltshire,8652023,St Pauls Primary School,170,17700,10325,7375
865,Wiltshire,8652027,Marlborough St Marys CE Primary School,313,19130,11159,7971
865,Wiltshire,8652029,Lypiatt Primary School,4,4000,2333,1667
865,Wiltshire,8652031,Neston Primary School,165,17650,10296,7354
865,Wiltshire,8652034,Monkton Park Primary School,208,18080,10547,7533
865,Wiltshire,8652045,Gomeldon Primary School,121,17210,10039,7171
865,Wiltshire,8652052,Hilmarton Primary School,98,16980,9905,7075
865,Wiltshire,8652053,Horningsham Primary School,66,16660,9718,6942
865,Wiltshire,8652060,Luckington Community School,45,16450,9596,6854
865,Wiltshire,8652086,Stanton St Quintin Community Primary School,71,16710,9748,6962
865,Wiltshire,8652087,Ramsbury Primary School,172,17720,10337,7383
865,Wiltshire,8652091,Harnham Infants School,164,17640,10290,7350
865,Wiltshire,8652136,Westbury Infant School,113,17130,9993,7137
865,Wiltshire,8652137,Westwood-with-Iford Primary School,96,16960,9893,7067
865,Wiltshire,8652140,Wootton Bassett Infants School,119,17190,10028,7162
865,Wiltshire,8652159,Kiwi Primary School,202,18020,10512,7508
865,Wiltshire,8652168,Priestley Primary School,174,17740,10348,7392
865,Wiltshire,8652170,The Grove Primary School,330,19300,11258,8042
865,Wiltshire,8652178,Princecroft Primary School,118,17180,10022,7158
865,Wiltshire,8652180,Redland Primary School,256,18560,10827,7733
865,Wiltshire,8652184,Longleaze Primary School,223,18230,10634,7596
865,Wiltshire,8652185,Mere School,167,17670,10308,7362
865,Wiltshire,8652190,Woodlands Primary School,179,17790,10378,7412
865,Wiltshire,8652191,Salisbury Manor Fields Primary School,189,17890,10436,7454
865,Wiltshire,8652196,Holbrook Primary School,203,18030,10518,7512
865,Wiltshire,8652198,Ludwell Community Primary School,71,16710,9748,6962
865,Wiltshire,8652218,Kings Lodge Primary School,299,18990,11078,7912
865,Wiltshire,8652222,Walwayne Court School,266,18660,10885,7775
865,Wiltshire,8652225,Bitham Brook Primary School,260,18600,10850,7750
865,Wiltshire,8652226,Charter Primary School,160,17600,10267,7333
865,Wiltshire,8652227,Newtown Community Primary School,193,17930,10459,7471
865,Wiltshire,8653002,Ashton Keynes Church of England Primary School,185,17850,10413,7437
865,Wiltshire,8653013,Box Church of England Primary School,153,17530,10226,7304
865,Wiltshire,8653015,Christ Church Church of England Controlled Primary School,368,19680,11480,8200
865,Wiltshire,8653017,Longford CofE (VC) Primary School,62,16620,9695,6925
865,Wiltshire,8653018,Broad Hinton Church of England Primary School,88,16880,9847,7033
865,Wiltshire,8653019,Broad Town Church of England Primary School,60,16600,9683,6917
865,Wiltshire,8653020,St Nicholas Church of England VC Primary School Bromham,76,16760,9777,6983
865,Wiltshire,8653035,Cherhill CofE School,159,17590,10261,7329
865,Wiltshire,8653040,Colerne CofE Primary School,217,18170,10599,7571
865,Wiltshire,8653045,St Sampsons Church of England Primary School,275,18750,10938,7812
865,Wiltshire,8653047,Crockerton CofE Primary School,87,16870,9841,7029
865,Wiltshire,8653048,Crudwell CofE Primary School,108,17080,9963,7117
865,Wiltshire,8653049,Collingbourne Church of England Primary School,90,16900,9858,7042
865,Wiltshire,8653063,Durrington Church of England Controlled Junior School,172,17720,10337,7383
865,Wiltshire,8653086,Heddington Church of England Primary School,62,16620,9695,6925
865,Wiltshire,8653088,Hilperton Church of England Voluntary Controlled Primary School,147,17470,10191,7279
865,Wiltshire,8653090,Holt Voluntary Controlled Primary School,159,17590,10261,7329
865,Wiltshire,8653091,Hullavington CofE Primary and Nursery School,116,17160,10010,7150
865,Wiltshire,8653096,Kington St Michael Church of England Primary School,107,17070,9958,7112
865,Wiltshire,8653100,Lacock Church of England Primary School,63,16630,9701,6929
865,Wiltshire,8653102,Langley Fitzurse Church of England Primary School,85,16850,9829,7021
865,Wiltshire,8653104,Lea and Garsdon Church of England Primary School,109,17090,9969,7121
865,Wiltshire,8653134,Newton Tony Church of England Voluntary Controlled School,46,16460,9602,6858
865,Wiltshire,8653135,North Bradley CofE Primary School,179,17790,10378,7412
865,Wiltshire,8653140,Oaksey CofE Primary School,70,16700,9742,6958
865,Wiltshire,8653149,Preshute Church of England Primary School,168,17680,10313,7367
865,Wiltshire,8653150,St Marys Church of England Primary School Purton,312,19120,11153,7967
865,Wiltshire,8653158,Harnham Church of England Controlled Junior School,343,19430,11334,8096
865,Wiltshire,8653161,Shalbourne CofE Primary School,42,16420,9578,6842
865,Wiltshire,8653163,Sherston CofE Primary School,161,17610,10273,7337
865,Wiltshire,8653166,Southwick Church of England Primary School,163,17630,10284,7346
865,Wiltshire,8653170,Staverton Church of England Voluntary Controlled Primary School,231,18310,10681,7629
865,Wiltshire,8653172,Stratford-sub-Castle Church of England Voluntary Controlled Primary School,123,17230,10051,7179
865,Wiltshire,8653174,Sutton Veny CofE School,148,17480,10197,7283
865,Wiltshire,8653186,Urchfont Church of England Primary School,99,16990,9911,7079
865,Wiltshire,8653191,The Minster CofE Primary School,187,17870,10424,7446
865,Wiltshire,8653192,Westbury Church of England Junior School,221,18210,10623,7587
865,Wiltshire,8653193,Westbury Leigh CofE Primary School,342,19420,11328,8092
865,Wiltshire,8653199,Winsley Church of England Voluntary Controlled Primary School,140,17400,10150,7250
865,Wiltshire,8653201,Winterbourne Earls Church of England Primary School,164,17640,10290,7350
865,Wiltshire,8653205,Sambourne Church of England Voluntary Controlled Primary School,125,17250,10063,7187
865,Wiltshire,8653220,Minety Church of England Primary School,127,17270,10074,7196
865,Wiltshire,8653222,St Barnabas Church of England School Market Lavington,60,16600,9683,6917
865,Wiltshire,8653229,Coombe Bissett Church of England Primary School,86,16860,9835,7025
865,Wiltshire,8653230,Dinton CofE Primary School,79,16790,9794,6996
865,Wiltshire,8653239,St Johns Church of England Primary School Tisbury,98,16980,9905,7075
865,Wiltshire,8653242,Brinkworth Earl Danbys Church of England Primary,140,17400,10150,7250
865,Wiltshire,8653300,St Michaels CofE Aided Primary,160,17600,10267,7333
865,Wiltshire,8653306,Baydon St Nicholas Church of England Primary School,118,17180,10022,7158
865,Wiltshire,8653316,Chapmanslade Church of England Voluntary Aided Primary School,97,16970,9899,7071
865,Wiltshire,8653318,Chilton Foliat Church of England Primary School,85,16850,9829,7021
865,Wiltshire,8653330,Derry Hill Church of England Voluntary Aided Primary School,184,17840,10407,7433
865,Wiltshire,8653355,St Nicholas Church of England Primary School Porton,99,16990,9911,7079
865,Wiltshire,8653362,St Andrews Church of England Voluntary Aided Primary School Laverstock,178,17780,10372,7408
865,Wiltshire,8653372,The New Forest CofE (VA) Primary School,154,17540,10232,7308
865,Wiltshire,8653383,Sarum St Pauls CofE (VA) Primary School,185,17850,10413,7437
865,Wiltshire,8653387,St Martins CofE Voluntary Aided Primary School,160,17600,10267,7333
865,Wiltshire,8653396,St Thomas A Becket Church of England Aided Primary School,56,16560,9660,6900
865,Wiltshire,8653402,Whiteparish All Saints Church of England Primary School,113,17130,9993,7137
865,Wiltshire,8653405,Winterslow CofE (Aided) Primary School,156,17560,10243,7317
865,Wiltshire,8653412,Christ The King Catholic School Amesbury,200,18000,10500,7500
865,Wiltshire,8653418,St Josephs Catholic Primary School Malmesbury,128,17280,10080,7200
865,Wiltshire,8653425,St Osmunds Catholic Primary School Salisbury,177,17770,10366,7404
865,Wiltshire,8653430,St Johns Catholic Primary School Trowbridge,275,18750,10938,7812
865,Wiltshire,8653435,Wardour Catholic Primary School,97,16970,9899,7071
865,Wiltshire,8653437,St Patricks Catholic Primary School Corsham,167,17670,10308,7362
865,Wiltshire,8653449,Broad Chalke CofE Primary School,178,17780,10372,7408
865,Wiltshire,8653453,Chilmark and Fonthill Bishop Church of England Aided Primary School,51,16510,9631,6879
865,Wiltshire,8653454,Semley Church of England Voluntary Aided Primary School,91,16910,9864,7046
865,Wiltshire,8653459,Hindon Church of England Voluntary Aided Primary School St Marys and St Johns,37,16370,9549,6821
865,Wiltshire,8653460,Alderbury and West Grimstead Church of England Primary School,156,17560,10243,7317
865,Wiltshire,8653461,Kennet Valley Church of England Aided Primary School,91,16910,9864,7046
865,Wiltshire,8653462,Amesbury Archer Primary School,337,19370,11299,8071
865,Wiltshire,8653464,Old Sarum Primary School,165,17650,10296,7354
865,Wiltshire,8653465,Wylye Valley Church of England Voluntary Aided Primary School,95,16950,9888,7062
865,Wiltshire,8653467,Churchfields the Village School,113,17130,9993,7137
865,Wiltshire,8653468,Amesbury Church of England Voluntary Controlled Primary School,380,19800,11550,8250
865,Wiltshire,8653469,Five Lanes Primary School,76,16760,9777,6983
865,Wiltshire,8653471,Lyneham Primary School,280,18800,10967,7833
865,Wiltshire,8653472,Bellefield Primary and Nursery School,242,18420,10745,7675
865,Wiltshire,8655201,Downton CofE VA Primary School,190,17900,10442,7458
865,Wiltshire,8655205,Frogwell Primary School,157,17570,10249,7321
865,Wiltshire,8655206,Studley Green Primary School,171,17710,10331,7379
865,Wiltshire,8655207,St Georges Catholic Primary School Warminster,152,17520,10220,7300
865,Wiltshire,8655208,St Marys RC Primary School,246,18460,10768,7692
865,Wiltshire,8655209,Paxcroft Primary School,270,18700,10908,7792
865,Wiltshire,8655212,Sutton Benger Church of England Aided Primary School,133,17330,10109,7221
865,Wiltshire,8655215,Ludgershall Castle Primary School,219,18190,10611,7579
865,Wiltshire,8655216,Pitton Church of England Voluntary Aided Primary School,85,16850,9829,7021
865,Wiltshire,8655218,Clarendon Junior School,351,19510,11381,8129
865,Wiltshire,8655219,Clarendon Infants School,191,17910,10448,7462
865,Wiltshire,8657009,St Nicholas School,40,16400,9567,6833
865,Wiltshire,8657010,Larkrise School,50,16500,9625,6875
865,Wiltshire,8657007,Downland School,3,3000,1750,1250
866,Swindon,8662004,Liden Primary and Nursery School,313,19130,11159,7971
866,Swindon,8662005,Oak Tree Nursery and Primary School,289,18890,11019,7871
866,Swindon,8662008,Catherine Wayte Primary School,357,19570,11416,8154
866,Swindon,8662009,Eldene Nursery and Primary School,275,18750,10938,7812
866,Swindon,8662011,Bridlewood Primary School,231,18310,10681,7629
866,Swindon,8662012,East Wichel Primary School & Nursery,329,19290,11253,8037
866,Swindon,8662026,Chiseldon Primary & Nursery School,144,17440,10173,7267
866,Swindon,8662095,Beechcroft Infant School,154,17540,10232,7308
866,Swindon,8662103,Even Swindon Primary School,514,21140,12332,8808
866,Swindon,8662123,Lainesmead Primary School,352,19520,11387,8133
866,Swindon,8662133,Wanborough Primary School,171,17710,10331,7379
866,Swindon,8662143,Wroughton Infant School,174,17740,10348,7392
866,Swindon,8662147,Lawn Primary,355,19550,11404,8146
866,Swindon,8662156,Wroughton Junior School,336,19360,11293,8067
866,Swindon,8662161,Nythe Primary School,147,17470,10191,7279
866,Swindon,8662164,Greenmeadow Primary School,251,18510,10798,7712
866,Swindon,8662166,Colebrook Junior School,170,17700,10325,7375
866,Swindon,8662167,Westrop Primary School,233,18330,10693,7637
866,Swindon,8662211,Robert Le Kyng Primary School,356,19560,11410,8150
866,Swindon,8662214,Brook Field Primary School,358,19580,11422,8158
866,Swindon,8662229,Haydonleigh Primary School,498,20980,12238,8742
866,Swindon,8663009,Bishopstone Church of England Primary School,42,16420,9578,6842
866,Swindon,8663455,Oliver Tomkins Church of England Junior School,200,18000,10500,7500
866,Swindon,8663458,Oliver Tomkins Church of England Infant and Nursery School,118,17180,10022,7158
866,Swindon,8663460,St Francis CofE Primary School,358,19580,11422,8158
866,Swindon,8663462,Red Oaks Primary School,434,20340,11865,8475
866,Swindon,8663463,Orchid Vale Primary School,353,19530,11393,8137
866,Swindon,8663465,Covingham Park Primary School,325,19250,11229,8021
866,Swindon,8665222,Oakhurst Community Primary School,336,19360,11293,8067
866,Swindon,8667006,Crowdys Hill School,24,16240,9473,6767
867,Bracknell Forest,8672057,Fox Hill Primary School,178,17780,10372,7408
867,Bracknell Forest,8672059,Holly Spring Junior School,331,19310,11264,8046
867,Bracknell Forest,8672060,Holly Spring Infant and Nursery School,164,17640,10290,7350
867,Bracknell Forest,8672087,College Town Primary School,419,20190,11778,8412
867,Bracknell Forest,8672099,Cranbourne Primary School,174,17740,10348,7392
867,Bracknell Forest,8672113,Uplands Primary School and Nursery,180,17800,10383,7417
867,Bracknell Forest,8672135,Ascot Heath Infant School,133,17330,10109,7221
867,Bracknell Forest,8672138,Owlsmoor Primary School,471,20710,12081,8629
867,Bracknell Forest,8672154,New Scotland Hill Primary School,177,17770,10366,7404
867,Bracknell Forest,8672165,Birch Hill Primary School,348,19480,11363,8117
867,Bracknell Forest,8672228,Wooden Hill Primary and Nursery School,292,18920,11037,7883
867,Bracknell Forest,8672250,Wildridings Primary School,345,19450,11346,8104
867,Bracknell Forest,8672251,Meadow Vale Primary School,548,21480,12530,8950
867,Bracknell Forest,8672254,Harmans Water Primary School,501,21010,12256,8754
867,Bracknell Forest,8672813,Whitegrove Primary School,362,19620,11445,8175
867,Bracknell Forest,8672814,Sandy Lane Primary School,451,20510,11964,8546
867,Bracknell Forest,8673023,Crowthorne Church of England Primary School,180,17800,10383,7417
867,Bracknell Forest,8673038,St Michaels Church of England Primary School Sandhurst,171,17710,10331,7379
867,Bracknell Forest,8673047,Warfield Church of England Primary School,317,19170,11183,7987
867,Bracknell Forest,8673054,Ascot Heath Church of England Junior School,238,18380,10722,7658
867,Bracknell Forest,8673062,Winkfield St Marys CofE Primary School,174,17740,10348,7392
867,Bracknell Forest,8673076,Binfield Church of England Primary School,357,19570,11416,8154
867,Bracknell Forest,8673313,St Michaels Easthampstead Church of England Voluntary Aided Primary School,206,18060,10535,7525
867,Bracknell Forest,8673333,St Josephs Catholic Primary School Bracknell,184,17840,10407,7433
867,Bracknell Forest,8673357,The Pines Primary School,243,18430,10751,7679
867,Bracknell Forest,8677032,Kennel Lane School,68,16680,9730,6950
868,Windsor and Maidenhead,8681103,RBWM Alternative Learning Provision,3,3000,1750,1250
868,Windsor and Maidenhead,8682071,Alwyn Infant  School,185,17850,10413,7437
868,Windsor and Maidenhead,8682072,Courthouse Junior School,393,19930,11626,8304
868,Windsor and Maidenhead,8682074,Riverside Primary School and Nursery,248,18480,10780,7700
868,Windsor and Maidenhead,8682077,Wessex Primary School,357,19570,11416,8154
868,Windsor and Maidenhead,8682085,Kings Court First School,173,17730,10343,7387
868,Windsor and Maidenhead,8682092,Waltham St Lawrence Primary School,95,16950,9888,7062
868,Windsor and Maidenhead,8682096,Hilltop First School,172,17720,10337,7383
868,Windsor and Maidenhead,8682107,Woodlands Park Primary School,142,17420,10162,7258
868,Windsor and Maidenhead,8682108,Furze Platt Junior School,357,19570,11416,8154
868,Windsor and Maidenhead,8682109,South Ascot Village Primary School,182,17820,10395,7425
868,Windsor and Maidenhead,8682112,Furze Platt Infant School,174,17740,10348,7392
868,Windsor and Maidenhead,8682123,Cookham Rise Primary School,179,17790,10378,7412
868,Windsor and Maidenhead,8682143,Homer First School and Nursery,182,17820,10395,7425
868,Windsor and Maidenhead,8682155,Alexander First School,81,16810,9806,7004
868,Windsor and Maidenhead,8682159,Oldfield Primary School,331,19310,11264,8046
868,Windsor and Maidenhead,8682176,Oakfield First School,232,18320,10687,7633
868,Windsor and Maidenhead,8682202,Wraysbury Primary School,340,19400,11317,8083
868,Windsor and Maidenhead,8682247,Larchfield Primary and Nursery School,172,17720,10337,7383
868,Windsor and Maidenhead,8683011,Braywood CofE First School,117,17170,10016,7154
868,Windsor and Maidenhead,8683021,Cookham Dean CofE Primary School,159,17590,10261,7329
868,Windsor and Maidenhead,8683022,Holy Trinity CofE Primary School Cookham,179,17790,10378,7412
868,Windsor and Maidenhead,8683031,Boyne Hill CofE Infant and Nursery School,119,17190,10028,7162
868,Windsor and Maidenhead,8683059,All Saints CofE Junior School,332,19320,11270,8050
868,Windsor and Maidenhead,8683072,Eton Wick CofE First School,108,17080,9963,7117
868,Windsor and Maidenhead,8683074,The Queen Anne Royal Free CofE Controlled First School,115,17150,10004,7146
868,Windsor and Maidenhead,8683318,The Royal First School,77,16770,9783,6987
868,Windsor and Maidenhead,8683322,Holy Trinity CofE Primary School Sunningdale,201,18010,10506,7504
868,Windsor and Maidenhead,8683323,St Michaels CofE Primary School Sunninghill,181,17810,10389,7421
868,Windsor and Maidenhead,8683324,Cheapside CofE Primary School,135,17350,10121,7229
868,Windsor and Maidenhead,8683326,Clewer Green CofE First School,225,18250,10646,7604
868,Windsor and Maidenhead,8683327,Trinity St Stephen CofE Aided First School,117,17170,10016,7154
868,Windsor and Maidenhead,8683338,St Edwards Catholic First School,235,18350,10704,7646
868,Windsor and Maidenhead,8684704,St Edwards Royal Free Ecumenical Middle School Windsor,242,18420,10745,7675
868,Windsor and Maidenhead,8687009,Manor Green School,94,16940,9882,7058
869,West Berkshire,8691111,Icollege Alternative Provision,8,8000,4667,3333
869,West Berkshire,8692050,Beenham Primary School,64,16640,9707,6933
869,West Berkshire,8692063,Chieveley Primary School,178,17780,10372,7408
869,West Berkshire,8692064,Curridge Primary School,84,16840,9823,7017
869,West Berkshire,8692066,The Ilsleys Primary School,58,16580,9672,6908
869,West Berkshire,8692068,Hermitage Primary School,163,17630,10284,7346
869,West Berkshire,8692069,Hungerford Primary School,324,19240,11223,8017
869,West Berkshire,8692070,Inkpen Primary School,66,16660,9718,6942
869,West Berkshire,8692083,John Rankin Junior School,314,19140,11165,7975
869,West Berkshire,8692084,John Rankin Infant and Nursery School,173,17730,10343,7387
869,West Berkshire,8692090,Francis Baily Primary School,474,20740,12098,8642
869,West Berkshire,8692110,Birch Copse Primary School,362,19620,11445,8175
869,West Berkshire,8692111,Westwood Farm Junior School,233,18330,10693,7637
869,West Berkshire,8692119,Long Lane Primary School,179,17790,10378,7412
869,West Berkshire,8692125,Garland Junior School,216,18160,10593,7567
869,West Berkshire,8692128,Robert Sandilands Primary School and Nursery,212,18120,10570,7550
869,West Berkshire,8692131,Westwood Farm Infant School,121,17210,10039,7171
869,West Berkshire,8692133,Springfield Primary School,256,18560,10827,7733
869,West Berkshire,8692140,Falkland Primary School,393,19930,11626,8304
869,West Berkshire,8692145,Parsons Down Infant School,148,17480,10197,7283
869,West Berkshire,8692158,Mrs Blands Infant School,111,17110,9981,7129
869,West Berkshire,8692174,Downsway Primary School,187,17870,10424,7446
869,West Berkshire,8692180,Kennet Valley Primary School,168,17680,10313,7367
869,West Berkshire,8692231,Parsons Down Junior School,291,18910,11031,7879
869,West Berkshire,8692239,Calcot Infant School and Nursery,154,17540,10232,7308
869,West Berkshire,8692240,Calcot Junior School,290,18900,11025,7875
869,West Berkshire,8692246,Spurcroft Primary School,386,19860,11585,8275
869,West Berkshire,8692249,Pangbourne Primary School,178,17780,10372,7408
869,West Berkshire,8693004,Aldermaston C.E. Primary School,137,17370,10133,7237
869,West Berkshire,8693006,Basildon C.E. Primary School,114,17140,9998,7142
869,West Berkshire,8693007,Beedon C.E. (Controlled) Primary School,43,16430,9584,6846
869,West Berkshire,8693013,Brimpton C.E. Primary School,48,16480,9613,6867
869,West Berkshire,8693014,Bucklebury C.E. Primary School,106,17060,9952,7108
869,West Berkshire,8693015,Burghfield St Marys C.E. Primary School,182,17820,10395,7425
869,West Berkshire,8693016,Chaddleworth St Andrews C.E. Primary School,28,16280,9497,6783
869,West Berkshire,8693018,Cold Ash St Marks C.E. School,170,17700,10325,7375
869,West Berkshire,8693020,Compton C.E. Primary School,159,17590,10261,7329
869,West Berkshire,8693024,Enborne C.E. Primary School,52,16520,9637,6883
869,West Berkshire,8693026,Hampstead Norreys C.E. Primary School,72,16720,9753,6967
869,West Berkshire,8693029,Kintbury St Marys C.E. Primary School,137,17370,10133,7237
869,West Berkshire,8693036,Purley CofE Primary School,97,16970,9899,7071
869,West Berkshire,8693039,Shaw-cum-Donnington C.E. Primary School,73,16730,9759,6971
869,West Berkshire,8693040,Shefford C.E. Primary School,33,16330,9526,6804
869,West Berkshire,8693042,Mortimer St Marys C.E. Junior School,216,18160,10593,7567
869,West Berkshire,8693043,Mortimer St Johns C.E. Infant School,117,17170,10016,7154
869,West Berkshire,8693044,Streatley C.E. Voluntary Controlled School,88,16880,9847,7033
869,West Berkshire,8693045,Theale C.E. Primary School,254,18540,10815,7725
869,West Berkshire,8693049,Welford and Wickham C.E. Primary School,82,16820,9812,7008
869,West Berkshire,8693306,St Pauls Catholic Primary School,278,18780,10955,7825
869,West Berkshire,8693310,Bradfield C.E. Primary School,122,17220,10045,7175
869,West Berkshire,8693311,Brightwalton C.E. Aided Primary School,79,16790,9794,6996
869,West Berkshire,8693314,Englefield C.E. Primary School,91,16910,9864,7046
869,West Berkshire,8693316,St Nicolas C.E. Junior School,258,18580,10838,7742
869,West Berkshire,8693321,Stockcross C.E. School,86,16860,9835,7025
869,West Berkshire,8693325,Sulhamstead and Ufton Nervet School,92,16920,9870,7050
869,West Berkshire,8693331,Woolhampton C.E. Primary School,77,16770,9783,6987
869,West Berkshire,8693332,Yattendon C.E. Primary School,59,16590,9678,6912
869,West Berkshire,8693358,St Finians Catholic Primary School,157,17570,10249,7321
869,West Berkshire,8693359,The Winchcombe School,364,19640,11457,8183
869,West Berkshire,8693360,Thatcham Park CofE Primary,325,19250,11229,8021
869,West Berkshire,8693361,The Willows Primary School,297,18970,11066,7904
869,West Berkshire,8695205,St John the Evangelist C.E. Nursery and Infant Sch,120,17200,10033,7167
869,West Berkshire,8695206,St Josephs Catholic Primary School,169,17690,10319,7371
869,West Berkshire,8697007,The Castle School,57,16570,9666,6904
869,West Berkshire,8697028,Brookfields Special School,79,16790,9794,6996
870,Reading,8701112,Cranbury College,8,8000,4667,3333
870,Reading,8702000,Alfred Sutton Primary School,494,20940,12215,8725
870,Reading,8702003,Caversham Primary School,394,19940,11632,8308
870,Reading,8702005,Coley Primary School,201,18010,10506,7504
870,Reading,8702006,E P Collier Primary School,263,18630,10868,7762
870,Reading,8702007,Geoffrey Field Junior School,357,19570,11416,8154
870,Reading,8702008,Geoffrey Field Infant School,178,17780,10372,7408
870,Reading,8702016,Oxford Road Community School,207,18070,10541,7529
870,Reading,8702018,Redlands Primary School,201,18010,10506,7504
870,Reading,8702019,The Hill Primary School,411,20110,11731,8379
870,Reading,8702020,The Ridgeway Primary School,301,19010,11089,7921
870,Reading,8702021,Park Lane Primary School,353,19530,11393,8137
870,Reading,8702024,Wilson Primary School,356,19560,11410,8150
870,Reading,8702026,Emmer Green Primary School,418,20180,11772,8408
870,Reading,8702027,Southcote Primary School,464,20640,12040,8600
870,Reading,8702029,St Michaels Primary School,327,19270,11241,8029
870,Reading,8702034,Moorlands Primary School,376,19760,11527,8233
870,Reading,8702036,Thameside Primary School,355,19550,11404,8146
870,Reading,8702226,Katesgrove Primary School,521,21210,12373,8837
870,Reading,8702233,Caversham Park Primary School,177,17770,10366,7404
870,Reading,8702234,Micklands Primary School,347,19470,11358,8112
870,Reading,8702253,Manor Primary School,263,18630,10868,7762
870,Reading,8703000,All Saints Church of England Aided Infant School,40,16400,9567,6833
870,Reading,8703302,St Annes Catholic Primary School,164,17640,10290,7350
870,Reading,8703304,English Martyrs Catholic Primary School,358,19580,11422,8158
870,Reading,8703305,Christ The King Catholic Primary School,302,19020,11095,7925
870,Reading,8703360,St Martins Catholic Primary School,155,17550,10238,7312
870,Reading,8703361,Whitley Park Primary and Nursery School,512,21120,12320,8800
870,Reading,8707036,The Holy Brook School,32,16320,9520,6800
871,Slough,8712252,Wexham Court Primary School,534,21340,12448,8892
871,Slough,8712255,Penn Wood Primary and Nursery School,562,21620,12612,9008
871,Slough,8712256,Claycots School,1267,28670,16724,11946
871,Slough,8713070,St Marys Church of England Primary School,477,20770,12116,8654
871,Slough,8713353,Our Lady of Peace Catholic Primary and Nursery School,514,21140,12332,8808
871,Slough,8713366,Khalsa Primary School,362,19620,11445,8175
871,Slough,8713367,Iqra Slough Islamic Primary School,535,21350,12454,8896
871,Slough,8715201,Priory School,718,23180,13522,9658
871,Slough,8715202,Holy Family Catholic Primary School,359,19590,11428,8162
871,Slough,8715207,Pippins School,148,17480,10197,7283
872,Wokingham,8722088,Farley Hill Primary School,175,17750,10354,7396
872,Wokingham,8722089,Lambs Lane Primary School,194,17940,10465,7475
872,Wokingham,8722100,Bearwood Primary School,228,18280,10663,7617
872,Wokingham,8722101,Wescott Infant School,113,17130,9993,7137
872,Wokingham,8722105,Whiteknights Primary School,352,19520,11387,8133
872,Wokingham,8722106,Keep Hatch Primary School,353,19530,11393,8137
872,Wokingham,8722116,Aldryngton Primary School,271,18710,10914,7796
872,Wokingham,8722121,Emmbrook Infant School,120,17200,10033,7167
872,Wokingham,8722130,Emmbrook Junior School,250,18500,10792,7708
872,Wokingham,8722137,Walter Infant School,180,17800,10383,7417
872,Wokingham,8722146,Winnersh Primary School,412,20120,11737,8383
872,Wokingham,8722148,Gorse Ride Junior School,242,18420,10745,7675
872,Wokingham,8722149,The Colleton Primary School,324,19240,11223,8017
872,Wokingham,8722157,Shinfield Infant and Nursery School,179,17790,10378,7412
872,Wokingham,8722160,Willow Bank Infant School,119,17190,10028,7162
872,Wokingham,8722161,Willow Bank Junior School,236,18360,10710,7650
872,Wokingham,8722167,Rivermead Primary School,337,19370,11299,8071
872,Wokingham,8722184,Westende Junior School,240,18400,10733,7667
872,Wokingham,8722227,The Hawthorns Primary School,361,19610,11439,8171
872,Wokingham,8722232,Gorse Ride Infants School,109,17090,9969,7121
872,Wokingham,8722235,Radstock Primary School,363,19630,11451,8179
872,Wokingham,8722237,Hawkedon Primary School,542,21420,12495,8925
872,Wokingham,8722238,Hillside Primary School,360,19600,11433,8167
872,Wokingham,8722245,Beechwood Primary School,299,18990,11078,7912
872,Wokingham,8722246,Highwood Primary School,191,17910,10448,7462
872,Wokingham,8722247,South Lake Primary School,361,19610,11439,8171
872,Wokingham,8723037,St Nicholas Church of England Primary Hurst,118,17180,10022,7158
872,Wokingham,8723041,Shinfield St Marys CofE Junior School,316,19160,11177,7983
872,Wokingham,8723046,Polehampton Church of England Infant School,120,17200,10033,7167
872,Wokingham,8723048,Crazies Hill CofE Primary School,81,16810,9806,7004
872,Wokingham,8723055,St Pauls CofE Junior School,384,19840,11573,8267
872,Wokingham,8723056,Woodley CofE Primary School,264,18640,10873,7767
872,Wokingham,8723057,Robert Piggott CofE Infant School,80,16800,9800,7000
872,Wokingham,8723061,Robert Piggott CofE Junior School,175,17750,10354,7396
872,Wokingham,8723315,Finchampstead CofE VA Primary School,100,17000,9917,7083
872,Wokingham,8723319,Grazeley Parochial Church of England Aided Primary School,141,17410,10156,7254
872,Wokingham,8723320,Sonning CofE Primary School,179,17790,10378,7412
872,Wokingham,8723368,St Dominic Savio Catholic Primary School,358,19580,11422,8158
872,Wokingham,8723370,Polehampton Church of England Junior School,238,18380,10722,7658
872,Wokingham,8723371,Loddon Primary School,416,20160,11760,8400
872,Wokingham,8723372,All Saints CofE (Aided) Primary School,232,18320,10687,7633
872,Wokingham,8727029,Addington School,97,16970,9899,7071
873,Cambridgeshire,8732000,Trumpington Meadows Primary School,216,18160,10593,7567
873,Cambridgeshire,8732001,Thorndown Primary School,457,20570,11999,8571
873,Cambridgeshire,8732002,Bassingbourn Primary School,273,18730,10926,7804
873,Cambridgeshire,8732004,Caldecote Primary School,172,17720,10337,7383
873,Cambridgeshire,8732006,Cottenham Primary School,498,20980,12238,8742
873,Cambridgeshire,8732010,Fen Drayton Primary School,79,16790,9794,6996
873,Cambridgeshire,8732011,Fowlmere Primary School,83,16830,9818,7012
873,Cambridgeshire,8732012,Foxton Primary School,93,16930,9876,7054
873,Cambridgeshire,8732015,Girton Glebe Primary School,180,17800,10383,7417
873,Cambridgeshire,8732016,Great Abington Primary School,115,17150,10004,7146
873,Cambridgeshire,8732018,Harston and Newton Community Primary School,143,17430,10168,7262
873,Cambridgeshire,8732028,Melbourn Primary School,292,18920,11037,7883
873,Cambridgeshire,8732029,Meldreth Primary School,146,17460,10185,7275
873,Cambridgeshire,8732031,Over Primary School,252,18520,10803,7717
873,Cambridgeshire,8732033,Pendragon Community Primary School,311,19110,11148,7962
873,Cambridgeshire,8732046,Swavesey Primary School,266,18660,10885,7775
873,Cambridgeshire,8732048,Waterbeach Community Primary School,302,19020,11095,7925
873,Cambridgeshire,8732054,Willingham Primary School,268,18680,10897,7783
873,Cambridgeshire,8732059,Meridian Primary School,187,17870,10424,7446
873,Cambridgeshire,8732060,Benwick Primary School,110,17100,9975,7125
873,Cambridgeshire,8732064,Townley Primary School,76,16760,9777,6983
873,Cambridgeshire,8732065,Coates Primary School,149,17490,10203,7287
873,Cambridgeshire,8732066,Lionel Walden Primary School,193,17930,10459,7471
873,Cambridgeshire,8732068,Friday Bridge Community Primary School,97,16970,9899,7071
873,Cambridgeshire,8732070,Robert Arkenstall Primary School,247,18470,10774,7696
873,Cambridgeshire,8732074,Littleport Community Primary School,381,19810,11556,8254
873,Cambridgeshire,8732075,Manea Community Primary School,166,17660,10302,7358
873,Cambridgeshire,8732082,Beaupre Community Primary School,174,17740,10348,7392
873,Cambridgeshire,8732083,Alderman Payne Primary School,87,16870,9841,7029
873,Cambridgeshire,8732084,Stretham Community Primary School,158,17580,10255,7325
873,Cambridgeshire,8732091,Clarkson Infants School,138,17380,10138,7242
873,Cambridgeshire,8732107,Morley Memorial Primary School,358,19580,11422,8158
873,Cambridgeshire,8732109,Newnham Croft Primary School,197,17970,10483,7487
873,Cambridgeshire,8732115,Shirley Community Primary School,343,19430,11334,8096
873,Cambridgeshire,8732118,Arbury Primary School,350,19500,11375,8125
873,Cambridgeshire,8732119,Colville Primary School,240,18400,10733,7667
873,Cambridgeshire,8732121,Mayfield Primary School,350,19500,11375,8125
873,Cambridgeshire,8732123,The Grove Primary School,247,18470,10774,7696
873,Cambridgeshire,8732202,The Icknield Primary School,147,17470,10191,7279
873,Cambridgeshire,8732205,Hauxton Primary School,84,16840,9823,7017
873,Cambridgeshire,8732208,Fenstanton and Hilton Primary School,220,18200,10617,7583
873,Cambridgeshire,8732211,Hemingford Grey Primary School,243,18430,10751,7679
873,Cambridgeshire,8732212,Houghton Primary School,172,17720,10337,7383
873,Cambridgeshire,8732214,Offord Primary School,85,16850,9829,7021
873,Cambridgeshire,8732217,The Ashbeach Primary School,121,17210,10039,7171
873,Cambridgeshire,8732219,Priory Park Infant School & Playgroup,168,17680,10313,7367
873,Cambridgeshire,8732222,Spaldwick Community Primary School,135,17350,10121,7229
873,Cambridgeshire,8732232,Westfield Junior School,343,19430,11334,8096
873,Cambridgeshire,8732239,Priory Junior School,324,19240,11223,8017
873,Cambridgeshire,8732240,Wyton on the Hill Community Primary School,139,17390,10144,7246
873,Cambridgeshire,8732246,Eastfield Infant and Nursery School,161,17610,10273,7337
873,Cambridgeshire,8732254,Yaxley Infant School,101,17010,9923,7087
873,Cambridgeshire,8732255,Sawtry Infants School,115,17150,10004,7146
873,Cambridgeshire,8732260,The Newton Community Primary School,79,16790,9794,6996
873,Cambridgeshire,8732293,Little Paxton Primary School,273,18730,10926,7804
873,Cambridgeshire,8732312,Bewick Bridge Community Primary School,220,18200,10617,7583
873,Cambridgeshire,8732315,Hardwick and Cambourne Community Primary School,480,20800,12133,8667
873,Cambridgeshire,8732317,St Matthews Primary School,537,21370,12466,8904
873,Cambridgeshire,8732321,Fourfields Community Primary School,357,19570,11416,8154
873,Cambridgeshire,8732327,Burwell Village College (Primary),393,19930,11626,8304
873,Cambridgeshire,8732328,Fulbourn Primary School,264,18640,10873,7767
873,Cambridgeshire,8732329,Spring Meadow Infant School,225,18250,10646,7604
873,Cambridgeshire,8732331,Kinderley Primary School,64,16640,9707,6933
873,Cambridgeshire,8732333,Queen Edith Primary School,354,19540,11398,8142
873,Cambridgeshire,8732335,The Spinney Primary School,180,17800,10383,7417
873,Cambridgeshire,8732336,Fawcett Primary School,312,19120,11153,7967
873,Cambridgeshire,8732442,Kettlefields Primary School,102,17020,9928,7092
873,Cambridgeshire,8732443,Stukeley Meadows Primary School,344,19440,11340,8100
873,Cambridgeshire,8732444,Ely St Johns Community Primary School,407,20070,11708,8362
873,Cambridgeshire,8732446,Kings Hedges Primary School,337,19370,11299,8071
873,Cambridgeshire,8732449,Monkfield Park Primary School,360,19600,11433,8167
873,Cambridgeshire,8732450,Abbey Meadows Primary School,395,19950,11638,8312
873,Cambridgeshire,8732452,Bushmead Primary School,258,18580,10838,7742
873,Cambridgeshire,8732453,Ridgefield Primary School,176,17760,10360,7400
873,Cambridgeshire,8733001,Barrington CofE VC Primary School,92,16920,9870,7050
873,Cambridgeshire,8733004,Burrough Green CofE Primary School,83,16830,9818,7012
873,Cambridgeshire,8733008,Castle Camps Church of England (Controlled) Primary School,103,17030,9934,7096
873,Cambridgeshire,8733009,Cheveley CofE Primary School,120,17200,10033,7167
873,Cambridgeshire,8733011,Coton Church of England (Voluntary Controlled) Primary School,112,17120,9987,7133
873,Cambridgeshire,8733012,Dry Drayton CofE (C) Primary School,46,16460,9602,6858
873,Cambridgeshire,8733014,Fordham CofE Primary School,222,18220,10628,7592
873,Cambridgeshire,8733017,Great Wilbraham CofE Primary School,73,16730,9759,6971
873,Cambridgeshire,8733022,Isleham Church of England Primary School,174,17740,10348,7392
873,Cambridgeshire,8733029,Steeple Morden CofE VC Primary School,166,17660,10302,7358
873,Cambridgeshire,8733032,William Westley Church of England VC Primary School,183,17830,10401,7429
873,Cambridgeshire,8733035,Haslingfield Endowed Primary School,148,17480,10197,7283
873,Cambridgeshire,8733041,Duxford Church of England Community Primary School,192,17920,10453,7467
873,Cambridgeshire,8733050,Cherry Hinton Church of England Voluntary Controlled Primary School,157,17570,10249,7321
873,Cambridgeshire,8733052,Sutton CofE VC Primary School,285,18850,10996,7854
873,Cambridgeshire,8733053,Little Thetford CofE VC Primary School,86,16860,9835,7025
873,Cambridgeshire,8733054,Wilburton CofE Primary School,106,17060,9952,7108
873,Cambridgeshire,8733058,The Rackham Church of England Primary School,271,18710,10914,7796
873,Cambridgeshire,8733061,Alconbury CofE Primary School,169,17690,10319,7371
873,Cambridgeshire,8733065,Folksworth CofE Primary School,78,16780,9788,6992
873,Cambridgeshire,8733066,Great Gidding CofE Primary School,53,16530,9643,6887
873,Cambridgeshire,8733067,Barnabas Oley CofE Primary School,109,17090,9969,7121
873,Cambridgeshire,8733068,Great Paxton CofE Primary School,103,17030,9934,7096
873,Cambridgeshire,8733071,Holywell CofE Primary School,175,17750,10354,7396
873,Cambridgeshire,8733074,Eynesbury CofE C Primary School,173,17730,10343,7387
873,Cambridgeshire,8733081,Brington CofE Primary School,43,16430,9584,6846
873,Cambridgeshire,8733301,Barton CofE VA Primary School,93,16930,9876,7054
873,Cambridgeshire,8733302,Pathfinder Primary School,19,16190,9444,6746
873,Cambridgeshire,8733308,Elsworth CofE VA Primary School,108,17080,9963,7117
873,Cambridgeshire,8733310,Great and Little Shelford CofE (Aided) Primary School,173,17730,10343,7387
873,Cambridgeshire,8733317,Linton CofE Infant School,113,17130,9993,7137
873,Cambridgeshire,8733321,Oakington CofE VA Primary School,123,17230,10051,7179
873,Cambridgeshire,8733325,Teversham CofE VA Primary School,139,17390,10144,7246
873,Cambridgeshire,8733331,Petersfield CofE Aided Primary School,112,17120,9987,7133
873,Cambridgeshire,8733350,Park Street CofE Primary School,94,16940,9882,7058
873,Cambridgeshire,8733356,St Pauls CofE VA Primary School,175,17750,10354,7396
873,Cambridgeshire,8733358,St Philips CofE Aided Primary School,256,18560,10827,7733
873,Cambridgeshire,8733360,St Albans Catholic Primary School,177,17770,10366,7404
873,Cambridgeshire,8733366,St Laurences Catholic Primary School,248,18480,10780,7700
873,Cambridgeshire,8733368,The Elton CofE Primary School of the Foundation of Frances and Jane Proby,116,17160,10010,7150
873,Cambridgeshire,8733373,Abbots Ripton CofE Primary School,80,16800,9800,7000
873,Cambridgeshire,8733384,St Annes CofE Primary School,180,17800,10383,7417
873,Cambridgeshire,8733386,Milton Road Primary School,354,19540,11398,8142
873,Cambridgeshire,8733389,The Vine Inter-Church Primary School,360,19600,11433,8167
873,Cambridgeshire,8733390,Orchard Park Community Primary School,163,17630,10284,7346
873,Cambridgeshire,8733392,Wheatfields Primary School,348,19480,11363,8117
873,Cambridgeshire,8733942,Brampton Village Primary School,390,19900,11608,8292
873,Cambridgeshire,8733943,The Bellbird Primary School,272,18720,10920,7800
873,Cambridgeshire,8733945,Huntingdon Primary School,416,20160,11760,8400
873,Cambridgeshire,8733946,Queen Emma Primary School,352,19520,11387,8133
873,Cambridgeshire,8735200,St Helens Primary School,140,17400,10150,7250
873,Cambridgeshire,8737001,The Harbour School,31,16310,9514,6796
873,Cambridgeshire,8737023,Samuel Pepys School,43,16430,9584,6846
873,Cambridgeshire,8737025,Granta School,46,16460,9602,6858
873,Cambridgeshire,8737026,Castle School Cambridge,66,16660,9718,6942
874,Peterborough,8741101,The Pupil Referral Service Peterborough,16,16000,9333,6667
874,Peterborough,8742215,Old Fletton Primary School,344,19440,11340,8100
874,Peterborough,8742223,Southfields Primary School,497,20970,12233,8737
874,Peterborough,8742234,Northborough Primary School,180,17800,10383,7417
874,Peterborough,8742244,The Duke of Bedford Primary School,164,17640,10290,7350
874,Peterborough,8742251,Oakdale Primary School,180,17800,10383,7417
874,Peterborough,8742264,Dogsthorpe Infant School,201,18010,10506,7504
874,Peterborough,8742269,Brewster Avenue Infant School,116,17160,10010,7150
874,Peterborough,8742270,Queens Drive Infant School,176,17760,10360,7400
874,Peterborough,8742295,Norwood Primary School,178,17780,10372,7408
874,Peterborough,8742307,Leighton Primary School,348,19480,11363,8117
874,Peterborough,8742313,Winyates Primary School,172,17720,10337,7383
874,Peterborough,8742316,Welbourne Primary School,186,17860,10418,7442
874,Peterborough,8742325,The Beeches Primary School,534,21340,12448,8892
874,Peterborough,8742449,Paston Ridings Primary School,428,20280,11830,8450
874,Peterborough,8742453,Heritage Park Primary School,181,17810,10389,7421
874,Peterborough,8742456,Hampton Hargate Primary School,540,21400,12483,8917
874,Peterborough,8743077,Barnack CofE (Controlled) Primary School,161,17610,10273,7337
874,Peterborough,8743078,Castor CofE Primary School,148,17480,10197,7283
874,Peterborough,8743079,Eye CofE Primary School,348,19480,11363,8117
874,Peterborough,8743080,Newborough CofE Primary School,175,17750,10354,7396
874,Peterborough,8743374,Peakirk-Cum-Glinton CofE Primary School,179,17790,10378,7412
874,Peterborough,8743376,All Saints CofE (Aided) Primary School,329,19290,11253,8037
874,Peterborough,8743377,St Augustines CofE (Voluntary Aided) Junior School,238,18380,10722,7658
874,Peterborough,8743378,St Thomas More Catholic Primary School,358,19580,11422,8158
874,Peterborough,8743379,Sacred Heart RC Primary School,180,17800,10383,7417
874,Peterborough,8743380,St Johns Church School,334,19340,11282,8058
874,Peterborough,8743386,Saint Michael CofE Primary School (Voluntary Aided),269,18690,10903,7787
874,Peterborough,8747020,Heltwate School,69,16690,9736,6954
874,Peterborough,8747024,The Phoenix School,88,16880,9847,7033
874,Peterborough,8747025,Nene Gate,7,7000,4083,2917
876,Halton,8762104,Moore Primary School,182,17820,10395,7425
876,Halton,8762107,Victoria Road Primary School,195,17950,10471,7479
876,Halton,8762118,Weston Point Community Primary School,141,17410,10156,7254
876,Halton,8762281,Weston Primary School,157,17570,10249,7321
876,Halton,8762283,Castle View Primary School,115,17150,10004,7146
876,Halton,8762295,The Brow Community Primary School,149,17490,10203,7287
876,Halton,8762297,Woodside Primary School,149,17490,10203,7287
876,Halton,8762325,Pewithall Primary School,184,17840,10407,7433
876,Halton,8762376,Hillview Primary School,163,17630,10284,7346
876,Halton,8762381,Murdishaw West Community Primary School,140,17400,10150,7250
876,Halton,8762382,Beechwood Primary School,131,17310,10098,7212
876,Halton,8762383,Gorsewood Primary School,164,17640,10290,7350
876,Halton,8762387,Windmill Hill Primary School,122,17220,10045,7175
876,Halton,8762406,Ditton Primary School,341,19410,11323,8087
876,Halton,8762415,Moorfield Primary School,219,18190,10611,7579
876,Halton,8762425,Fairfield Primary School,474,20740,12098,8642
876,Halton,8762428,Lunts Heath Primary School,316,19160,11177,7983
876,Halton,8762689,Hallwood Park Primary School and Nursery,123,17230,10051,7179
876,Halton,8762700,Astmoor Primary School,122,17220,10045,7175
876,Halton,8762711,Simms Cross Primary School,216,18160,10593,7567
876,Halton,8762712,Halton Lodge Primary School,174,17740,10348,7392
876,Halton,8762723,Westfield Primary School,128,17280,10080,7200
876,Halton,8762725,Brookvale Primary School,225,18250,10646,7604
876,Halton,8762726,Our Lady of Perpetual Succour Catholic Primary School,176,17760,10360,7400
876,Halton,8762727,Oakfield Community Primary School,234,18340,10698,7642
876,Halton,8763050,Halebank CofE Primary School,65,16650,9713,6937
876,Halton,8763175,Spinney Avenue Church of England Voluntary Controlled Primary School,175,17750,10354,7396
876,Halton,8763176,Hale Church of England Voluntary Controlled Primary School,135,17350,10121,7229
876,Halton,8763177,Farnworth Church of England Controlled Primary School,354,19540,11398,8142
876,Halton,8763179,All Saints Upton Church of England Voluntary Controlled Primary School,180,17800,10383,7417
876,Halton,8763502,Runcorn All Saints CofE Primary School,70,16700,9742,6958
876,Halton,8763506,St Marys Church of England Primary School,199,17990,10494,7496
876,Halton,8763509,St Edwards Catholic Primary School,110,17100,9975,7125
876,Halton,8763510,St Clements Catholic Primary School,175,17750,10354,7396
876,Halton,8763511,The Holy Spirit Catholic Primary School,100,17000,9917,7083
876,Halton,8763614,St Bedes Catholic Junior School,305,19050,11113,7937
876,Halton,8763615,St Bedes Catholic Infant School,152,17520,10220,7300
876,Halton,8763632,Our Lady Mother of the Saviour Catholic Primary School,159,17590,10261,7329
876,Halton,8763637,St Martins Catholic Primary School,175,17750,10354,7396
876,Halton,8763640,St Bertelines CofE Primary School,250,18500,10792,7708
876,Halton,8763648,St Basils Catholic Primary School,315,19150,11171,7979
876,Halton,8763649,St Gerards Catholic Primary and Nursery School,169,17690,10319,7371
876,Halton,8763650,St John Fisher Catholic Primary School,178,17780,10372,7408
876,Halton,8763651,St Michaels Catholic Primary School,207,18070,10541,7529
876,Halton,8767200,Chesnut Lodge Special School,27,16270,9491,6779
877,Warrington,8772013,Bewsey Lodge Primary School,232,18320,10687,7633
877,Warrington,8772015,Dallam Community Primary School,184,17840,10407,7433
877,Warrington,8772016,Meadowside Community Primary and Nursery School,197,17970,10483,7487
877,Warrington,8772103,Bradshaw Community Primary School,179,17790,10378,7412
877,Warrington,8772112,Stockton Heath Primary School,346,19460,11352,8108
877,Warrington,8772116,Thelwall Community Junior School,168,17680,10313,7367
877,Warrington,8772117,The Cobbs Infant and Nursery School,174,17740,10348,7392
877,Warrington,8772125,Statham Community Primary School,175,17750,10354,7396
877,Warrington,8772126,Ravenbank Community Primary School,356,19560,11410,8150
877,Warrington,8772300,Broomfields Junior School,363,19630,11451,8179
877,Warrington,8772313,Oughtrington Community Primary School,362,19620,11445,8175
877,Warrington,8772317,Appleton Thorn Primary School,173,17730,10343,7387
877,Warrington,8772335,Cherry Tree Primary School,188,17880,10430,7450
877,Warrington,8772370,Thelwall Community Infant School,86,16860,9835,7025
877,Warrington,8772401,Croft Primary School,179,17790,10378,7412
877,Warrington,8772402,Culcheth Community Primary School,184,17840,10407,7433
877,Warrington,8772405,Woolston Community Primary School,192,17920,10453,7467
877,Warrington,8772416,Newchurch Community Primary School,183,17830,10401,7429
877,Warrington,8772423,Twiss Green Community Primary School,173,17730,10343,7387
877,Warrington,8772433,Brook Acre Community Primary School,196,17960,10477,7483
877,Warrington,8772677,Locking Stumps Community Primary School,298,18980,11072,7908
877,Warrington,8772687,Gorse Covert Primary School,259,18590,10844,7746
877,Warrington,8772697,Callands Community Primary School,285,18850,10996,7854
877,Warrington,8772717,Barrow Hall Community Primary School,482,20820,12145,8675
877,Warrington,8772728,Oakwood Avenue Community Primary School,510,21100,12308,8792
877,Warrington,8772729,Latchford CofE Primary School,158,17580,10255,7325
877,Warrington,8772730,Grappenhall Heys Community Primary School,181,17810,10389,7421
877,Warrington,8772732,Sankey Valley St James Church of England Primary School,180,17800,10383,7417
877,Warrington,8773302,St Elphins (Fairfield) CofE Voluntary Aided Primary School,338,19380,11305,8075
877,Warrington,8773304,St Margarets CofE Voluntary Aided Primary School,359,19590,11428,8162
877,Warrington,8773308,Warrington St Anns CofE Primary School,178,17780,10372,7408
877,Warrington,8773310,Warrington St Barnabas CofE Primary School,175,17750,10354,7396
877,Warrington,8773313,St Andrews CofE Primary School,175,17750,10354,7396
877,Warrington,8773316,Birchwood CofE Primary School,163,17630,10284,7346
877,Warrington,8773400,Our Ladys Catholic Primary School,171,17710,10331,7379
877,Warrington,8773401,Sacred Heart Catholic Primary School,171,17710,10331,7379
877,Warrington,8773402,St Albans Catholic Primary School,168,17680,10313,7367
877,Warrington,8773404,St Benedicts Catholic Primary School,174,17740,10348,7392
877,Warrington,8773409,St Augustines Catholic Primary School,119,17190,10028,7162
877,Warrington,8773410,St Stephens Catholic Primary School,177,17770,10366,7404
877,Warrington,8773505,Grappenhall St Wilfrids CofE Primary School,354,19540,11398,8142
877,Warrington,8773508,St Thomas CofE Primary School,180,17800,10383,7417
877,Warrington,8773512,St Monicas Catholic Primary School,179,17790,10378,7412
877,Warrington,8773601,Christ Church CofE Primary School Padgate,274,18740,10932,7808
877,Warrington,8773603,Winwick CofE Primary School,168,17680,10313,7367
877,Warrington,8773609,Woolston CofE Aided Primary School,184,17840,10407,7433
877,Warrington,8773610,St Paul of the Cross Catholic Primary School,148,17480,10197,7283
877,Warrington,8773611,St Lewis Catholic Primary School,175,17750,10354,7396
877,Warrington,8773612,St Oswalds Catholic Primary School,182,17820,10395,7425
877,Warrington,8773613,St Peters Catholic Primary School,186,17860,10418,7442
877,Warrington,8773622,St Josephs Catholic Primary School,263,18630,10868,7762
877,Warrington,8773627,St Vincents Catholic Primary School,196,17960,10477,7483
877,Warrington,8773629,St Bridgets Catholic Primary School,179,17790,10378,7412
877,Warrington,8773638,Cinnamon Brow CofE Primary School,270,18700,10908,7792
877,Warrington,8773639,Stretton St Matthews CofE Primary School,184,17840,10407,7433
877,Warrington,8773642,St Philip (Westbrook) CofE Aided Primary School,408,20080,11713,8367
877,Warrington,8777001,Green Lane Community Special School,58,16580,9672,6908
877,Warrington,8777002,Fox Wood Special School,50,16500,9625,6875
877,Warrington,8777103,Woolston Brook School,14,14000,8167,5833
878,Devon,8782002,Bow Community Primary School,111,17110,9981,7129
878,Devon,8782007,Cheriton Fitzpaine Primary School,69,16690,9736,6954
878,Devon,8782008,Clyst Hydon Primary School,37,16370,9549,6821
878,Devon,8782009,Clyst St Mary Primary School,162,17620,10278,7342
878,Devon,8782010,Colyton Primary School,144,17440,10173,7267
878,Devon,8782011,Copplestone Primary School,160,17600,10267,7333
878,Devon,8782012,Haywards Primary School,310,19100,11142,7958
878,Devon,8782015,Culmstock Primary School,115,17150,10004,7146
878,Devon,8782025,Countess Wear Community School,278,18780,10955,7825
878,Devon,8782026,Ladysmith Infant & Nursery School,175,17750,10354,7396
878,Devon,8782027,Ladysmith Junior School,350,19500,11375,8125
878,Devon,8782028,Montgomery Primary School,323,19230,11218,8012
878,Devon,8782029,Newtown Primary School,152,17520,10220,7300
878,Devon,8782033,Stoke Hill Infants and Nursery School,175,17750,10354,7396
878,Devon,8782034,Stoke Hill Junior School,352,19520,11387,8133
878,Devon,8782043,Exeter Road Community Primary School,175,17750,10354,7396
878,Devon,8782045,Marpool Primary School,335,19350,11288,8062
878,Devon,8782048,Honiton Primary School,362,19620,11445,8175
878,Devon,8782050,Kilmington Primary School,90,16900,9858,7042
878,Devon,8782054,Newton Poppleford Primary School,163,17630,10284,7346
878,Devon,8782055,Newton St Cyres Primary School,84,16840,9823,7017
878,Devon,8782056,Ottery St Mary Primary School,354,19540,11398,8142
878,Devon,8782058,West Hill Primary School,184,17840,10407,7433
878,Devon,8782059,Sandford School,137,17370,10133,7237
878,Devon,8782060,Seaton Primary School,336,19360,11293,8067
878,Devon,8782062,Shute Community Primary School,73,16730,9759,6971
878,Devon,8782073,Upottery Primary School,97,16970,9899,7071
878,Devon,8782074,Whimple Primary School,119,17190,10028,7162
878,Devon,8782075,Willand School,344,19440,11340,8100
878,Devon,8782079,Landscore Primary School,282,18820,10978,7842
878,Devon,8782085,Bassetts Farm Primary School,341,19410,11323,8087
878,Devon,8782089,Spreyton School,21,16210,9456,6754
878,Devon,8782090,The Topsham School,178,17780,10372,7408
878,Devon,8782200,Appledore School,177,17770,10366,7404
878,Devon,8782201,Ashwater Primary School,25,16250,9479,6771
878,Devon,8782205,Pilton Infants School,118,17180,10022,7158
878,Devon,8782206,Beaford Community Primary & Nursery School,82,16820,9812,7008
878,Devon,8782207,East-the-Water Community Primary School,317,19170,11183,7987
878,Devon,8782209,West Croft School,466,20660,12052,8608
878,Devon,8782210,Bishops Nympton Primary School,65,16650,9713,6937
878,Devon,8782211,Bishops Tawton Primary School,142,17420,10162,7258
878,Devon,8782215,Caen Community Primary School,308,19080,11130,7950
878,Devon,8782216,Southmead School,298,18980,11072,7908
878,Devon,8782218,Buckland Brewer Primary School,40,16400,9567,6833
878,Devon,8782220,Clawton Primary School,93,16930,9876,7054
878,Devon,8782223,East Anstey Primary School,39,16390,9561,6829
878,Devon,8782225,Filleigh Community Primary School,75,16750,9771,6979
878,Devon,8782226,Fremington Community Primary and Nursery School,287,18870,11008,7862
878,Devon,8782228,Halwill Community Primary School,86,16860,9835,7025
878,Devon,8782229,Hartland Primary School,101,17010,9923,7087
878,Devon,8782231,Horwood and Newton Tracey Community Primary School,81,16810,9806,7004
878,Devon,8782232,Ilfracombe Infant and Nursery School,238,18380,10722,7658
878,Devon,8782233,Instow Community Primary School,122,17220,10045,7175
878,Devon,8782234,Kentisbury Primary School,30,16300,9508,6792
878,Devon,8782235,Kings Nympton Community Primary School,45,16450,9596,6854
878,Devon,8782237,Langtree Community School and Nursery Unit,73,16730,9759,6971
878,Devon,8782238,Marwood School,101,17010,9923,7087
878,Devon,8782239,Monkleigh Primary School,88,16880,9847,7033
878,Devon,8782240,North Molton School,79,16790,9794,6996
878,Devon,8782241,Parkham Primary School,30,16300,9508,6792
878,Devon,8782242,St Giles-on-the-Heath Community School,82,16820,9812,7008
878,Devon,8782243,Shebbear Community School,65,16650,9713,6937
878,Devon,8782244,Shirwell Community Primary School,45,16450,9596,6854
878,Devon,8782245,South Molton Community Primary School,147,17470,10191,7279
878,Devon,8782249,West Down School,78,16780,9788,6992
878,Devon,8782252,Winkleigh Primary School,170,17700,10325,7375
878,Devon,8782254,Woolsery Primary School,101,17010,9923,7087
878,Devon,8782257,Kingsacre Primary School,191,17910,10448,7462
878,Devon,8782400,Abbotskerswell Primary School,95,16950,9888,7062
878,Devon,8782402,Bishopsteignton School,166,17660,10302,7358
878,Devon,8782404,Bovey Tracey Primary School,259,18590,10844,7746
878,Devon,8782408,Broadhempston Village Primary School,46,16460,9602,6858
878,Devon,8782411,Cockwood Primary School,77,16770,9783,6987
878,Devon,8782416,Denbury Primary School,98,16980,9905,7075
878,Devon,8782417,Doddiscombsleigh Primary  School,27,16270,9491,6779
878,Devon,8782420,Exminster Community Primary,315,19150,11171,7979
878,Devon,8782423,Ipplepen Primary School,162,17620,10278,7342
878,Devon,8782424,Kenton Primary School,83,16830,9818,7012
878,Devon,8782425,Kingsbridge Community Primary School,355,19550,11404,8146
878,Devon,8782428,Loddiswell Primary School,84,16840,9823,7017
878,Devon,8782431,Decoy Primary School,352,19520,11387,8133
878,Devon,8782432,Highweek Community Primary and Nursery School,252,18520,10803,7717
878,Devon,8782442,Starcross Primary School,163,17630,10284,7346
878,Devon,8782445,Stokeinteignhead School,87,16870,9841,7029
878,Devon,8782446,Stokenham Area Primary School,192,17920,10453,7467
878,Devon,8782448,Hazeldown School,364,19640,11457,8183
878,Devon,8782461,The Grove School,228,18280,10663,7617
878,Devon,8782472,Bradley Barton Primary School and Nursery Unit,318,19180,11188,7992
878,Devon,8782476,Canada Hill Community Primary School,296,18960,11060,7900
878,Devon,8782600,Bere Alston Primary School,165,17650,10296,7354
878,Devon,8782603,Ermington Primary School,127,17270,10074,7196
878,Devon,8782604,Gulworthy Primary School,65,16650,9713,6937
878,Devon,8782605,Hatherleigh Community Primary School,163,17630,10284,7346
878,Devon,8782608,Horrabridge Primary & Nursery School,188,17880,10430,7450
878,Devon,8782609,The Erme Primary School,101,17010,9923,7087
878,Devon,8782610,Manor Primary School Ivybridge,225,18250,10646,7604
878,Devon,8782612,Lifton Community Primary School,82,16820,9812,7008
878,Devon,8782614,Milton Abbot School,62,16620,9695,6925
878,Devon,8782617,Princetown Community Primary School,35,16350,9538,6812
878,Devon,8782618,Shaugh Prior Primary School,37,16370,9549,6821
878,Devon,8782622,Mary Tavy and Brentor Community Primary School,70,16700,9742,6958
878,Devon,8782623,Tavistock Community Primary & Nursery School,316,19160,11177,7983
878,Devon,8782625,Whitchurch Community Primary School,185,17850,10413,7437
878,Devon,8782710,Ugborough Primary School,85,16850,9829,7021
878,Devon,8782715,Modbury Primary School,148,17480,10197,7283
878,Devon,8782717,Bolham Community Primary School,91,16910,9864,7046
878,Devon,8782718,Halberton Primary School,63,16630,9701,6929
878,Devon,8782720,The Castle Primary School,270,18700,10908,7792
878,Devon,8782721,Two Moors Primary School,314,19140,11165,7975
878,Devon,8782723,Heathcoat Primary School,325,19250,11229,8021
878,Devon,8782724,Willowbrook School,315,19150,11171,7979
878,Devon,8783001,Brampford Speke Church of England Primary School,65,16650,9713,6937
878,Devon,8783002,Branscombe Church of England Primary School,21,16210,9456,6754
878,Devon,8783003,Broadhembury Church of England Primary School,26,16260,9485,6775
878,Devon,8783004,Burlescombe Church of England Primary School,45,16450,9596,6854
878,Devon,8783005,St Martins CofE Primary & Nursery School,327,19270,11241,8029
878,Devon,8783011,Withycombe Raleigh Church of England Primary School,532,21320,12437,8883
878,Devon,8783013,Kentisbeare Church of England Primary School,146,17460,10185,7275
878,Devon,8783014,Lympstone Church of England Primary School,147,17470,10191,7279
878,Devon,8783015,Offwell Church of England Primary School,80,16800,9800,7000
878,Devon,8783016,Payhembury Church of England Primary School,77,16770,9783,6987
878,Devon,8783017,Plymtree Church of England Primary School,65,16650,9713,6937
878,Devon,8783022,Silverton Church of England Primary School,101,17010,9923,7087
878,Devon,8783024,Stoke Canon Church of England Primary School and Pre-School,83,16830,9818,7012
878,Devon,8783025,Thorverton Church of England Primary School,67,16670,9724,6946
878,Devon,8783026,Uplowman Church of England Primary School,61,16610,9689,6921
878,Devon,8783028,Littleham Church of England Primary School,133,17330,10109,7221
878,Devon,8783053,Berrynarbor Church of England Primary School,77,16770,9783,6987
878,Devon,8783059,Georgeham Church of England (VC) Primary School,87,16870,9841,7029
878,Devon,8783060,Goodleigh Church of England Primary School,83,16830,9818,7012
878,Devon,8783061,Great Torrington Bluecoat Church of England Primary School,410,20100,11725,8375
878,Devon,8783063,Holsworthy Church of England Primary School,222,18220,10628,7592
878,Devon,8783065,Ilfracombe Church of England Junior School,463,20630,12034,8596
878,Devon,8783066,Parracombe Church of England Primary School,29,16290,9503,6787
878,Devon,8783069,St Marys Church of England Primary School,354,19540,11398,8142
878,Devon,8783101,Berry Pomeroy Parochial Church of England Primary School,85,16850,9829,7021
878,Devon,8783105,Chudleigh Church of England Community Primary School,368,19680,11480,8200
878,Devon,8783107,Dartington Church of England Primary School,220,18200,10617,7583
878,Devon,8783111,Kenn Church of England Primary School,77,16770,9783,6987
878,Devon,8783112,Kingskerswell Church of England Primary School,323,19230,11218,8012
878,Devon,8783114,Malborough with South Huish Church of England Primary School,80,16800,9800,7000
878,Devon,8783128,St Michaels Church of England Primary School,358,19580,11422,8158
878,Devon,8783152,Cornwood Church of England Primary School,63,16630,9701,6929
878,Devon,8783154,Lamerton Church of England Voluntary Controlled Primary School,39,16390,9561,6829
878,Devon,8783300,Awliscombe Church of England Primary School,68,16680,9730,6950
878,Devon,8783304,St Peters Church of England Primary School,240,18400,10733,7667
878,Devon,8783308,Drakes Church of England Primary School,65,16650,9713,6937
878,Devon,8783309,The Beacon Church of England (VA) Primary School,177,17770,10366,7404
878,Devon,8783311,Farway Church of England Primary School,14,14000,8167,5833
878,Devon,8783312,Feniton Church of England Primary School,188,17880,10430,7450
878,Devon,8783313,Webbers Church of England Primary School,71,16710,9748,6962
878,Devon,8783316,Otterton Church of England Primary School,51,16510,9631,6879
878,Devon,8783319,Tipton St John Church of England Primary School,81,16810,9806,7004
878,Devon,8783321,Woodbury Church of England Primary School,175,17750,10354,7396
878,Devon,8783322,Woodbury Salterton Church of England Primary School,50,16500,9625,6875
878,Devon,8783323,St Sidwells Church of England Primary School,174,17740,10348,7392
878,Devon,8783328,Pinhoe Church of England Primary School,356,19560,11410,8150
878,Devon,8783375,Wynstream School,347,19470,11358,8112
878,Devon,8783453,Chittlehampton Church of England Primary School,33,16330,9526,6804
878,Devon,8783455,Lynton Church of England Primary School,44,16440,9590,6850
878,Devon,8783457,St Margarets Church of England (Aided) Junior School,203,18030,10518,7512
878,Devon,8783459,South Molton United Church of England Primary School,151,17510,10214,7296
878,Devon,8783460,Swimbridge Church of England Primary School,89,16890,9853,7037
878,Devon,8783461,St Georges Church of England (VA) Infant and Nursery School,146,17460,10185,7275
878,Devon,8783462,Morchard Bishop Church of England Primary School,96,16960,9893,7067
878,Devon,8783605,St Catherines CofE Nursery & Primary School,144,17440,10173,7267
878,Devon,8783607,Marldon Church of England Primary School,173,17730,10343,7387
878,Devon,8783620,Wolborough Church of England (Aided) Nursery and Primary School,174,17740,10348,7392
878,Devon,8783751,St Marys Church of England Primary School,87,16870,9841,7029
878,Devon,8783752,St Andrews Church of England Primary School,179,17790,10378,7412
878,Devon,8783768,Bickleigh Down Church of England Primary School,358,19580,11422,8158
878,Devon,8783772,Rackenford Church of England Primary School,51,16510,9631,6879
878,Devon,8783777,Clyst Heath Nursery and Community Primary School,268,18680,10897,7783
878,Devon,8783779,Haytor View Community Primary School,152,17520,10220,7300
878,Devon,8787002,Ellen Tinkham School,70,16700,9742,6958
878,Devon,8787006,Mill Water School,54,16540,9648,6892
878,Devon,8787008,Barley Lane School,13,13000,7583,5417
878,Devon,8787020,The Lampard Community School,26,16260,9485,6775
878,Devon,8787021,Pathfield School,53,16530,9643,6887
878,Devon,8787044,Bidwell Brook School,49,16490,9619,6871
878,Devon,8787087,Orchard Manor School,44,32440,18924,13516
878,Devon,8787088,Marland School,12,12000,7000,5000
878,Devon,8782046,Trinity Church of England Voluntary Aided Primary and Nursery School,18,16180,9438,6742
879,Plymouth,8792638,College Road Primary School,177,17770,10366,7404
879,Plymouth,8792640,Laira Green Primary School,249,18490,10786,7704
879,Plymouth,8792670,Pennycross Primary School,278,18780,10955,7825
879,Plymouth,8792671,Lipson Vale Primary School,349,19490,11369,8121
879,Plymouth,8792706,Tor Bridge Primary School,169,17690,10319,7371
879,Plymouth,8792707,Yealmpstone Farm Primary School,172,17720,10337,7383
879,Plymouth,8792729,Whitleigh Community Primary School,310,19100,11142,7958
879,Plymouth,8793159,Compton CofE Primary School,373,19730,11509,8221
879,Plymouth,8793160,St Andrews Cof E VA Primary School,178,17780,10372,7408
879,Plymouth,8793161,Mary Deans CofE Primary School,290,18900,11025,7875
879,Plymouth,8793757,St Budeaux Foundation CofE (Aided) Junior School,147,17470,10191,7279
879,Plymouth,8793759,St Peters CofE Primary School,147,17470,10191,7279
879,Plymouth,8793760,Plympton St Marys CofE Infant School,106,17060,9952,7108
879,Plymouth,8793772,Riverside Community Primary School,458,20580,12005,8575
879,Plymouth,8793777,High View School,270,18700,10908,7792
879,Plymouth,8797062,Woodlands School,38,16380,9555,6825
879,Plymouth,8797063,Cann Bridge School,34,16340,9532,6808
879,Plymouth,8797067,Mount Tamar School,37,16370,9549,6821
879,Plymouth,8797068,Longcause Community Special School,42,16420,9578,6842
879,Plymouth,8797069,Mill Ford School,42,16420,9578,6842
880,Torbay,8802407,Furzeham Primary School,243,18430,10751,7679
880,Torbay,8802439,White Rock Primary School,458,20580,12005,8575
880,Torbay,8802455,Homelands Primary School,178,17780,10372,7408
880,Torbay,8802460,Watcombe Primary School,171,17710,10331,7379
880,Torbay,8802469,Sherwell Valley Primary School,561,21610,12606,9004
880,Torbay,8803103,Brixham Church of England Primary School,181,17810,10389,7421
880,Torbay,8807042,Mayfield School,126,17260,10068,7192
881,Essex,8811120,Childrens Support Service Langdon Hills Basildon,17,16170,9433,6737
881,Essex,8812001,St Georges New Town Junior School,357,19570,11416,8154
881,Essex,8812002,St Georges Infant School and Nursery,180,17800,10383,7417
881,Essex,8812003,Hamilton Primary School,363,19630,11451,8179
881,Essex,8812004,Oakfield Primary School,360,19600,11433,8167
881,Essex,8812005,Grange Primary School,272,18720,10920,7800
881,Essex,8812006,Lexden Primary School with Unit for Hearing Impaired Pupils,176,17760,10360,7400
881,Essex,8812007,Myland Community Primary School,290,18900,11025,7875
881,Essex,8812008,North Primary School and Nursery,355,19550,11404,8146
881,Essex,8812010,Old Heath Community Primary School,179,17790,10378,7412
881,Essex,8812011,St Johns Green Primary School,419,20190,11778,8412
881,Essex,8812013,Holly Trees Primary School,359,19590,11428,8162
881,Essex,8812015,Brightside Primary School,395,19950,11638,8312
881,Essex,8812017,Kings Ford Infant School and Nursery,96,16960,9893,7067
881,Essex,8812020,Springfield Primary School,375,19750,11521,8229
881,Essex,8812027,Oakwood Infant and Nursery School,227,18270,10658,7612
881,Essex,8812028,Frinton-on-Sea Primary School,185,17850,10413,7437
881,Essex,8812034,De Vere Primary School,127,17270,10074,7196
881,Essex,8812038,Langenhoe Community Primary School and Pre-School,121,17210,10039,7171
881,Essex,8812039,Langham Primary School,93,16930,9876,7054
881,Essex,8812041,Stanway Primary School,262,18620,10862,7758
881,Essex,8812042,Tiptree Heath Primary School,148,17480,10197,7283
881,Essex,8812043,Alresford Primary School,126,17260,10068,7192
881,Essex,8812044,Bradfield Primary School,94,16940,9882,7058
881,Essex,8812045,Great Bentley Primary School,182,17820,10395,7425
881,Essex,8812050,Tendring Primary School,120,17200,10033,7167
881,Essex,8812051,Wix and Wrabness Primary School,100,17000,9917,7083
881,Essex,8812054,Gosbecks Primary School,260,18600,10850,7750
881,Essex,8812055,Prettygate Junior School,257,18570,10833,7737
881,Essex,8812056,Prettygate Infant School,120,17200,10033,7167
881,Essex,8812057,Hazelmere Junior School,219,18190,10611,7579
881,Essex,8812058,Hazelmere Infant School and Nursery,120,17200,10033,7167
881,Essex,8812059,The Mayflower Primary School,285,18850,10996,7854
881,Essex,8812062,Montgomery Junior School Colchester,300,19000,11083,7917
881,Essex,8812063,Montgomery Infant School and Nursery Colchester,176,17760,10360,7400
881,Essex,8812064,Home Farm Primary School,186,17860,10418,7442
881,Essex,8812068,Brightlingsea Infant School and Nursery,562,21620,12612,9008
881,Essex,8812069,Broomgrove Infant School,115,17150,10004,7146
881,Essex,8812073,Broomgrove Junior School,227,18270,10658,7612
881,Essex,8812074,Milldene Primary School,149,17490,10203,7287
881,Essex,8812075,Friars Grove Primary School,360,19600,11433,8167
881,Essex,8812081,Stanway Fiveways Primary School,344,19440,11340,8100
881,Essex,8812082,Church Langley Community Primary School,437,20370,11883,8487
881,Essex,8812088,Baynards Primary School,76,16760,9777,6983
881,Essex,8812090,Highfields Primary School,273,18730,10926,7804
881,Essex,8812134,Beckers Green Primary School,276,18760,10943,7817
881,Essex,8812181,Quilters Junior School,261,18610,10856,7754
881,Essex,8812210,Trinity Road Primary School,263,18630,10868,7762
881,Essex,8812250,Bocking Church Street Primary School,202,18020,10512,7508
881,Essex,8812261,Vange Primary School and Nursery,89,16890,9853,7037
881,Essex,8812271,Wickford Junior School,501,21010,12256,8754
881,Essex,8812297,St Michaels Primary School and Nursery Colchester,186,17860,10418,7442
881,Essex,8812300,John Bunyan Primary School and Nursery,464,20640,12040,8600
881,Essex,8812310,Burnham-on-Crouch Primary School,358,19580,11422,8158
881,Essex,8812311,Canvey Junior School,238,18380,10722,7658
881,Essex,8812317,Roach Vale Primary School,178,17780,10372,7408
881,Essex,8812330,Chipping Hill Primary School,239,18390,10728,7662
881,Essex,8812370,Cressing Primary School,132,17320,10103,7217
881,Essex,8812374,Spring Meadow Primary School & School House Nursery,270,18700,10908,7792
881,Essex,8812380,Great Bardfield Primary School,104,17040,9940,7100
881,Essex,8812414,Harwich Community Primary School and Nursery,175,17750,10354,7396
881,Essex,8812450,Great Leighs Primary School,191,17910,10448,7462
881,Essex,8812460,Rettendon Primary School,114,17140,9998,7142
881,Essex,8812500,Highwood Primary School,36,16360,9543,6817
881,Essex,8812510,Felsted Primary School,230,18300,10675,7625
881,Essex,8812521,Holt Farm Infant School,146,17460,10185,7275
881,Essex,8812541,Quilters Infant School,121,17210,10039,7171
881,Essex,8812549,Galleywood Infant School,118,17180,10022,7158
881,Essex,8812550,Stebbing Primary School,109,17090,9969,7121
881,Essex,8812569,Mildmay Infant and Nursery School,183,17830,10401,7429
881,Essex,8812579,Baddow Hall Infant School,136,17360,10127,7233
881,Essex,8812581,Fairhouse Community Primary School,354,19540,11398,8142
881,Essex,8812588,Long Ridings Primary School,356,19560,11410,8150
881,Essex,8812590,Cold Norton Primary School,126,17260,10068,7192
881,Essex,8812599,Ingatestone Infant School,88,16880,9847,7033
881,Essex,8812601,Sunnymede Junior School,263,18630,10868,7762
881,Essex,8812606,Millhouse Primary School,502,21020,12262,8758
881,Essex,8812609,Baddow Hall Junior School,254,18540,10815,7725
881,Essex,8812611,Ghyllgrove Community Junior School,357,19570,11416,8154
881,Essex,8812619,Writtle Infant School,120,17200,10033,7167
881,Essex,8812624,West Horndon Primary School,99,16990,9911,7079
881,Essex,8812630,Tollesbury School,178,17780,10372,7408
881,Essex,8812640,Blackmore Primary School,144,17440,10173,7267
881,Essex,8812647,Limes Farm Junior School,190,17900,10442,7458
881,Essex,8812649,Wentworth Primary School,351,19510,11381,8129
881,Essex,8812656,Down Hall Primary School,253,18530,10809,7721
881,Essex,8812659,Boreham Primary School,187,17870,10424,7446
881,Essex,8812669,John Ray Infant School,193,17930,10459,7471
881,Essex,8812671,Sunnymede Infant School,121,17210,10039,7171
881,Essex,8812679,Powers Hall Infant School,160,17600,10267,7333
881,Essex,8812680,Kelvedon Hatch Community Primary School,158,17580,10255,7325
881,Essex,8812681,South Green Junior School,237,18370,10716,7654
881,Essex,8812710,Ashdon Primary School,77,16770,9783,6987
881,Essex,8812720,Clavering Primary School,157,17570,10249,7321
881,Essex,8812729,Doddinghurst Infant School,113,17130,9993,7137
881,Essex,8812730,Great Sampford Community Primary School,81,16810,9806,7004
881,Essex,8812733,Nazeing Primary School,226,18260,10652,7608
881,Essex,8812737,Hatfield Peverel Infant School,105,17050,9946,7104
881,Essex,8812740,Henham and Ugley Primary and Nursery School,166,17660,10302,7358
881,Essex,8812747,Bentfield Primary School,191,17910,10448,7462
881,Essex,8812750,Manuden Primary School,85,16850,9829,7021
881,Essex,8812751,Canvey Island Infant School,118,17180,10022,7158
881,Essex,8812759,Great Bradfords Junior School,352,19520,11387,8133
881,Essex,8812760,Newport Primary School,157,17570,10249,7321
881,Essex,8812767,White Court School,520,21200,12367,8833
881,Essex,8812769,Great Bradfords Infant and Nursery School,169,17690,10319,7371
881,Essex,8812770,Wimbish Primary School,69,16690,9736,6954
881,Essex,8812779,Danbury Park Community Primary School,226,18260,10652,7608
881,Essex,8812789,Beehive Lane Community Primary School,179,17790,10378,7412
881,Essex,8812798,Eversley Primary School,361,19610,11439,8171
881,Essex,8812799,Priory Primary School Bicknacre,166,17660,10302,7358
881,Essex,8812821,Edward Francis Primary School,363,19630,11451,8179
881,Essex,8812838,Hogarth Primary School,208,18080,10547,7533
881,Essex,8812879,Westlands Community Primary School,493,20930,12209,8721
881,Essex,8812911,South Green Infant School,122,17220,10045,7175
881,Essex,8812918,Willowbrook Primary School,182,17820,10395,7425
881,Essex,8812919,Warley Primary School,186,17860,10418,7442
881,Essex,8812950,Writtle Junior School,239,18390,10728,7662
881,Essex,8812973,Buckhurst Hill Community Primary School,354,19540,11398,8142
881,Essex,8812998,William Read Primary School,353,19530,11393,8137
881,Essex,8813001,Kendall Church of England Primary School,181,17810,10389,7421
881,Essex,8813003,St Johns Church of England Voluntary Controlled Primary School Colchester,213,18130,10576,7554
881,Essex,8813006,Holy Trinity Church of England Voluntary Controlled Primary School Halstead,213,18130,10576,7554
881,Essex,8813008,St Andrews Bulmer Church of England Voluntary Controlled Primary School,36,16360,9543,6817
881,Essex,8813009,St Giles Church of England Primary School,74,16740,9765,6975
881,Essex,8813013,St Peters Church of England Voluntary Controlled Primary School Sible Hedingham,181,17810,10389,7421
881,Essex,8813015,St Margarets Church of England Voluntary Controlled Primary School Toppesfield,67,16670,9724,6946
881,Essex,8813018,Boxted St Peters Church of England School,169,17690,10319,7371
881,Essex,8813019,Chappel Church of England Controlled Primary School,91,16910,9864,7046
881,Essex,8813020,Copford Church of England Voluntary Controlled Primary School,185,17850,10413,7437
881,Essex,8813021,Holy Trinity CofE Primary School Eight Ash Green and Aldham,110,17100,9975,7125
881,Essex,8813022,Dedham Church of England Voluntary Controlled Primary School,181,17810,10389,7421
881,Essex,8813023,St Lawrence Church of England Primary School Rowhedge,161,17610,10273,7337
881,Essex,8813024,Fordham All Saints Church of England Voluntary Controlled Primary School,120,17200,10033,7167
881,Essex,8813025,Great Tey Church of England Voluntary Controlled Primary School,48,16480,9613,6867
881,Essex,8813026,Layer-de-la-Haye Church of England Voluntary Controlled Primary School,176,17760,10360,7400
881,Essex,8813027,St Andrews Church of England Voluntary Controlled Primary School Marks Tey,156,17560,10243,7317
881,Essex,8813028,St Lukes Church of England Controlled Primary School,258,18580,10838,7742
881,Essex,8813029,Heathlands Church of England Voluntary Controlled Primary School West Bergholt,355,19550,11404,8146
881,Essex,8813030,St Marys Church of England Voluntary Controlled Primary School Ardleigh,100,17000,9917,7083
881,Essex,8813032,St Georges Church of England Primary School Great Bromley,103,17030,9934,7096
881,Essex,8813040,Parsons Heath Church of England Voluntary Controlled Primary School,178,17780,10372,7408
881,Essex,8813102,St Nicholas Church of England Voluntary Controlled Primary School Rawreth,125,17250,10063,7187
881,Essex,8813103,Canewdon Endowed Church of England Voluntary Controlled Primary School,103,17030,9934,7096
881,Essex,8813123,Coopersale and Theydon Garnon Church of England Voluntary Controlled Primary School,179,17790,10378,7412
881,Essex,8813131,Sheering Church of England Voluntary Controlled Primary School,95,16950,9888,7062
881,Essex,8813201,All Saints Maldon Church of England Voluntary Controlled Primary School,283,18830,10984,7846
881,Essex,8813208,Finchingfield Church of England Voluntary Controlled Primary School,49,16490,9619,6871
881,Essex,8813209,St Peters Church of England Voluntary Controlled Primary School Coggeshall,269,18690,10903,7787
881,Essex,8813212,Wethersfield Church of England Voluntary Controlled Primary School,73,16730,9759,6971
881,Essex,8813213,White Notley Church of England Voluntary Controlled Primary School,93,16930,9876,7054
881,Essex,8813214,St John Church of England Voluntary Controlled Primary School Danbury,197,17970,10483,7487
881,Essex,8813215,East Hanningfield Church of England Primary School,103,17030,9934,7096
881,Essex,8813217,Great Waltham Church of England Voluntary Controlled Primary School,135,17350,10121,7229
881,Essex,8813218,Ford End Church of England Primary School,61,16610,9689,6921
881,Essex,8813222,Roxwell Church of England Voluntary Controlled Primary School,82,16820,9812,7008
881,Essex,8813224,Downham Church of England Voluntary Controlled Primary School,199,17990,10494,7496
881,Essex,8813225,Stock Church of England Primary School,177,17770,10366,7404
881,Essex,8813232,St Nicholas Church of England Voluntary Controlled Primary School,114,17140,9998,7142
881,Essex,8813235,Woodham Walter Church of England Voluntary Controlled Primary School,89,16890,9853,7037
881,Essex,8813237,Doddinghurst Church of England Voluntary Controlled Junior School,208,18080,10547,7533
881,Essex,8813238,Dr Walkers Church of England Voluntary Controlled Primary School Fyfield,84,16840,9823,7017
881,Essex,8813239,Matching Green Church of England Voluntary Controlled Primary School,72,16720,9753,6967
881,Essex,8813241,Birchanger Church of England Voluntary Controlled Primary School,105,17050,9946,7104
881,Essex,8813244,Elsenham Church of England Voluntary Controlled Primary School,194,17940,10465,7475
881,Essex,8813247,Rickling Church of England Voluntary Controlled Primary School,82,16820,9812,7008
881,Essex,8813251,Two Village Church of England Voluntary Controlled Primary School,160,17600,10267,7333
881,Essex,8813254,Hare Street Community Primary School and Nursery,359,19590,11428,8162
881,Essex,8813257,Abacus Primary School,281,18810,10973,7837
881,Essex,8813302,St Josephs Catholic Primary School Harwich,97,16970,9899,7071
881,Essex,8813308,St John the Baptist Church of England Voluntary Aided Primary School Pebmarsh,61,16610,9689,6921
881,Essex,8813309,Birch Church of England Voluntary Aided Primary School,130,17300,10092,7208
881,Essex,8813310,Fingringhoe Church of England Voluntary Aided Primary School,75,16750,9771,6979
881,Essex,8813314,All Saints Church of England Voluntary Aided Primary School Great Oakley,72,16720,9753,6967
881,Essex,8813324,The Bishop William Ward Church of England Primary School,176,17760,10360,7400
881,Essex,8813402,Bentley St Pauls Church of England Voluntary Aided Primary School,178,17780,10372,7408
881,Essex,8813422,Ingrave Johnstone Church of England Voluntary Aided Primary School,184,17840,10407,7433
881,Essex,8813430,St Marys Church of England Voluntary Aided Primary School,177,17770,10366,7404
881,Essex,8813431,St Anne Line Catholic Junior School,243,18430,10751,7679
881,Essex,8813440,St Michaels Church of England Voluntary Aided Primary School,361,19610,11439,8171
881,Essex,8813450,St Marys Church of England Voluntary Aided Primary School Burnham-on-Crouch,177,17770,10366,7404
881,Essex,8813451,St Anne Line Catholic Infant School,119,17190,10028,7162
881,Essex,8813462,St Peters Church of England Voluntary Aided Primary School South Weald,293,18930,11043,7887
881,Essex,8813470,Terling Church of England Voluntary Aided Primary School,82,16820,9812,7008
881,Essex,8813471,St Peters Catholic Primary School,360,19600,11433,8167
881,Essex,8813501,Churchgate Church of England Voluntary Aided Primary School Harlow,173,17730,10343,7387
881,Essex,8813530,Little Waltham Church of England Voluntary Aided Primary School,161,17610,10273,7337
881,Essex,8813560,St Marys Church of England Voluntary Aided Primary School Woodham Ferrers,46,16460,9602,6858
881,Essex,8813570,Great Easton Church of England Voluntary Aided Primary School,128,17280,10080,7200
881,Essex,8813580,St Marys Church of England Voluntary Aided Primary School Hatfield Broad Oak,91,16910,9864,7046
881,Essex,8813592,St Thomas of Canterbury Church of England Aided Junior School Brentwood,309,19090,11136,7954
881,Essex,8813610,Little Hallingbury Church of England Voluntary Aided Primary School,137,17370,10133,7237
881,Essex,8813612,St Joseph the Worker Catholic Primary School,181,17810,10389,7421
881,Essex,8813622,St Thomas of Canterbury Church of England Aided Infant School,151,17510,10214,7296
881,Essex,8813660,Tolleshunt DArcy St Nicholas CofE VA Primary School,61,16610,9689,6921
881,Essex,8813670,Moreton Church of England Voluntary Aided Primary School,173,17730,10343,7387
881,Essex,8813700,Farnham Church of England Primary School,36,16360,9543,6817
881,Essex,8813730,Radwinter Church of England Voluntary Aided Primary School,94,16940,9882,7058
881,Essex,8813770,St Pius X Catholic Primary School,178,17780,10372,7408
881,Essex,8813780,Ingatestone and Fryerning Church of England Voluntary Aided Junior School,185,17850,10413,7437
881,Essex,8813781,Lincewood Primary School,353,19530,11393,8137
881,Essex,8813790,St Francis Catholic Primary School Braintree,168,17680,10313,7367
881,Essex,8813795,Chrishall Holy Trinity and St Nicholas CofE (Aided) Primary School and Pre-School,92,16920,9870,7050
881,Essex,8813810,St Michaels Church of England Voluntary Aided Junior School,218,18180,10605,7575
881,Essex,8813811,St Francis Catholic Primary School Maldon,169,17690,10319,7371
881,Essex,8813813,Holy Family Catholic Primary School Witham,176,17760,10360,7400
881,Essex,8813814,Trinity St Marys CofE Voluntary Aided Primary School South Woodham Ferrers,170,17700,10325,7375
881,Essex,8813815,St Josephs Catholic Primary School SWF,166,17660,10302,7358
881,Essex,8813820,St Peters Church of England Voluntary Aided Primary School West Hanningfield,88,16880,9847,7033
881,Essex,8813822,All Saints Church of England Voluntary Aided Primary School Dovercourt,165,17650,10296,7354
881,Essex,8813823,The Bishops Church of England and Roman Catholic Primary School,370,19700,11492,8208
881,Essex,8813826,Chancellor Park Primary School Chelmsford,210,18100,10558,7542
881,Essex,8813837,Epping Primary School,353,19530,11393,8137
881,Essex,8813839,Queen Boudica Primary School,356,19560,11410,8150
881,Essex,8813840,Riverside Primary School,259,18590,10844,7746
881,Essex,8815200,Elmwood Primary School,366,19660,11468,8192
881,Essex,8815204,Great Totham Primary School,375,19750,11521,8229
881,Essex,8815216,Holland Haven Primary School,295,18950,11054,7896
881,Essex,8815220,Elmstead Primary School,185,17850,10413,7437
881,Essex,8815221,Millfields Primary School,184,17840,10407,7433
881,Essex,8815224,St Katherines Church of England Primary School,179,17790,10378,7412
881,Essex,8815226,Rodings Primary School,203,18030,10518,7512
881,Essex,8815228,Kingswood Primary School and Nursery,356,19560,11410,8150
881,Essex,8815229,St Marys CofE Foundation Primary School,266,18660,10885,7775
881,Essex,8815236,Buttsbury Infant School,241,18410,10739,7671
881,Essex,8815241,St Andrews CofE Primary School,259,18590,10844,7746
881,Essex,8815242,Leverton Primary School,346,19460,11352,8108
881,Essex,8815246,Waltham Holy Cross Primary School,504,21040,12273,8767
881,Essex,8815248,Thaxted Primary School,211,18110,10564,7546
881,Essex,8815249,The Cathedral Church of England Voluntary Aided Primary School Chelmsford,267,18670,10891,7779
881,Essex,8815252,Broomfield Primary School,269,18690,10903,7787
881,Essex,8815255,St John Fisher Catholic Primary School,308,19080,11130,7950
881,Essex,8815257,Lawford Church of England Voluntary Aided Primary School,178,17780,10372,7408
881,Essex,8815258,Great Dunmow Primary School,357,19570,11416,8154
881,Essex,8815259,Dunmow St Marys Primary School,363,19630,11451,8179
881,Essex,8815260,Walton on the Naze Primary School,224,18240,10640,7600
881,Essex,8815261,Chase Lane Primary School and Nursery,358,19580,11422,8158
881,Essex,8815265,Collingwood Primary School,196,17960,10477,7483
881,Essex,8815267,St Helens Catholic Infant School,176,17760,10360,7400
881,Essex,8815269,Thomas Willingale Primary School and Nursery,353,19530,11393,8137
881,Essex,8815270,Upshire Primary Foundation School,164,17640,10290,7350
881,Essex,8815271,Mersea Island School,364,19640,11457,8183
881,Essex,8815272,Earls Colne Primary School and Nursery,290,18900,11025,7875
881,Essex,8815274,Engaines Primary School and Nursery,246,18460,10768,7692
881,Essex,8815276,Howbridge Infant School,171,17710,10331,7379
881,Essex,8815279,Hatfield Peverel St Andrews Junior School,227,18270,10658,7612
881,Essex,8815280,Brinkley Grove Primary School,360,19600,11433,8167
881,Essex,8817022,Wells Park School,45,16450,9596,6854
881,Essex,8817036,Cedar Hall School,36,16360,9543,6817
881,Essex,8817048,The Edith Borthwick School,103,17030,9934,7096
881,Essex,8817054,Glenwood School,95,16950,9888,7062
881,Essex,8817060,Shorefields School,47,16470,9608,6862
881,Essex,8817069,Lexden Springs School,80,16800,9800,7000
881,Essex,8817070,Harlow Fields School and College,43,16430,9584,6846
882,Southend-on-Sea,8822019,Chalkwell Hall Junior School,476,20760,12110,8650
882,Southend-on-Sea,8822022,Chalkwell Hall Infant School,240,18400,10733,7667
882,Southend-on-Sea,8822023,Earls Hall Primary School,543,21430,12501,8929
882,Southend-on-Sea,8822096,Leigh North Street Primary School,540,21400,12483,8917
882,Southend-on-Sea,8822109,West Leigh Infant School,240,18400,10733,7667
882,Southend-on-Sea,8822124,Barons Court Primary School and Nursery,206,18060,10535,7525
882,Southend-on-Sea,8822126,Heycroft Primary School,360,19600,11433,8167
882,Southend-on-Sea,8822407,Fairways Primary School,374,19740,11515,8225
882,Southend-on-Sea,8823325,St Marys Prittlewell CofE Primary School,504,21040,12273,8767
882,Southend-on-Sea,8823825,Eastwood Primary School & Nursery,347,19470,11358,8112
882,Southend-on-Sea,8823826,Edwards Hall Primary School,347,19470,11358,8112
882,Southend-on-Sea,8825273,Milton Hall Primary School and Nursery,522,21220,12378,8842
883,Thurrock,8832078,Warren Primary School,355,19550,11404,8146
883,Thurrock,8832402,Little Thurrock Primary School,534,21340,12448,8892
883,Thurrock,8832722,Bonnygate Primary School,355,19550,11404,8146
883,Thurrock,8833605,Holy Cross Catholic Primary School,214,18140,10582,7558
884,Herefordshire,8842001,Almeley Primary School,55,16550,9654,6896
884,Herefordshire,8842003,Leominster Primary School,475,20750,12104,8646
884,Herefordshire,8842011,Bredenbury Primary School,40,16400,9567,6833
884,Herefordshire,8842024,St Peters Primary School,169,17690,10319,7371
884,Herefordshire,8842031,Clifford Primary School,79,16790,9794,6996
884,Herefordshire,8842046,Ewyas Harold Primary School,105,17050,9946,7104
884,Herefordshire,8842053,Garway Primary School,54,16540,9648,6892
884,Herefordshire,8842056,Broadlands Primary School,150,17500,10208,7292
884,Herefordshire,8842057,Hampton Dene Primary School,210,18100,10558,7542
884,Herefordshire,8842063,Marlbrook Primary School,449,20490,11953,8537
884,Herefordshire,8842067,St Martins Primary School,278,18780,10955,7825
884,Herefordshire,8842071,Trinity Primary School,518,21180,12355,8825
884,Herefordshire,8842096,Kington Primary School,167,17670,10308,7362
884,Herefordshire,8842098,Ledbury Primary School,352,19520,11387,8133
884,Herefordshire,8842101,Longtown Community Primary School,57,16570,9666,6904
884,Herefordshire,8842103,Luston Primary School,77,16770,9783,6987
884,Herefordshire,8842104,Madley Primary School,174,17740,10348,7392
884,Herefordshire,8842116,Michaelchurch Escley Primary School,46,16460,9602,6858
884,Herefordshire,8842122,Peterchurch Primary School,119,17190,10028,7162
884,Herefordshire,8842138,Ashfield Park Primary School,306,19060,11118,7942
884,Herefordshire,8842146,Shobdon Primary School,73,16730,9759,6971
884,Herefordshire,8842148,Stoke Prior Primary School,82,16820,9812,7008
884,Herefordshire,8842152,St Weonards Primary School,16,16000,9333,6667
884,Herefordshire,8842155,Walford Primary School,176,17760,10360,7400
884,Herefordshire,8842157,Wellington Primary School,58,16580,9672,6908
884,Herefordshire,8842158,Weobley Primary School,146,17460,10185,7275
884,Herefordshire,8842160,Withington Primary School,56,16560,9660,6900
884,Herefordshire,8843006,Bosbury CofE Primary School,120,17200,10033,7167
884,Herefordshire,8843021,Clehonger CofE Primary School,85,16850,9829,7021
884,Herefordshire,8843023,Colwall CofE Primary School,142,17420,10162,7258
884,Herefordshire,8843026,St Marys CofE Primary School,163,17630,10284,7346
884,Herefordshire,8843035,Eardisley CofE Primary School,90,16900,9858,7042
884,Herefordshire,8843046,Goodrich CofE Primary School,116,17160,10010,7150
884,Herefordshire,8843047,Gorsley Goffs Primary School,171,17710,10331,7379
884,Herefordshire,8843071,Little Dewchurch CofE Primary School,91,16910,9864,7046
884,Herefordshire,8843079,Much Birch CofE Primary School,168,17680,10313,7367
884,Herefordshire,8843083,Orleton CofE Primary School,138,17380,10138,7242
884,Herefordshire,8843305,Brampton Abbotts CofE Primary School,112,17120,9987,7133
884,Herefordshire,8843307,Bridstow CofE Primary School,81,16810,9806,7004
884,Herefordshire,8843315,Cradley CofE Primary School,105,17050,9946,7104
884,Herefordshire,8843325,St Marys CofE Primary School,132,17320,10103,7217
884,Herefordshire,8843330,Our Ladys RC Primary School,177,17770,10366,7404
884,Herefordshire,8843331,St Francis Xaviers Primary School,182,17820,10395,7425
884,Herefordshire,8843332,St James CofE Primary School,180,17800,10383,7417
884,Herefordshire,8843341,Kimbolton St James CofE Primary School,71,16710,9748,6962
884,Herefordshire,8843342,Kingsland CofE School,125,17250,10063,7187
884,Herefordshire,8843347,Lea CofE Primary School,98,16980,9905,7075
884,Herefordshire,8843348,Leintwardine Endowed CE Primary School,85,16850,9829,7021
884,Herefordshire,8843349,Ivington CofE Primary School,105,17050,9946,7104
884,Herefordshire,8843363,Much Marcle CofE Primary School,85,16850,9829,7021
884,Herefordshire,8843366,Pembridge CofE Primary School,81,16810,9806,7004
884,Herefordshire,8843367,Pencombe CofE Primary School,33,16330,9526,6804
884,Herefordshire,8843372,St Josephs RC Primary School,95,16950,9888,7062
884,Herefordshire,8843378,Staunton-on-Wye Endowed Primary School,83,16830,9818,7012
884,Herefordshire,8843384,Weston-under-Penyard CofE Primary School,59,16590,9678,6912
884,Herefordshire,8843385,Whitchurch CofE Primary School,115,17150,10004,7146
884,Herefordshire,8843393,Riverside Primary School,480,20800,12133,8667
884,Herefordshire,8847004,Blackmarston School,64,16640,9707,6933
884,Herefordshire,8847007,Westfield School,21,16210,9456,6754
885,Worcestershire,8851103,Perryfields Primary Pupil Referral Unit,11,11000,6417,4583
885,Worcestershire,8851105,The Beacon Primary Short Stay School,8,8000,4667,3333
885,Worcestershire,8852002,Crown Meadow First School & Nursery,235,18350,10704,7646
885,Worcestershire,8852006,Ashton-under-Hill First School,90,16900,9858,7042
885,Worcestershire,8852008,Beoley First School,77,16770,9783,6987
885,Worcestershire,8852013,Broadway First School,69,16690,9736,6954
885,Worcestershire,8852015,Catshill First School,201,18010,10506,7504
885,Worcestershire,8852016,Charford First School,335,19350,11288,8062
885,Worcestershire,8852017,Finstall First School,240,18400,10733,7667
885,Worcestershire,8852018,Lickey End First School,119,17190,10028,7162
885,Worcestershire,8852019,Meadows First School,241,18410,10739,7671
885,Worcestershire,8852020,Millfields First School,216,18160,10593,7567
885,Worcestershire,8852021,Sidemoor First School and Nursery,234,18340,10698,7642
885,Worcestershire,8852022,Blackwell First School,112,17120,9987,7133
885,Worcestershire,8852032,Clifton upon Teme Primary School,56,16560,9660,6900
885,Worcestershire,8852034,Dodford First School,53,16530,9643,6887
885,Worcestershire,8852035,Westlands First School,198,17980,10488,7492
885,Worcestershire,8852036,Chawson First School,291,18910,11031,7879
885,Worcestershire,8852041,Swan Lane First School,301,19010,11089,7921
885,Worcestershire,8852047,Fairfield First School,94,16940,9882,7058
885,Worcestershire,8852055,Hagley Primary School,539,21390,12478,8912
885,Worcestershire,8852118,Pebworth First School,29,16290,9503,6787
885,Worcestershire,8852119,Abbey Park First and Nursery School,123,17230,10051,7179
885,Worcestershire,8852128,Batchley First and Nursery School,211,18110,10564,7546
885,Worcestershire,8852131,Holyoakes Field First School,190,17900,10442,7458
885,Worcestershire,8852136,Tenacres First School,233,18330,10693,7637
885,Worcestershire,8852137,Woodrow First School,233,18330,10693,7637
885,Worcestershire,8852141,Roman Way First School,158,17580,10255,7325
885,Worcestershire,8852147,Stoke Prior First School,117,17170,10016,7154
885,Worcestershire,8852161,Cherry Orchard Primary School,536,21360,12460,8900
885,Worcestershire,8852173,Perdiswell Primary School,352,19520,11387,8133
885,Worcestershire,8852188,Wythall Meadow Green Primary,255,18550,10821,7729
885,Worcestershire,8852192,Moons Moat First School,180,17800,10383,7417
885,Worcestershire,8852197,Beaconside Primary and Nursery School,180,17800,10383,7417
885,Worcestershire,8852200,Pitmaston Primary School,512,21120,12320,8800
885,Worcestershire,8852202,Oldbury Park Primary School,349,19490,11369,8121
885,Worcestershire,8852901,Lickey Hills Primary School and Nursery,354,19540,11398,8142
885,Worcestershire,8852906,Abbey Park Middle School,131,17310,10098,7212
885,Worcestershire,8852907,Comberton Primary School,341,19410,11323,8087
885,Worcestershire,8852910,Franche Primary School,663,22630,13201,9429
885,Worcestershire,8852911,Offmore Primary School,253,18530,10809,7721
885,Worcestershire,8852914,Leigh and Bransford Primary School,111,17110,9981,7129
885,Worcestershire,8852916,Westacre Middle School,256,18560,10827,7733
885,Worcestershire,8852917,Witton Middle School,295,18950,11054,7896
885,Worcestershire,8852920,Oak Hill First School,353,19530,11393,8137
885,Worcestershire,8852921,Holywell Primary and Nursery School,354,19540,11398,8142
885,Worcestershire,8853000,Abberley Parochial VC Primary School,90,16900,9858,7042
885,Worcestershire,8853001,Bayton CofE Primary School,90,16900,9858,7042
885,Worcestershire,8853002,Belbroughton CofE Primary School,146,17460,10185,7275
885,Worcestershire,8853005,Blakedown CofE Primary School,128,17280,10080,7200
885,Worcestershire,8853008,Broadheath CofE Primary School,121,17210,10039,7171
885,Worcestershire,8853010,Far Forest Lea Memorial CofE Primary School,109,17090,9969,7121
885,Worcestershire,8853011,St Annes CofE VC Primary School,261,18610,10856,7754
885,Worcestershire,8853014,Callow End CofE Primary School,86,16860,9835,7025
885,Worcestershire,8853016,Cookley Sebright Primary School,183,17830,10401,7429
885,Worcestershire,8853018,Church Lench CofE First School,59,16590,9678,6912
885,Worcestershire,8853019,Claines CofE Primary School,178,17780,10372,7408
885,Worcestershire,8853020,Cleeve Prior CofE (Controlled) Primary School,33,16330,9526,6804
885,Worcestershire,8853021,St Catherines CofE (VC) Primary School,353,19530,11393,8137
885,Worcestershire,8853022,Clent Parochial Primary School,90,16900,9858,7042
885,Worcestershire,8853023,St Georges CofE Primary School and Nursery,154,17540,10232,7308
885,Worcestershire,8853027,Cropthorne-with-Charlton CofE First School,86,16860,9835,7025
885,Worcestershire,8853029,Defford-Cum-Besford CofE School,35,16350,9538,6812
885,Worcestershire,8853038,Eckington CofE First School,73,16730,9759,6971
885,Worcestershire,8853039,Eldersfield Lawn CofE Primary School,93,16930,9876,7054
885,Worcestershire,8853040,Elmley Castle CofE First School,33,16330,9526,6804
885,Worcestershire,8853042,St Richards CofE First School,286,18860,11002,7858
885,Worcestershire,8853043,St Andrews CE School,199,17990,10494,7496
885,Worcestershire,8853048,Grimley and Holt CofE Primary School,79,16790,9794,6996
885,Worcestershire,8853049,Hanbury CofE First School,97,16970,9899,7071
885,Worcestershire,8853053,Harvington CofE First School,138,17380,10138,7242
885,Worcestershire,8853056,Himbleton CofE First School,49,16490,9619,6871
885,Worcestershire,8853057,Hindlip CofE First School,72,16720,9753,6967
885,Worcestershire,8853074,Malvern Wyche CofE Primary School,120,17200,10033,7167
885,Worcestershire,8853077,Martley CofE Primary School,111,17110,9981,7129
885,Worcestershire,8853084,Overbury CofE First School,56,16560,9660,6900
885,Worcestershire,8853085,Pendock CofE Primary School,41,16410,9573,6837
885,Worcestershire,8853091,Feckenham CofE First School,94,16940,9882,7058
885,Worcestershire,8853092,St Georges CofE First School,166,17660,10302,7358
885,Worcestershire,8853093,St Lukes CofE First School,116,17160,10010,7150
885,Worcestershire,8853094,St Stephens CofE First School,110,17100,9975,7125
885,Worcestershire,8853097,Romsley St Kenelms CofE Primary School,168,17680,10313,7367
885,Worcestershire,8853098,Rushwick CofE Primary School,129,17290,10086,7204
885,Worcestershire,8853099,Sedgeberrow CofE First School,146,17460,10185,7275
885,Worcestershire,8853105,Tibberton CofE First School,57,16570,9666,6904
885,Worcestershire,8853107,Upton-upon-Severn CofE Primary School,155,17550,10238,7312
885,Worcestershire,8853108,Upton Snodsbury CofE First School,55,16550,9654,6896
885,Worcestershire,8853109,Upper Arley CofE VC Primary School,65,16650,9713,6937
885,Worcestershire,8853110,Whittington CofE Primary School,181,17810,10389,7421
885,Worcestershire,8853114,St Barnabas CofE Primary School,360,19600,11433,8167
885,Worcestershire,8853116,Red Hill CofE Primary School,178,17780,10372,7408
885,Worcestershire,8853210,Northleigh CofE Primary School,266,18660,10885,7775
885,Worcestershire,8853300,Astley CofE Primary School,84,16840,9823,7017
885,Worcestershire,8853302,St Andrews CofE First School,179,17790,10378,7412
885,Worcestershire,8853306,The Bredon Hancocks Endowed First School,141,17410,10156,7254
885,Worcestershire,8853308,Broadwas CofE Aided Primary School,85,16850,9829,7021
885,Worcestershire,8853317,St Josephs Catholic Primary School,177,17770,10366,7404
885,Worcestershire,8853324,Fladbury CofE First School,68,16680,9730,6950
885,Worcestershire,8853329,Hallow CofE Primary School,165,17650,10296,7354
885,Worcestershire,8853330,Chaddesley Corbett Endowed Primary School,157,17570,10249,7321
885,Worcestershire,8853331,St Marys CofE (VA) Primary School,162,17620,10278,7342
885,Worcestershire,8853350,Lindridge St Lawrence CE Primary School,73,16730,9759,6971
885,Worcestershire,8853358,St Josephs Catholic Primary School,128,17280,10080,7200
885,Worcestershire,8853359,Malvern Wells CofE Primary School,86,16860,9835,7025
885,Worcestershire,8853360,St James CofE Primary School,85,16850,9829,7021
885,Worcestershire,8853365,Ombersley Endowed First School,94,16940,9882,7058
885,Worcestershire,8853368,Holy Redeemer Catholic Primary School,157,17570,10249,7321
885,Worcestershire,8853381,Sytchampton Endowed Primary School,83,16830,9818,7012
885,Worcestershire,8853382,Tardebigge CofE First School,115,17150,10004,7146
885,Worcestershire,8853387,Our Lady Queen of Peace Catholic Primary,172,17720,10337,7383
885,Worcestershire,8853389,St Georges CofE Primary School,173,17730,10343,7387
885,Worcestershire,8853390,St Georges Catholic Primary School,178,17780,10372,7408
885,Worcestershire,8853391,St Josephs Catholic Primary School,290,18900,11025,7875
885,Worcestershire,8853397,Bewdley Primary School,269,18690,10903,7787
885,Worcestershire,8853400,Grove Primary School,160,17600,10267,7333
885,Worcestershire,8854006,The De Montfort School,138,17380,10138,7242
885,Worcestershire,8854401,Aston Fields Middle School,303,19030,11101,7929
885,Worcestershire,8854402,Catshill Middle School,155,17550,10238,7312
885,Worcestershire,8854403,Parkside Middle School,282,18820,10978,7842
885,Worcestershire,8854408,Blackminster Middle School,64,16640,9707,6933
885,Worcestershire,8854576,St Egwins CofE Middle School,139,17390,10144,7246
885,Worcestershire,8855201,Flyford Flavell First School,61,16610,9689,6921
885,Worcestershire,8855202,St Thomas More Catholic First School,167,17670,10308,7362
885,Worcestershire,8857001,Rigby Hall Day Special School,52,16520,9637,6883
885,Worcestershire,8857009,Pitcheroak School,55,16550,9654,6896
885,Worcestershire,8857015,Chadsgrove School,48,16480,9613,6867
885,Worcestershire,8857025,Fort Royal,175,17750,10354,7396
885,Worcestershire,8857026,Wyre Forest School,91,16910,9864,7046
886,Kent,8862000,St Johns Church of England Primary School,239,18390,10728,7662
886,Kent,8862002,Repton Manor Primary School,360,19600,11433,8167
886,Kent,8862065,The Discovery School,544,21440,12507,8933
886,Kent,8862066,Maypole Primary School,357,19570,11416,8154
886,Kent,8862074,Sunny Bank Primary School,240,18400,10733,7667
886,Kent,8862079,Woodlands Primary School,562,21620,12612,9008
886,Kent,8862088,Crockenhill Primary School,179,17790,10378,7412
886,Kent,8862089,The Anthony Roper Primary School,270,18700,10908,7792
886,Kent,8862094,Cobham Primary School,188,17880,10430,7450
886,Kent,8862095,Cecil Road Primary and Nursery School,327,19270,11241,8029
886,Kent,8862109,Higham Primary School,184,17840,10407,7433
886,Kent,8862116,Lawn Primary School,176,17760,10360,7400
886,Kent,8862119,Shears Green Infant School,239,18390,10728,7662
886,Kent,8862120,Bean Primary School,178,17780,10372,7408
886,Kent,8862127,Paddock Wood Primary School,520,21200,12367,8833
886,Kent,8862128,Capel Primary School,182,17820,10395,7425
886,Kent,8862130,Dunton Green Primary School,143,17430,10168,7262
886,Kent,8862132,Hadlow Primary School,176,17760,10360,7400
886,Kent,8862133,Halstead Community Primary School,79,16790,9794,6996
886,Kent,8862134,Four Elms Primary School,95,16950,9888,7062
886,Kent,8862135,Horsmonden Primary School,173,17730,10343,7387
886,Kent,8862136,Kemsing Primary School,170,17700,10325,7375
886,Kent,8862137,Leigh Primary School,145,17450,10179,7271
886,Kent,8862138,Otford Primary School,339,19390,11311,8079
886,Kent,8862139,Pembury School,421,20210,11789,8421
886,Kent,8862142,Sandhurst Primary School,124,17240,10057,7183
886,Kent,8862147,Weald Community Primary School,143,17430,10168,7262
886,Kent,8862148,Shoreham Village School,76,16760,9777,6983
886,Kent,8862155,Slade Primary School and Attached Unit for Children with Hearing Impairment,316,19160,11177,7983
886,Kent,8862156,Sussex Road Community Primary School,387,19870,11591,8279
886,Kent,8862161,Boughton Monchelsea Primary School,181,17810,10389,7421
886,Kent,8862163,East Farleigh Primary School,174,17740,10348,7392
886,Kent,8862164,East Peckham Primary School,142,17420,10162,7258
886,Kent,8862165,Headcorn Primary School,183,17830,10401,7429
886,Kent,8862166,Hollingbourne Primary School,88,16880,9847,7033
886,Kent,8862167,Ightham Primary School,172,17720,10337,7383
886,Kent,8862168,Lenham Primary School,179,17790,10378,7412
886,Kent,8862169,Platts Heath Primary School,70,16700,9742,6958
886,Kent,8862171,Brunswick House Primary School,360,19600,11433,8167
886,Kent,8862175,North Borough Junior School,326,19260,11235,8025
886,Kent,8862176,Park Way Primary School,272,18720,10920,7800
886,Kent,8862183,Marden Primary School,226,18260,10652,7608
886,Kent,8862185,Mereworth Community Primary School,182,17820,10395,7425
886,Kent,8862187,Offham Primary School,179,17790,10378,7412
886,Kent,8862188,Plaxtol Primary School,79,16790,9794,6996
886,Kent,8862189,Ryarsh Primary School,180,17800,10383,7417
886,Kent,8862190,Shipbourne School,46,16460,9602,6858
886,Kent,8862191,St Katherines School,505,21050,12279,8771
886,Kent,8862192,Staplehurst School,372,19720,11503,8217
886,Kent,8862193,Sutton Valence Primary School,160,17600,10267,7333
886,Kent,8862226,Eastling Primary School,91,16910,9864,7046
886,Kent,8862227,Ethelbert Road Primary School,180,17800,10383,7417
886,Kent,8862228,Davington Primary School,356,19560,11410,8150
886,Kent,8862231,Lower Halstow Primary School,130,17300,10092,7208
886,Kent,8862237,Queenborough School and Nursery,358,19580,11422,8158
886,Kent,8862239,Rodmersham School,82,16820,9812,7008
886,Kent,8862245,Rose Street Primary School,257,18570,10833,7737
886,Kent,8862254,Canterbury Road Primary School,181,17810,10389,7421
886,Kent,8862258,Blean Primary School,375,19750,11521,8229
886,Kent,8862259,Chartham Primary School,296,18960,11060,7900
886,Kent,8862263,Herne Bay Infant School,229,18290,10669,7621
886,Kent,8862265,Hoath Primary School,71,16710,9748,6962
886,Kent,8862268,Westmeads Community Infant School,120,17200,10033,7167
886,Kent,8862269,Whitstable Junior School,269,18690,10903,7787
886,Kent,8862270,Aldington Primary School,173,17730,10343,7387
886,Kent,8862272,East Stour Primary School,359,19590,11428,8162
886,Kent,8862275,Victoria Road Primary School,179,17790,10378,7412
886,Kent,8862276,Willesborough Infant School,263,18630,10868,7762
886,Kent,8862278,Bethersden Primary School,111,17110,9981,7129
886,Kent,8862279,Brook Primary School,83,16830,9818,7012
886,Kent,8862280,Challock Primary School,181,17810,10389,7421
886,Kent,8862282,Great Chart Primary School,421,20210,11789,8421
886,Kent,8862285,Mersham Primary School,174,17740,10348,7392
886,Kent,8862287,Rolvenden Primary School,89,16890,9853,7037
886,Kent,8862289,Smeeth Community Primary School,125,17250,10063,7187
886,Kent,8862296,Mundella Primary School,167,17670,10308,7362
886,Kent,8862298,Hawkinge Primary School,321,19210,11206,8004
886,Kent,8862300,Sellindge Primary School,96,16960,9893,7067
886,Kent,8862312,River Primary School,366,19660,11468,8192
886,Kent,8862318,Langdon Primary School,67,16670,9724,6946
886,Kent,8862320,Eythorne Elvington Community Primary School,94,16940,9882,7058
886,Kent,8862321,Lydden Primary School,79,16790,9794,6996
886,Kent,8862322,Preston Primary School,108,17080,9963,7117
886,Kent,8862326,Wingham Primary School,176,17760,10360,7400
886,Kent,8862327,Worth Primary School,59,16590,9678,6912
886,Kent,8862328,St Mildreds Primary Infant School,178,17780,10372,7408
886,Kent,8862329,Callis Grange Nursery and Infant School,177,17770,10366,7404
886,Kent,8862337,St Crispins Community Primary Infant School,180,17800,10383,7417
886,Kent,8862340,Ellington Infant School,146,17460,10185,7275
886,Kent,8862345,Priory Infant School,118,17180,10022,7158
886,Kent,8862431,Shears Green Junior School,478,20780,12122,8658
886,Kent,8862434,West Minster Primary School,377,19770,11533,8237
886,Kent,8862454,Aycliffe Community Primary School,110,17100,9975,7125
886,Kent,8862459,Riverhead Infants School,180,17800,10383,7417
886,Kent,8862465,Claremont Primary School,438,20380,11888,8492
886,Kent,8862471,Whitfield Aspen School,406,20060,11702,8358
886,Kent,8862474,St Pauls Infant School,180,17800,10383,7417
886,Kent,8862482,Langton Green Primary School,332,19320,11270,8050
886,Kent,8862490,Bishops Down Primary School,266,18660,10885,7775
886,Kent,8862509,Singlewell Primary School,210,18100,10558,7542
886,Kent,8862510,Cheriton Primary School,389,19890,11603,8287
886,Kent,8862514,Brookfield Infant School,117,17170,10016,7154
886,Kent,8862519,Vigo Village School,175,17750,10354,7396
886,Kent,8862520,Madginford Primary School,556,21560,12577,8983
886,Kent,8862524,Palmarsh Primary School,122,17220,10045,7175
886,Kent,8862525,Painters Ash Primary School,355,19550,11404,8146
886,Kent,8862530,Tunbury Primary School,524,21240,12390,8850
886,Kent,8862532,St Margarets-at-Cliffe Primary School,165,17650,10296,7354
886,Kent,8862534,Bysing Wood Primary School,139,17390,10144,7246
886,Kent,8862539,Stocks Green Primary School,188,17880,10430,7450
886,Kent,8862545,Sandgate Primary School,364,19640,11457,8183
886,Kent,8862552,Sandling Primary School,364,19640,11457,8183
886,Kent,8862559,Capel-le-Ferne Primary School,176,17760,10360,7400
886,Kent,8862562,Lunsford Primary School,180,17800,10383,7417
886,Kent,8862569,Briary Primary School,345,19450,11346,8104
886,Kent,8862574,Downs View Infant School,179,17790,10378,7412
886,Kent,8862578,Kingswood Primary School,101,17010,9923,7087
886,Kent,8862586,Senacre Wood Primary School,179,17790,10378,7412
886,Kent,8862603,Bromstone Primary School Broadstairs,427,20270,11824,8446
886,Kent,8862607,Parkside Community Primary School,95,16950,9888,7062
886,Kent,8862611,St Stephens Infant School,180,17800,10383,7417
886,Kent,8862615,High Firs Primary School,177,17770,10366,7404
886,Kent,8862626,Sandwich Infant School,84,16840,9823,7017
886,Kent,8862627,Sandwich Junior School,223,18230,10634,7596
886,Kent,8862629,Holywell Primary School,172,17720,10337,7383
886,Kent,8862632,Sevenoaks Primary School,506,21060,12285,8775
886,Kent,8862643,Swalecliffe Community Primary School,552,21520,12553,8967
886,Kent,8862648,Aylesham Primary School,196,17960,10477,7483
886,Kent,8862651,Broadwater Down Primary School,157,17570,10249,7321
886,Kent,8862653,West Borough Primary School,355,19550,11404,8146
886,Kent,8862661,Cage Green Primary School,364,19640,11457,8183
886,Kent,8862662,Long Mead Community Primary School,133,17330,10109,7221
886,Kent,8862672,Palm Bay Primary School,363,19630,11451,8179
886,Kent,8862674,Kings Farm Primary School,310,19100,11142,7958
886,Kent,8862680,Kings Hill School,419,20190,11778,8412
886,Kent,8862682,New Ash Green Primary School,322,19220,11212,8008
886,Kent,8862689,The Craylands School,205,18050,10529,7521
886,Kent,8862692,The Churchill School,358,19580,11422,8158
886,Kent,8863010,St Pauls Church of England Voluntary Controlled Primary School,95,16950,9888,7062
886,Kent,8863015,Fawkham Church of England Voluntary Controlled Primary School,88,16880,9847,7033
886,Kent,8863020,Sedleys Church of England Voluntary Aided Primary School,85,16850,9829,7021
886,Kent,8863022,Benenden Church of England Primary School,137,17370,10133,7237
886,Kent,8863023,Bidborough Church of England Voluntary Controlled Primary School,181,17810,10389,7421
886,Kent,8863027,Cranbrook Church of England Primary School,136,17360,10127,7233
886,Kent,8863029,Goudhurst and Kilndown Church of England Primary School,183,17830,10401,7429
886,Kent,8863032,Hawkhurst Church of England Primary School,165,17650,10296,7354
886,Kent,8863033,Hildenborough Church of England Primary School,173,17730,10343,7387
886,Kent,8863034,Lamberhurst St Marys CofE (Voluntary Controlled) Primary School,171,17710,10331,7379
886,Kent,8863035,Seal Church of England Voluntary Controlled Primary School,222,18220,10628,7592
886,Kent,8863037,St Johns Church of England Primary School Sevenoaks,213,18130,10576,7554
886,Kent,8863042,Speldhurst Church of England Voluntary Aided Primary School,125,17250,10063,7187
886,Kent,8863043,Sundridge and Brasted Church of England Voluntary Controlled Primary School,80,16800,9800,7000
886,Kent,8863049,St James Church of England Junior School,359,19590,11428,8162
886,Kent,8863050,St Johns Church of England Primary School,555,21550,12571,8979
886,Kent,8863052,St Marks Church of England Primary School,246,18460,10768,7692
886,Kent,8863053,St Peters Church of England Primary School,120,17200,10033,7167
886,Kent,8863054,Crockham Hill Church of England Voluntary Controlled Primary School,118,17180,10022,7158
886,Kent,8863055,Churchill Church of England Voluntary Controlled Primary School,243,18430,10751,7679
886,Kent,8863057,St Peters Church of England Primary School,146,17460,10185,7275
886,Kent,8863061,Bredhurst Church of England Voluntary Controlled Primary School,105,17050,9946,7104
886,Kent,8863062,Burham Church of England Primary School,131,17310,10098,7212
886,Kent,8863067,Harrietsham Church of England Primary School,172,17720,10337,7383
886,Kent,8863069,Leeds and Broomfield Church of England Primary School,74,16740,9765,6975
886,Kent,8863072,Maidstone St Michaels Church of England Junior School,159,17590,10261,7329
886,Kent,8863073,St Michaels Church of England Infant School Maidstone,80,16800,9800,7000
886,Kent,8863081,Thurnham Church of England Infant School,183,17830,10401,7429
886,Kent,8863082,Trottiscliffe Church of England Primary School,59,16590,9678,6912
886,Kent,8863083,Ulcombe Church of England Primary School,60,16600,9683,6917
886,Kent,8863084,Wateringbury Church of England Primary School,171,17710,10331,7379
886,Kent,8863088,Wouldham All Saints Church of England Voluntary Controlled Primary School,179,17790,10378,7412
886,Kent,8863089,St Georges Church of England Voluntary Controlled Primary School,181,17810,10389,7421
886,Kent,8863090,St Margarets Collier Street Church of England Voluntary Controlled School,99,16990,9911,7079
886,Kent,8863091,Laddingford St Marys Church of England Voluntary Controlled Primary School,69,16690,9736,6954
886,Kent,8863092,Yalding St Peter and St Paul Church of England Voluntary Controlled Primary School,131,17310,10098,7212
886,Kent,8863106,Eastchurch Church of England Primary School,398,19980,11655,8325
886,Kent,8863108,Ospringe Church of England Primary School,214,18140,10582,7558
886,Kent,8863109,Hernhill Church of England Primary School,177,17770,10366,7404
886,Kent,8863111,Newington Church of England Primary School,152,17520,10220,7300
886,Kent,8863117,Teynham Parochial Church of England Primary School,175,17750,10354,7396
886,Kent,8863120,Barham Church of England Primary School,175,17750,10354,7396
886,Kent,8863122,Bridge and Patrixbourne Church of England Primary School,360,19600,11433,8167
886,Kent,8863123,Chislet Church of England Primary School,80,16800,9800,7000
886,Kent,8863126,Littlebourne Church of England Primary School,81,16810,9806,7004
886,Kent,8863129,St Alphege Church of England Infant School,121,17210,10039,7171
886,Kent,8863130,Wickhambreaux Church of England Primary School,108,17080,9963,7117
886,Kent,8863134,John Mayne Church of England Primary School Biddenden,110,17100,9975,7125
886,Kent,8863136,Brabourne Church of England Primary School,90,16900,9858,7042
886,Kent,8863137,Brookland Church of England Primary School,85,16850,9829,7021
886,Kent,8863138,Chilham St Marys Church of England Primary School,78,16780,9788,6992
886,Kent,8863139,High Halden Church of England Primary School,84,16840,9823,7017
886,Kent,8863145,Woodchurch Church of England Primary School,148,17480,10197,7283
886,Kent,8863146,Bodsham Church of England Primary School,86,16860,9835,7025
886,Kent,8863149,Folkestone St Martins Church of England Primary School,179,17790,10378,7412
886,Kent,8863150,Folkestone St Peters Church of England Primary School,86,16860,9835,7025
886,Kent,8863153,Seabrook Church of England Primary School,91,16910,9864,7046
886,Kent,8863154,Lyminge Church of England Primary School,170,17700,10325,7375
886,Kent,8863155,Lympne Church of England Primary School,189,17890,10436,7454
886,Kent,8863158,Stelling Minnis Church of England Primary School,89,16890,9853,7037
886,Kent,8863159,Stowting Church of England Primary School,82,16820,9812,7008
886,Kent,8863160,Selsted Church of England Primary School,87,16870,9841,7029
886,Kent,8863167,Eastry Church of England Primary School,185,17850,10413,7437
886,Kent,8863168,Goodnestone Church of England Primary School,55,16550,9654,6896
886,Kent,8863169,Guston Church of England Primary School,127,17270,10074,7196
886,Kent,8863171,Nonington Church of England Primary School,54,16540,9648,6892
886,Kent,8863173,Kingsdown and Ringwould CofE Primary School,189,17890,10436,7454
886,Kent,8863175,Sibertswold Church of England Primary School at Shepherdswell,177,17770,10366,7404
886,Kent,8863178,Birchington Church of England Primary School,389,19890,11603,8287
886,Kent,8863179,Margate Holy Trinity and St Johns Church of England Primary School,335,19350,11288,8062
886,Kent,8863181,St Saviours Church of England Junior School,385,19850,11579,8271
886,Kent,8863182,Minster Church of England Primary School,356,19560,11410,8150
886,Kent,8863183,Monkton Church of England Primary School,92,16920,9870,7050
886,Kent,8863186,St Nicholas At Wade Church of England Primary School,183,17830,10401,7429
886,Kent,8863198,Frittenden Church of England Primary School,84,16840,9823,7017
886,Kent,8863199,Egerton Church of England Primary School,177,17770,10366,7404
886,Kent,8863201,St Lawrence Church of England Primary School,73,16730,9759,6971
886,Kent,8863282,Boughton-under-Blean and Dunkirk Primary School,193,17930,10459,7471
886,Kent,8863284,Lady Joanna Thornhill Endowed Primary School,367,19670,11474,8196
886,Kent,8863289,St Peters Methodist Primary School,174,17740,10348,7392
886,Kent,8863294,St Matthews High Brooms Church of England Voluntary Controlled Primary School,392,19920,11620,8300
886,Kent,8863295,Herne Church of England Infant School,178,17780,10372,7408
886,Kent,8863296,Langafel Church of England Voluntary Controlled Primary School,285,18850,10996,7854
886,Kent,8863297,Southborough CofE Primary School,466,20660,12052,8608
886,Kent,8863298,West Kingsdown CofE VC Primary School,130,17300,10092,7208
886,Kent,8863299,The John Wesley Church of England Methodist Voluntary Aided Primary School,364,19640,11457,8183
886,Kent,8863303,St Katharines Knockholt Church of England Voluntary Aided Primary School,165,17650,10296,7354
886,Kent,8863307,Chevening St Botolphs Church of England Voluntary Aided Primary School,180,17800,10383,7417
886,Kent,8863308,Colliers Green Church of England Primary School,95,16950,9888,7062
886,Kent,8863309,Sissinghurst Voluntary Aided Church of England Primary School,140,17400,10150,7250
886,Kent,8863312,Hever Church of England Voluntary Aided Primary School,103,17030,9934,7096
886,Kent,8863314,Penshurst Church of England Voluntary Aided Primary School,88,16880,9847,7033
886,Kent,8863317,Lady Boswells Church of England Voluntary Aided Primary School Sevenoaks,310,19100,11142,7958
886,Kent,8863318,Ide Hill Church of England Primary School,115,17150,10004,7146
886,Kent,8863320,St Barnabas CofE VA Primary School,174,17740,10348,7392
886,Kent,8863322,St James Church of England Voluntary Aided Infant School,180,17800,10383,7417
886,Kent,8863323,Hunton Church of England Primary School,82,16820,9812,7008
886,Kent,8863325,Platt Church of England Voluntary Aided Primary School,123,17230,10051,7179
886,Kent,8863328,Bapchild and Tonge Church of England Primary School,176,17760,10360,7400
886,Kent,8863332,Hartlip Endowed Church of England Primary School,90,16900,9858,7042
886,Kent,8863337,Tunstall Church of England (Aided) Primary School,240,18400,10733,7667
886,Kent,8863338,Herne Church of England Junior School,361,19610,11439,8171
886,Kent,8863339,Whitstable and Seasalter Endowed Church of England Junior School,194,17940,10465,7475
886,Kent,8863340,Ashford St Marys Church of England Primary School,358,19580,11422,8158
886,Kent,8863346,Wittersham Church of England Primary School,108,17080,9963,7117
886,Kent,8863347,Elham Church of England Primary School,113,17130,9993,7137
886,Kent,8863350,Saltwood CofE Primary School,190,17900,10442,7458
886,Kent,8863351,Ash Cartwright and Kelsey Church of England Primary School,139,17390,10144,7246
886,Kent,8863356,Dover St Marys Church of England Primary School,187,17870,10424,7446
886,Kent,8863360,St Peter-in-Thanet CofE Junior School,375,19750,11521,8229
886,Kent,8863364,Ramsgate Holy Trinity Church of England Primary School,180,17800,10383,7417
886,Kent,8863373,St Marys Church of England Voluntary Aided Primary School,168,17680,10313,7367
886,Kent,8863718,St Augustines Catholic Primary School,173,17730,10343,7387
886,Kent,8863722,St Ethelberts Catholic Primary School,182,17820,10395,7425
886,Kent,8863728,St Anselms Catholic Primary School,180,17800,10383,7417
886,Kent,8863733,Our Ladys Catholic Primary School Dartford,188,17880,10430,7450
886,Kent,8863749,St Thomas Catholic Primary School Canterbury,179,17790,10378,7412
886,Kent,8863893,Phoenix Community Primary School,180,17800,10383,7417
886,Kent,8863896,Downsview Community Primary School,170,17700,10325,7375
886,Kent,8863898,Greenfields Community Primary School,274,18740,10932,7808
886,Kent,8863902,Hythe Bay CofE Primary School,352,19520,11387,8133
886,Kent,8863904,Castle Hill Community Primary School,333,19330,11276,8054
886,Kent,8863906,Palace Wood Primary School,357,19570,11416,8154
886,Kent,8863907,Hextable Primary School,387,19870,11591,8279
886,Kent,8863909,Ashford Oaks Community Primary School,359,19590,11428,8162
886,Kent,8863910,Joy Lane Primary School,469,20690,12069,8621
886,Kent,8863913,Rusthall St Pauls CofE VA Primary School,184,17840,10407,7433
886,Kent,8863916,Green Park Community Primary School,301,19010,11089,7921
886,Kent,8863917,Garlinge Primary School and Nursery,633,22330,13026,9304
886,Kent,8863918,Newington Community Primary School,557,21570,12583,8987
886,Kent,8863919,Dartford Bridge Community Primary School,304,19040,11107,7933
886,Kent,8863920,Goat Lees Primary School,176,17760,10360,7400
886,Kent,8865200,Snodland CofE Primary School,319,19190,11194,7996
886,Kent,8865201,Borough Green Primary School,249,18490,10786,7704
886,Kent,8865202,Holy Trinity Church of England Voluntary Aided Primary School,368,19680,11480,8200
886,Kent,8865203,Roseacre Junior School,423,20230,11801,8429
886,Kent,8865206,Herne Bay Junior School,482,20820,12145,8675
886,Kent,8865207,St Francis Catholic Primary School Maidstone,356,19560,11410,8150
886,Kent,8865208,Ditton Church of England Junior School,248,18480,10780,7700
886,Kent,8865212,Ditton Infant School,118,17180,10022,7158
886,Kent,8865213,Holy Trinity Church of England Primary School Dartford,362,19620,11445,8175
886,Kent,8865214,St Bartholomews Catholic Primary School Swanley,300,19000,11083,7917
886,Kent,8865218,Greatstone Primary School,311,19110,11148,7962
886,Kent,8865221,Wincheap Foundation Primary School,378,19780,11538,8242
886,Kent,8865223,Brookfield Junior School,239,18390,10728,7662
886,Kent,8865225,Harcourt Primary School,140,17400,10150,7250
886,Kent,8865226,Willesborough Junior School,474,20740,12098,8642
886,Kent,8865229,Fleetdown Primary School,519,21190,12361,8829
886,Kent,8865447,St Georges Church of England Foundation School,120,17200,10033,7167
886,Kent,8867021,Valence School,19,16190,9444,6746
886,Kent,8867032,Bower Grove School,93,16930,9876,7054
886,Kent,8867033,St Anthonys School,34,16340,9532,6808
886,Kent,8867039,Ifield School,97,16970,9899,7071
886,Kent,8867040,Foreland Fields School,95,16950,9888,7062
886,Kent,8867043,The Beacon Folkestone,129,17290,10086,7204
886,Kent,8867044,Rowhill School,35,16350,9538,6812
886,Kent,8867045,Elms School,47,16470,9608,6862
886,Kent,8867051,Nexus Foundation Special School,63,16630,9701,6929
886,Kent,8867056,Five Acre Wood School,181,17810,10389,7421
886,Kent,8867058,Stone Bay School,6,6000,3500,2500
886,Kent,8867062,The Orchard School,25,16250,9479,6771
886,Kent,8867063,St Nicholas School,92,16920,9870,7050
886,Kent,8867069,The Wyvern School (Buxford),112,17120,9987,7133
886,Kent,8867070,Oakley School,72,16720,9753,6967
886,Kent,8867072,Meadowfield School,111,17110,9981,7129
886,Kent,8867073,Laleham Gap School,52,16520,9637,6883
887,Medway,8872198,Greenvale Infant School,118,17180,10022,7158
887,Medway,8872199,Luton Junior School,354,19540,11398,8142
887,Medway,8872201,Luton Infant & Nursery School,175,17750,10354,7396
887,Medway,8872202,New Road Primary School,264,18640,10873,7767
887,Medway,8872210,Wainscott Primary School,300,19000,11083,7917
887,Medway,8872215,Balfour Infant School,179,17790,10378,7412
887,Medway,8872216,Crest Infant School,175,17750,10354,7396
887,Medway,8872403,Hempstead Junior School,354,19540,11398,8142
887,Medway,8872433,Oaklands School,342,19420,11328,8092
887,Medway,8872439,Horsted Infant School,120,17200,10033,7167
887,Medway,8872493,Park Wood Junior School,357,19570,11416,8154
887,Medway,8872494,Park Wood Infant School,182,17820,10395,7425
887,Medway,8872506,Horsted Junior School,244,18440,10757,7683
887,Medway,8872549,Swingate Primary School,531,21310,12431,8879
887,Medway,8872638,Hempstead Infant School,173,17730,10343,7387
887,Medway,8872665,St Peters Infant School,74,16740,9765,6975
887,Medway,8873096,St Helens Church of England Primary School Cliffe,181,17810,10389,7421
887,Medway,8873102,St Nicholas Church of England Voluntary Controlled Infant School,80,16800,9800,7000
887,Medway,8873712,St Michaels RC Primary School,356,19560,11410,8150
887,Medway,8873729,English Martyrs Catholic Primary School,180,17800,10383,7417
887,Medway,8873732,St Thomas of Canterbury RC Primary School,211,18110,10564,7546
887,Medway,8873736,St Thomas More Roman Catholic Primary School,363,19630,11451,8179
887,Medway,8873746,St William of Perth Roman Catholic Primary School,181,17810,10389,7421
887,Medway,8873752,St Augustine of Canterbury Catholic Primary School,175,17750,10354,7396
887,Medway,8873753,St Benedicts Catholic Primary School,180,17800,10383,7417
887,Medway,8873755,St Marys Catholic Primary School,360,19600,11433,8167
887,Medway,8873756,St Marys Island Church of England (Aided) Primary School,361,19610,11439,8171
887,Medway,8873759,Fairview Community Primary School,529,21290,12419,8871
887,Medway,8873760,Burnt Oak Primary School,356,19560,11410,8150
887,Medway,8877053,Abbey Court Foundation Special School,55,16550,9654,6896
888,Lancashire,8881100,Stepping Stones School,3,3000,1750,1250
888,Lancashire,8881103,Golden Hill Pupil Referral Unit,21,16210,9456,6754
888,Lancashire,8881107,Hendon Brook School,27,16270,9491,6779
888,Lancashire,8882014,North Road Primary School,153,17530,10226,7304
888,Lancashire,8882015,St John the Baptist Roman Catholic Primary School,235,18350,10704,7646
888,Lancashire,8882016,Forton Primary School,63,16630,9701,6929
888,Lancashire,8882017,Bowerham  Primary & Nursery School,355,19550,11404,8146
888,Lancashire,8882019,Lancaster Dallas Road Community Primary School,356,19560,11410,8150
888,Lancashire,8882020,Ridge Community Primary School,161,17610,10273,7337
888,Lancashire,8882021,Lancaster Ryelands Primary School,307,19070,11124,7946
888,Lancashire,8882024,Willow Lane Community Primary School,172,17720,10337,7383
888,Lancashire,8882025,Morecambe Bay Community Primary School,266,18660,10885,7775
888,Lancashire,8882027,Lancaster Road Primary School,414,20140,11748,8392
888,Lancashire,8882028,Morecambe and Heysham Sandylands Community Primary School,348,19480,11363,8117
888,Lancashire,8882029,West End Primary School,172,17720,10337,7383
888,Lancashire,8882030,Nateby Primary School,67,16670,9724,6946
888,Lancashire,8882031,Nether Kellet Community Primary School,90,16900,9858,7042
888,Lancashire,8882041,Kirkham and Wesham Primary School,175,17750,10354,7396
888,Lancashire,8882042,Ansdell Primary School,210,18100,10558,7542
888,Lancashire,8882045,Stalmine Primary School,63,16630,9701,6929
888,Lancashire,8882047,Thornton Primary School,95,16950,9888,7062
888,Lancashire,8882048,Thornton Cleveleys Royles Brook Primary School,234,18340,10698,7642
888,Lancashire,8882049,Farington Primary School,168,17680,10313,7367
888,Lancashire,8882050,Fulwood and Cadley Primary School,266,18660,10885,7775
888,Lancashire,8882051,Harris Primary School,183,17830,10401,7429
888,Lancashire,8882052,Kennington Primary School,209,18090,10553,7537
888,Lancashire,8882053,Goosnargh Whitechapel Primary School,79,16790,9794,6996
888,Lancashire,8882054,Lea Community Primary School,175,17750,10354,7396
888,Lancashire,8882055,Little Hoole Primary School,171,17710,10331,7379
888,Lancashire,8882058,Penwortham Primary School,174,17740,10348,7392
888,Lancashire,8882059,Tarleton Community Primary School,241,18410,10739,7671
888,Lancashire,8882060,Lostock Hall Community Primary School,344,19440,11340,8100
888,Lancashire,8882062,Catforth Primary School,55,16550,9654,6896
888,Lancashire,8882064,Clitheroe Pendle Primary School,297,18970,11066,7904
888,Lancashire,8882067,Great Harwood Primary School,129,17290,10086,7204
888,Lancashire,8882071,Padiham Primary School,253,18530,10809,7721
888,Lancashire,8882073,Sabden Primary School,66,16660,9718,6942
888,Lancashire,8882074,Barrowford School,340,19400,11317,8083
888,Lancashire,8882076,Briercliffe Primary School,268,18680,10897,7783
888,Lancashire,8882082,Park Primary School,328,19280,11247,8033
888,Lancashire,8882083,Colne Primet Primary School,166,17660,10302,7358
888,Lancashire,8882085,West Street Community Primary School,162,17620,10278,7342
888,Lancashire,8882087,Bradley Primary School,362,19620,11445,8175
888,Lancashire,8882089,Marsden Community Primary School,370,19700,11492,8208
888,Lancashire,8882090,Lomeshaye Junior School,357,19570,11416,8154
888,Lancashire,8882092,Walverden Primary School,359,19590,11428,8162
888,Lancashire,8882093,Whitefield Infant School and Nursery,178,17780,10372,7408
888,Lancashire,8882094,Trawden Forest Primary School,167,17670,10308,7362
888,Lancashire,8882095,Worsthorne Primary School,183,17830,10401,7429
888,Lancashire,8882096,Accrington Huncoat Primary School,160,17600,10267,7333
888,Lancashire,8882097,Accrington Hyndburn Park Primary School,382,19820,11562,8258
888,Lancashire,8882099,Accrington Peel Park Primary School,527,21270,12408,8862
888,Lancashire,8882101,Accrington Spring Hill Community Primary School,351,19510,11381,8129
888,Lancashire,8882105,Clayton-le-Moors Mount Pleasant Primary School,341,19410,11323,8087
888,Lancashire,8882107,Oswaldtwistle Moor End Primary School,159,17590,10261,7329
888,Lancashire,8882108,Oswaldtwistle West End Primary School,177,17770,10366,7404
888,Lancashire,8882109,Britannia Community Primary School,195,17950,10471,7479
888,Lancashire,8882111,Northern Primary School,165,17650,10296,7354
888,Lancashire,8882112,Bacup St Saviours Community Primary School,75,16750,9771,6979
888,Lancashire,8882113,Sharneyford Primary School,57,16570,9666,6904
888,Lancashire,8882114,Bacup Thorn Primary School,231,18310,10681,7629
888,Lancashire,8882117,Haslingden Primary School,353,19530,11393,8137
888,Lancashire,8882118,Helmshore Primary School,357,19570,11416,8154
888,Lancashire,8882121,Ramsbottom Stubbins Primary School,178,17780,10372,7408
888,Lancashire,8882128,Water Primary School,95,16950,9888,7062
888,Lancashire,8882129,Waterfoot Primary School,266,18660,10885,7775
888,Lancashire,8882140,Anderton Primary School,171,17710,10331,7379
888,Lancashire,8882142,Brindle Gregson Lane Primary School,168,17680,10313,7367
888,Lancashire,8882145,Highfield Primary School,236,18360,10710,7650
888,Lancashire,8882146,Buckshaw Primary School,174,17740,10348,7392
888,Lancashire,8882147,Coppull Primary School and Nursery,211,18110,10564,7546
888,Lancashire,8882150,Woodlea Junior School,230,18300,10675,7625
888,Lancashire,8882156,Pinfold Primary School,36,16360,9543,6817
888,Lancashire,8882162,Burnley Lowerhouse Junior School,209,18090,10553,7537
888,Lancashire,8882164,Burnley Brunshaw Primary School,357,19570,11416,8154
888,Lancashire,8882183,Crawford Village Primary School,45,16450,9596,6854
888,Lancashire,8882184,Wrightington Mossy Lea Primary School,26,16260,9485,6775
888,Lancashire,8882185,Brookfield Community Primary School,148,17480,10197,7283
888,Lancashire,8882187,Deepdale Community Primary School,530,21300,12425,8875
888,Lancashire,8882188,Eldon Primary School,167,17670,10308,7362
888,Lancashire,8882189,Brockholes Wood Community Primary School and Nursery,197,17970,10483,7487
888,Lancashire,8882190,Frenchwood Community Primary School,285,18850,10996,7854
888,Lancashire,8882191,Preston Grange Primary School,158,17580,10255,7325
888,Lancashire,8882192,Preston Greenlands Community Primary School,169,17690,10319,7371
888,Lancashire,8882193,Holme Slack Community Primary School,163,17630,10284,7346
888,Lancashire,8882195,Ribbleton Avenue Infant School,132,17320,10103,7217
888,Lancashire,8882196,Moor Nook Community Primary School,162,17620,10278,7342
888,Lancashire,8882197,The Roebuck School,245,18450,10763,7687
888,Lancashire,8882198,Ashton Primary School,174,17740,10348,7392
888,Lancashire,8882200,Ingol Community Primary School,120,17200,10033,7167
888,Lancashire,8882214,Kelbrook Primary School,86,16860,9835,7025
888,Lancashire,8882215,Earby Springfield Primary School,143,17430,10168,7262
888,Lancashire,8882224,Burnley Stoneyholme Community Primary School,358,19580,11422,8158
888,Lancashire,8882226,Rosegrove Infant School,108,17080,9963,7117
888,Lancashire,8882228,Barden Primary School,367,19670,11474,8196
888,Lancashire,8882230,Burnley Heasandford Primary School,542,21420,12495,8925
888,Lancashire,8882235,Whittlefield Primary School,174,17740,10348,7392
888,Lancashire,8882237,Burnley Ightenhill Primary School,311,19110,11148,7962
888,Lancashire,8882238,Gisburn Road Community Primary School,160,17600,10267,7333
888,Lancashire,8882240,Salterforth Primary School,90,16900,9858,7042
888,Lancashire,8882266,Gisburn Primary School,116,17160,10010,7150
888,Lancashire,8882272,Tonacliffe Primary School,272,18720,10920,7800
888,Lancashire,8882368,Trumacar Nursery and Community Primary School,299,18990,11078,7912
888,Lancashire,8882370,Moorside Primary School,429,20290,11836,8454
888,Lancashire,8882391,Edisford Primary School,192,17920,10453,7467
888,Lancashire,8882396,Poulton-le-Fylde Carr Head Primary School,188,17880,10430,7450
888,Lancashire,8882404,Charles Saer Community Primary School,262,18620,10862,7758
888,Lancashire,8882405,Kingsfold Primary School,117,17170,10016,7154
888,Lancashire,8882406,Weeton Primary School,138,17380,10138,7242
888,Lancashire,8882409,Rawtenstall Balladen Community Primary School,179,17790,10378,7412
888,Lancashire,8882415,Ormskirk West End Primary School,97,16970,9899,7071
888,Lancashire,8882425,Morecambe and Heysham Torrisholme Community Primary School,355,19550,11404,8146
888,Lancashire,8882426,Lytham St Annes Mayfield Primary School,297,18970,11066,7904
888,Lancashire,8882427,Seven Stars Primary School,159,17590,10261,7329
888,Lancashire,8882437,Walton-le-Dale Community Primary School,356,19560,11410,8150
888,Lancashire,8882443,Aughton Town Green Primary School,270,18700,10908,7792
888,Lancashire,8882446,Freckleton Strike Lane Primary School,168,17680,10313,7367
888,Lancashire,8882492,Northfold Community Primary School,178,17780,10372,7408
888,Lancashire,8882497,Clifton Primary School,222,18220,10628,7592
888,Lancashire,8882509,Queens Drive Primary School,384,19840,11573,8267
888,Lancashire,8882514,Whitefield Primary School,336,19360,11293,8067
888,Lancashire,8882517,Stanah Primary School,345,19450,11346,8104
888,Lancashire,8882525,Little Digmoor Primary School,75,16750,9771,6979
888,Lancashire,8882526,Hillside Community Primary School,168,17680,10313,7367
888,Lancashire,8882527,Larkholme Primary School,251,18510,10798,7712
888,Lancashire,8882530,Garstang Community Primary School,176,17760,10360,7400
888,Lancashire,8882541,Poulton-le-Fylde the Breck Primary School,244,18440,10757,7683
888,Lancashire,8882552,Delph Side Community Primary School,141,17410,10156,7254
888,Lancashire,8882554,Lever House Primary School,237,18370,10716,7654
888,Lancashire,8882564,Withnell Fold Primary School,80,16800,9800,7000
888,Lancashire,8882565,Abbey Village Primary School,68,16680,9730,6950
888,Lancashire,8882572,Euxton Primrose Hill Primary School,246,18460,10768,7692
888,Lancashire,8882574,Eccleston Primary School,173,17730,10343,7387
888,Lancashire,8882576,Great Wood Primary School,343,19430,11334,8096
888,Lancashire,8882577,Balshaw Lane Community Primary School,238,18380,10722,7658
888,Lancashire,8882595,Crawshawbooth Primary School,271,18710,10914,7796
888,Lancashire,8882597,Ormskirk Asmall Primary School,130,17300,10092,7208
888,Lancashire,8882615,Lytham Hall Park Primary School,353,19530,11393,8137
888,Lancashire,8882622,Carleton Green Community Primary School,271,18710,10914,7796
888,Lancashire,8882636,Clayton-le-Woods Manor Road Primary School,206,18060,10535,7525
888,Lancashire,8882637,Coupe Green Primary School,111,17110,9981,7129
888,Lancashire,8882646,Reedley Primary School,348,19480,11363,8117
888,Lancashire,8882651,Clitheroe Brookside Primary School,158,17580,10255,7325
888,Lancashire,8882653,Caton Community Primary School,30,16300,9508,6792
888,Lancashire,8882656,Holland Moor Primary School,401,20010,11673,8337
888,Lancashire,8882679,Gillibrand Primary School,182,17820,10395,7425
888,Lancashire,8882684,Lancaster Lane Community Primary School,180,17800,10383,7417
888,Lancashire,8882687,Haslingden Broadway Primary School,181,17810,10389,7421
888,Lancashire,8882695,Burscough Village Primary School,177,17770,10366,7404
888,Lancashire,8882696,Cobbs Brow School,248,18480,10780,7700
888,Lancashire,8882698,Adlington Primary School,112,17120,9987,7133
888,Lancashire,8882702,Clayton Brook Primary School,154,17540,10232,7308
888,Lancashire,8882703,Pool House Community Primary School,124,17240,10057,7183
888,Lancashire,8882704,Fishwick Primary School,92,16920,9870,7050
888,Lancashire,8882705,Crow Orchard Primary School,129,17290,10086,7204
888,Lancashire,8882812,Coates Lane Primary School,181,17810,10389,7421
888,Lancashire,8882814,Moss Side Primary School,216,18160,10593,7567
888,Lancashire,8882815,Penwortham Broad Oak Primary School,167,17670,10308,7362
888,Lancashire,8882817,Westwood Primary School,160,17600,10267,7333
888,Lancashire,8882818,Sherwood Primary School,363,19630,11451,8179
888,Lancashire,8882820,Accrington Woodnook Primary School,160,17600,10267,7333
888,Lancashire,8882821,Shakespeare Primary School,358,19580,11422,8158
888,Lancashire,8882822,Fleetwood Chaucer Community Primary School,224,18240,10640,7600
888,Lancashire,8882826,Thornton Cleveleys Manor Beach Primary School,216,18160,10593,7567
888,Lancashire,8882827,Morecambe and Heysham Westgate Primary School,490,20900,12192,8708
888,Lancashire,8882830,Longton Primary School,178,17780,10372,7408
888,Lancashire,8882831,Morecambe and Heysham Grosvenor Park Primary School,255,18550,10821,7729
888,Lancashire,8882832,Mossgate Primary School,178,17780,10372,7408
888,Lancashire,8882833,Longsands Community Primary School,180,17800,10383,7417
888,Lancashire,8882835,Duke Street Primary School,276,18760,10943,7817
888,Lancashire,8882836,Fleetwood Flakefleet Primary School,340,19400,11317,8083
888,Lancashire,8882837,Northbrook Primary School,151,17510,10214,7296
888,Lancashire,8882838,Cottam Primary School,181,17810,10389,7421
888,Lancashire,8882839,Rosewood Primary School,350,19500,11375,8125
888,Lancashire,8882840,Cherry Fold Community Primary School,310,19100,11142,7958
888,Lancashire,8882841,Burnley Springfield Community Primary School,175,17750,10354,7396
888,Lancashire,8882842,Cuerden Church School Bamber Bridge,156,17560,10243,7317
888,Lancashire,8883001,Ribbleton Avenue Methodist Junior School,260,18600,10850,7750
888,Lancashire,8883009,St Stephens CofE School,211,18110,10564,7546
888,Lancashire,8883011,Barnoldswick Church of England Controlled Primary School,298,18980,11072,7908
888,Lancashire,8883016,Kirkland and Catterall St Helens Church of England Voluntary Aided Primary School,122,17220,10045,7175
888,Lancashire,8883017,Wray with Botton Endowed Primary School,39,16390,9561,6829
888,Lancashire,8883018,Cop Lane Church of England Primary School Penwortham,176,17760,10360,7400
888,Lancashire,8883019,Howick Church Endowed Primary School,90,16900,9858,7042
888,Lancashire,8883021,Padiham Green Church of England Primary School,181,17810,10389,7421
888,Lancashire,8883022,Rawtenstall St Pauls Church of England Primary School,236,18360,10710,7650
888,Lancashire,8883023,St Marys CofE Primary School Rawtenstall,170,17700,10325,7375
888,Lancashire,8883025,Leyland St Andrews Church of England Infant School,119,17190,10028,7162
888,Lancashire,8883026,Aughton Christ Church Church of England Voluntary Controlled Primary School,183,17830,10401,7429
888,Lancashire,8883029,Ormskirk Lathom Park Church of England Primary School,20,16200,9450,6750
888,Lancashire,8883031,Ormskirk Church of England Primary School,329,19290,11253,8037
888,Lancashire,8883058,St Bartholomews Church of England Primary School,149,17490,10203,7287
888,Lancashire,8883075,Staining Church of England Voluntary Controlled Primary School,192,17920,10453,7467
888,Lancashire,8883078,Burscough Bridge St Johns Church of England Primary School,151,17510,10214,7296
888,Lancashire,8883080,Westhead Lathom St James Church of England Primary School,75,16750,9771,6979
888,Lancashire,8883082,Quernmore Church of England Voluntary Controlled Primary School,88,16880,9847,7033
888,Lancashire,8883084,Tatham Fells Church of England Voluntary Controlled Primary School,41,16410,9573,6837
888,Lancashire,8883085,Bamber Bridge St Aidans Church of England Primary School,117,17170,10016,7154
888,Lancashire,8883087,Bickerstaffe Voluntary Controlled Church of England School,63,16630,9701,6929
888,Lancashire,8883089,Penwortham Middleforth Church of England Primary School,182,17820,10395,7425
888,Lancashire,8883094,Roughlee Church of England Primary School,34,16340,9532,6808
888,Lancashire,8883098,Banks St Stephens CofE School,124,17240,10057,7183
888,Lancashire,8883099,Edenfield Church of England Primary School,159,17590,10261,7329
888,Lancashire,8883105,St Peters CofE Primary School,164,17640,10290,7350
888,Lancashire,8883107,Higham St Johns Church of England Primary School,122,17220,10045,7175
888,Lancashire,8883108,Aughton St Michaels Church of England Primary School,167,17670,10308,7362
888,Lancashire,8883111,Read St Johns CofE Primary School,176,17760,10360,7400
888,Lancashire,8883113,Rawtenstall Newchurch Church of England Primary School,119,17190,10028,7162
888,Lancashire,8883125,Thornton Cleveleys Baines Endowed Voluntary Controlled Primary School,178,17780,10372,7408
888,Lancashire,8883126,Carters Charity Voluntary Controlled Primary School Preesall,144,17440,10173,7267
888,Lancashire,8883127,Higher Walton Church of England Primary School,87,16870,9841,7029
888,Lancashire,8883129,Brabins Endowed School,63,16630,9701,6929
888,Lancashire,8883130,Rishton Methodist Primary School,149,17490,10203,7287
888,Lancashire,8883131,Barrow Primary School,125,17250,10063,7187
888,Lancashire,8883134,Oswaldtwistle Hippings Methodist Voluntary Controlled Primary School,182,17820,10395,7425
888,Lancashire,8883141,Leyland Methodist Junior School,268,18680,10897,7783
888,Lancashire,8883143,Leyland Methodist Infant School,142,17420,10162,7258
888,Lancashire,8883146,Burscough Bridge Methodist School,55,16550,9654,6896
888,Lancashire,8883147,Holmeswood Methodist School,25,16250,9479,6771
888,Lancashire,8883168,Warton Archbishop Huttons VC Primary School,98,16980,9905,7075
888,Lancashire,8883169,Banks Methodist School,36,16360,9543,6817
888,Lancashire,8883179,Trinity Church of England/Methodist School,169,17690,10319,7371
888,Lancashire,8883181,Hapton Church of England/Methodist Primary School,111,17110,9981,7129
888,Lancashire,8883185,Richard Durnings Endowed Primary School,64,16640,9707,6933
888,Lancashire,8883191,Scarisbrick St Marks Church of England Primary School,52,16520,9637,6883
888,Lancashire,8883195,Oswaldtwistle St Andrews Church of England Primary School,255,18550,10821,7729
888,Lancashire,8883196,Bacup Holy Trinity Stacksteads Church of England Primary School,206,18060,10535,7525
888,Lancashire,8883300,Balderstone St Leonards Church of England Voluntary Aided Primary School,86,16860,9835,7025
888,Lancashire,8883301,Fulwood St Peters Church of England Primary School and Nursery,174,17740,10348,7392
888,Lancashire,8883302,Langho and Billington St Leonards CofE Primary School,242,18420,10745,7675
888,Lancashire,8883303,Chatburn Church of England Primary School,98,16980,9905,7075
888,Lancashire,8883304,St James Church of England Primary School Clitheroe,253,18530,10809,7721
888,Lancashire,8883307,Great Harwood St Bartholomews Parish Church of England Voluntary Aided Primary School,173,17730,10343,7387
888,Lancashire,8883308,Great Harwood St Johns Church of England Primary School,132,17320,10103,7217
888,Lancashire,8883312,Mellor St Mary Church of England Primary School,123,17230,10051,7179
888,Lancashire,8883313,Padiham St Leonards Voluntary Aided Church of England Primary School,235,18350,10704,7646
888,Lancashire,8883316,Rishton St Peter and St Pauls Church of England Primary School,154,17540,10232,7308
888,Lancashire,8883319,Simonstone St Peters Church of England Primary School,107,17070,9958,7112
888,Lancashire,8883321,Whalley Church of England Primary School,240,18400,10733,7667
888,Lancashire,8883322,St Josephs Catholic Primary School Preston,249,18490,10786,7704
888,Lancashire,8883323,Barrowford St Thomas Church of England Primary School,104,17040,9940,7100
888,Lancashire,8883324,St Johns CofE Primary School Cliviger,171,17710,10331,7379
888,Lancashire,8883325,Colne Christ Church Church of England Voluntary Aided Primary School,159,17590,10261,7329
888,Lancashire,8883326,Foulridge Saint Michael and All Angels CofE Voluntary Aided Primary School,169,17690,10319,7371
888,Lancashire,8883330,Nelson St Philips Church of England Primary School,120,17200,10033,7167
888,Lancashire,8883331,Nelson St Pauls Church of England Primary School,324,19240,11223,8017
888,Lancashire,8883334,Baxenden St Johns Church of England Primary School,176,17760,10360,7400
888,Lancashire,8883336,Accrington Benjamin Hargreaves Voluntary Aided Church of England Primary School,142,17420,10162,7258
888,Lancashire,8883337,Green Haworth Church of England Primary School,64,16640,9707,6933
888,Lancashire,8883339,St Mary and St Andrews Catholic Primary School Barton Newsham,108,17080,9963,7117
888,Lancashire,8883340,Accrington St John with St Augustine Church of England Primary School,175,17750,10354,7396
888,Lancashire,8883342,Accrington St Mary Magdalens Church of England Primary School,174,17740,10348,7392
888,Lancashire,8883343,Trinity and St Michaels VA CofE/Methodist Primary School,185,17850,10413,7437
888,Lancashire,8883347,Church St Nicholas Church of England Primary School,163,17630,10284,7346
888,Lancashire,8883352,St Bernards Catholic Primary School Preston,186,17860,10418,7442
888,Lancashire,8883353,Knuzden St Oswalds CofE Voluntary Aided Primary School,170,17700,10325,7375
888,Lancashire,8883355,Oswaldtwistle St Pauls Church of England Primary School,122,17220,10045,7175
888,Lancashire,8883357,Haslingden St James Church of England Primary School,145,17450,10179,7271
888,Lancashire,8883359,St Johns Stonefold CofE Primary School,109,17090,9969,7121
888,Lancashire,8883366,St Annes Church of England Primary School Edgeside,121,17210,10039,7171
888,Lancashire,8883386,Bretherton Endowed Church of England Voluntary Aided Primary School,95,16950,9888,7062
888,Lancashire,8883387,Brindle St James Church of England Voluntary Aided Primary School,58,16580,9672,6908
888,Lancashire,8883388,Christ Church Charnock Richard CofE Primary School,159,17590,10261,7329
888,Lancashire,8883389,Chorley All Saints Church of England Primary School and Nursery Unit,176,17760,10360,7400
888,Lancashire,8883390,Chorley the Parish of St Laurence Church of England Primary School,181,17810,10389,7421
888,Lancashire,8883393,St Georges Church of England Primary School Chorley,224,18240,10640,7600
888,Lancashire,8883397,Chorley St James Church of England Primary School,172,17720,10337,7383
888,Lancashire,8883401,Clayton-le-Woods Church of England Primary School,169,17690,10319,7371
888,Lancashire,8883402,Coppull St Johns Church of England Voluntary Aided Primary School,93,16930,9876,7054
888,Lancashire,8883403,Coppull Parish Church of England Primary School,161,17610,10273,7337
888,Lancashire,8883406,Eccleston St Marys Church of England Primary School,179,17790,10378,7412
888,Lancashire,8883407,Euxton Church of England Voluntary Aided Primary School,178,17780,10372,7408
888,Lancashire,8883408,Slaidburn Brennands Endowed Primary School,40,16400,9567,6833
888,Lancashire,8883409,Heskin Pembertons Church of England Primary School,93,16930,9876,7054
888,Lancashire,8883411,Leyland St James Church of England Primary School,201,18010,10506,7504
888,Lancashire,8883412,Mawdesley St Peters Church of England Primary School,79,16790,9794,6996
888,Lancashire,8883414,Whittle-le-Woods Church of England Primary School,210,18100,10558,7542
888,Lancashire,8883419,Downholland-Haskayne Voluntary Aided Church of England Primary School,31,16310,9514,6796
888,Lancashire,8883420,Halsall St Cuthberts Church of England Primary School,127,17270,10074,7196
888,Lancashire,8883424,Burscough Lordsgate Township Church of England Primary School,179,17790,10378,7412
888,Lancashire,8883426,Newburgh Church of England Primary School,104,17040,9940,7100
888,Lancashire,8883430,Burnley St Peters Church of England Primary School,172,17720,10337,7383
888,Lancashire,8883431,Burnley Holy Trinity Church of England Primary School,179,17790,10378,7412
888,Lancashire,8883432,Burnley St Stephens Church of England Voluntary Aided Primary School,178,17780,10372,7408
888,Lancashire,8883433,Burnley St James Lanehead Church of England Primary School,239,18390,10728,7662
888,Lancashire,8883434,Christ The King Roman Catholic Primary School Burnley,185,17850,10413,7437
888,Lancashire,8883435,St Mary Magdalenes Roman Catholic Primary School Burnley,174,17740,10348,7392
888,Lancashire,8883438,St Augustine of Canterbury Roman Catholic Primary School Burnley,182,17820,10395,7425
888,Lancashire,8883440,Wellfield Methodist and Anglican Church School,179,17790,10378,7412
888,Lancashire,8883448,Dalton St Michaels Church of England Primary School,53,16530,9643,6887
888,Lancashire,8883457,St Thomas the Martyr Voluntary Aided Church of England Primary School,149,17490,10203,7287
888,Lancashire,8883459,Upholland Roby Mill CofE Voluntary Aided Primary School,21,16210,9456,6754
888,Lancashire,8883461,Appley Bridge All Saints Church of England Primary School,154,17540,10232,7308
888,Lancashire,8883481,Rivington Foundation Primary School,92,16920,9870,7050
888,Lancashire,8883515,Calder Vale St John Church of England Primary School,15,15000,8750,6250
888,Lancashire,8883516,Bilsborrow John Cross Church of England Primary School,43,16430,9584,6846
888,Lancashire,8883517,Bleasdale Church of England Primary School,11,11000,6417,4583
888,Lancashire,8883518,Bolton-le-Sands Church of England Primary School,265,18650,10879,7771
888,Lancashire,8883519,Carnforth Christ Church Church of England Voluntary Aided Primary School,80,16800,9800,7000
888,Lancashire,8883520,Arkholme Church of England Primary School,53,16530,9643,6887
888,Lancashire,8883521,Caton St Pauls Church of England Primary School,152,17520,10220,7300
888,Lancashire,8883522,Cockerham Parochial CofE Primary School,73,16730,9759,6971
888,Lancashire,8883524,Dolphinholme Church of England Primary School,65,16650,9713,6937
888,Lancashire,8883525,Ellel St John the Evangelist Church of England Primary School,164,17640,10290,7350
888,Lancashire,8883526,Garstang St Thomas Church of England Primary School,164,17640,10290,7350
888,Lancashire,8883527,St Wilfrids Cof E Primary School,213,18130,10576,7554
888,Lancashire,8883528,Hornby St Margarets Church of England Primary School,50,16500,9625,6875
888,Lancashire,8883529,Inskip St Peters Church of England Voluntary Aided School,48,16480,9613,6867
888,Lancashire,8883530,Lancaster Christ Church Church of England Primary School,179,17790,10378,7412
888,Lancashire,8883531,Scotforth St Pauls Church of England Primary and Nursery School,181,17810,10389,7421
888,Lancashire,8883533,Skerton St Lukes Church of England Primary School,179,17790,10378,7412
888,Lancashire,8883534,Leck St Peters Church of England Primary School,28,16280,9497,6783
888,Lancashire,8883535,Melling St Wilfrid Church of England Primary School,35,16350,9538,6812
888,Lancashire,8883536,Heysham St Peters Church of England Primary School,205,18050,10529,7521
888,Lancashire,8883537,Poulton-le-Sands Church of England Primary School,169,17690,10319,7371
888,Lancashire,8883538,Overton St Helens Church of England Primary School,144,17440,10173,7267
888,Lancashire,8883539,Cawthornes Endowed School,27,16270,9491,6779
888,Lancashire,8883542,Silverdale St Johns Church of England Voluntary Aided Primary School,59,16590,9678,6912
888,Lancashire,8883543,Slyne-with-Hest St Lukes Church of England Primary School,202,18020,10512,7508
888,Lancashire,8883546,Thurnham Glasson Christ Church Church of England Primary School,25,16250,9479,6771
888,Lancashire,8883548,St Michaels-on-Wyre Church of England Primary School,96,16960,9893,7067
888,Lancashire,8883550,Winmarleigh Church of England Primary School,22,16220,9462,6758
888,Lancashire,8883551,Yealand Church of England Primary School,23,16230,9468,6762
888,Lancashire,8883552,Bryning with Warton St Pauls Church of England Primary School,86,16860,9835,7025
888,Lancashire,8883553,Freckleton Church of England Primary School,164,17640,10290,7350
888,Lancashire,8883554,Great Eccleston Copp CofE Primary School,117,17170,10016,7154
888,Lancashire,8883557,Kirkham St Michaels Church of England Primary School,128,17280,10080,7200
888,Lancashire,8883562,Lytham Church of England Voluntary Aided Primary School,193,17930,10459,7471
888,Lancashire,8883564,St Annes on Sea St Thomas Church of England Primary School,167,17670,10308,7362
888,Lancashire,8883565,Medlar-with-Wesham Church of England Primary School,139,17390,10144,7246
888,Lancashire,8883568,Pilling St Johns Church of England Voluntary Aided Primary School,89,16890,9853,7037
888,Lancashire,8883570,Poulton-le-Fylde St Chads CofE Primary School,209,18090,10553,7537
888,Lancashire,8883571,Carleton St Hildas Church of England Primary School,174,17740,10348,7392
888,Lancashire,8883572,Preesall Fleetwoods Charity Church of England Primary School,111,17110,9981,7129
888,Lancashire,8883573,Ribby with Wrea Endowed CofE Primary School,134,17340,10115,7225
888,Lancashire,8883574,Singleton Church of England Voluntary Aided Primary School,88,16880,9847,7033
888,Lancashire,8883575,Weeton St Michaels Church of England Voluntary Aided Primary School,39,16390,9561,6829
888,Lancashire,8883577,Barton St Lawrence Church of England Primary School,138,17380,10138,7242
888,Lancashire,8883578,Broughton-in-Amounderness Church of England Primary School,214,18140,10582,7558
888,Lancashire,8883579,Goosnargh Oliversons Church of England Primary School,155,17550,10238,7312
888,Lancashire,8883580,Grimsargh St Michaels Church of England Primary School,177,17770,10366,7404
888,Lancashire,8883581,Hesketh-with-Becconsall All Saints CofE School,175,17750,10354,7396
888,Lancashire,8883582,Lea Neelds Endowed Church of England Primary School,119,17190,10028,7162
888,Lancashire,8883583,Longridge Church of England Primary School,160,17600,10267,7333
888,Lancashire,8883585,New Longton All Saints CofE Primary School,180,17800,10383,7417
888,Lancashire,8883586,Hoole St Michael CofE Primary School,91,16910,9864,7046
888,Lancashire,8883589,Ribchester St Wilfrids Church of England Voluntary Aided Primary School,75,16750,9771,6979
888,Lancashire,8883590,Samlesbury Church of England School,56,16560,9660,6900
888,Lancashire,8883591,Tarleton Holy Trinity CofE Primary School,150,17500,10208,7292
888,Lancashire,8883592,Tarleton Mere Brow Church of England Primary School,58,16580,9672,6908
888,Lancashire,8883596,Walton-le-Dale St Leonards Church of England Primary School,241,18410,10739,7671
888,Lancashire,8883597,Woodplumpton St Annes CofE Primary School,91,16910,9864,7046
888,Lancashire,8883599,Altham St James Church of England Primary School,53,16530,9643,6887
888,Lancashire,8883600,St Annes Catholic Primary School,174,17740,10348,7392
888,Lancashire,8883601,Our Lady and St Edwards Catholic Primary School Preston,180,17800,10383,7417
888,Lancashire,8883605,St Patricks Catholic Primary School,161,17610,10273,7337
888,Lancashire,8883607,St Bernadettes Catholic Primary School Lancaster,184,17840,10407,7433
888,Lancashire,8883608,St Catherines RC Primary School,190,17900,10442,7458
888,Lancashire,8883610,St Johns Catholic Primary School Skelmersdale,166,17660,10302,7358
888,Lancashire,8883611,St Clares Catholic Primary School Preston,217,18170,10599,7571
888,Lancashire,8883614,St James Catholic Primary School Skelmersdale,130,17300,10092,7208
888,Lancashire,8883615,St Veronicas Roman Catholic Primary School Helmshore,154,17540,10232,7308
888,Lancashire,8883616,Holy Family Catholic Primary School Warton,102,17020,9928,7092
888,Lancashire,8883618,St Edmunds Catholic Primary School,85,16850,9829,7021
888,Lancashire,8883634,Ashton-on-Ribble St Andrews Church of England Primary School,360,19600,11433,8167
888,Lancashire,8883636,Preston St Matthews Church of England Primary School,355,19550,11404,8146
888,Lancashire,8883638,The Blessed Sacrament Catholic Primary School,339,19390,11311,8079
888,Lancashire,8883639,English Martyrs Catholic Primary School Preston,176,17760,10360,7400
888,Lancashire,8883642,Sacred Heart Catholic Primary School,153,17530,10226,7304
888,Lancashire,8883643,St Augustines Catholic Primary School,227,18270,10658,7612
888,Lancashire,8883645,St Maria Goretti Catholic Primary School Preston,171,17710,10331,7379
888,Lancashire,8883646,St Gregorys Catholic Primary School Preston,181,17810,10389,7421
888,Lancashire,8883647,St Ignatius Catholic Primary School,160,17600,10267,7333
888,Lancashire,8883653,Holy Family Catholic Primary School Ingol Preston,131,17310,10098,7212
888,Lancashire,8883666,Farington Moss St. Pauls C.E. Primary School,160,17600,10267,7333
888,Lancashire,8883668,Scorton Church of England Primary School,53,16530,9643,6887
888,Lancashire,8883670,Over Kellet Wilsons Endowed Church of England Primary School,107,17070,9958,7112
888,Lancashire,8883677,Bishop Martin Church of England Primary School,165,17650,10296,7354
888,Lancashire,8883702,St Mary and Michael Catholic Primary School,149,17490,10203,7287
888,Lancashire,8883703,Our Lady of Lourdes Catholic Primary School Carnforth,78,16780,9788,6992
888,Lancashire,8883704,St Marys Catholic Primary School Claughton-on-Brock,26,16260,9485,6775
888,Lancashire,8883705,St Josephs Catholic Primary School Lancaster,168,17680,10313,7367
888,Lancashire,8883706,The Cathedral Catholic Primary School Lancaster,177,17770,10366,7404
888,Lancashire,8883707,St Marys Catholic Primary School Morecambe,157,17570,10249,7321
888,Lancashire,8883709,St Marys Catholic Primary School Fleetwood,127,17270,10074,7196
888,Lancashire,8883711,St Wulstans and St Edmunds Catholic Primary School and Nursery,250,18500,10792,7708
888,Lancashire,8883712,St Marys Catholic Primary School Great Eccleston,29,16290,9503,6787
888,Lancashire,8883713,The Willows Catholic Primary School Kirkham,163,17630,10284,7346
888,Lancashire,8883715,Our Lady Star of the Sea Catholic Primary School,176,17760,10360,7400
888,Lancashire,8883716,St Peters Catholic Primary School Lytham,180,17800,10383,7417
888,Lancashire,8883717,St Josephs Catholic Primary School Medlar-with-Wesham,86,16860,9835,7025
888,Lancashire,8883718,St Williams Catholic Primary School Pilling,19,16190,9444,6746
888,Lancashire,8883719,St Johns Catholic Primary School Poulton-le-Fylde,174,17740,10348,7392
888,Lancashire,8883720,Sacred Heart Catholic Primary School Thornton Cleveleys,183,17830,10401,7429
888,Lancashire,8883725,St Francis Catholic Primary School Goosnargh,57,16570,9666,6904
888,Lancashire,8883726,St Marys Catholic Primary School,85,16850,9829,7021
888,Lancashire,8883727,Alston Lane Catholic Primary School Longridge,176,17760,10360,7400
888,Lancashire,8883728,Longridge St Wilfrids Roman Catholic Primary School,161,17610,10273,7337
888,Lancashire,8883729,St Oswalds Catholic Primary School Longton,205,18050,10529,7521
888,Lancashire,8883730,St Mary Magdalens Catholic Primary School,175,17750,10354,7396
888,Lancashire,8883736,Our Lady and St Gerards Roman Catholic Primary School Lostock Hall,265,18650,10879,7771
888,Lancashire,8883738,St Patricks Roman Catholic Primary School Walton-le-Dale,175,17750,10354,7396
888,Lancashire,8883741,St Josephs Roman Catholic Primary School Hurst Green,62,16620,9695,6925
888,Lancashire,8883742,St Marys Roman Catholic Primary School Langho,210,18100,10558,7542
888,Lancashire,8883743,St Marys Roman Catholic Primary School Chipping,30,16300,9508,6792
888,Lancashire,8883744,St Michael and St Johns Roman Catholic Primary School Clitheroe,153,17530,10226,7304
888,Lancashire,8883746,St Huberts Roman Catholic Primary School Great Harwood,144,17440,10173,7267
888,Lancashire,8883747,St Wulstans Catholic Primary School Great Harwood,146,17460,10185,7275
888,Lancashire,8883748,St Marys Roman Catholic Primary School Osbaldeston,61,16610,9689,6921
888,Lancashire,8883749,St John the Baptist Roman Catholic Primary School Padiham,183,17830,10401,7429
888,Lancashire,8883752,St Charles RC School,155,17550,10238,7312
888,Lancashire,8883753,St Marys Roman Catholic Primary School Sabden,73,16730,9759,6971
888,Lancashire,8883754,Holy Trinity Roman Catholic Primary School Brierfield,87,16870,9841,7029
888,Lancashire,8883755,Sacred Heart Roman Catholic Primary School Colne,185,17850,10413,7437
888,Lancashire,8883757,Holy Saviour Roman Catholic Primary School Nelson,181,17810,10389,7421
888,Lancashire,8883759,St John Southworth Roman Catholic Primary School Nelson,183,17830,10401,7429
888,Lancashire,8883762,St Annes and St Josephs Roman Catholic Primary School Accrington,229,18290,10669,7621
888,Lancashire,8883763,St Oswalds Roman Catholic Primary School Accrington,119,17190,10028,7162
888,Lancashire,8883764,Sacred Heart Roman Catholic Primary School Church,169,17690,10319,7371
888,Lancashire,8883765,St Marys Roman Catholic Primary School Clayton-le-Moors,100,17000,9917,7083
888,Lancashire,8883766,St Marys Roman Catholic Primary School Oswaldtwistle,220,18200,10617,7583
888,Lancashire,8883768,St Josephs Roman Catholic Primary School Stacksteads Bacup,118,17180,10022,7158
888,Lancashire,8883769,St Marys Roman Catholic Primary School Bacup,135,17350,10121,7229
888,Lancashire,8883771,St Marys Roman Catholic Primary School Haslingden,123,17230,10051,7179
888,Lancashire,8883775,St Peters Roman Catholic Primary School Newchurch,127,17270,10074,7196
888,Lancashire,8883776,St James-the-Less Roman Catholic Primary School Rawtenstall,181,17810,10389,7421
888,Lancashire,8883781,St Josephs Catholic Primary School Anderton,169,17690,10319,7371
888,Lancashire,8883782,St Josephs Catholic Primary School Brindle,81,16810,9806,7004
888,Lancashire,8883783,Sacred Heart Catholic Primary School Chorley,162,17620,10278,7342
888,Lancashire,8883785,St Josephs Catholic Primary School Chorley,178,17780,10372,7408
888,Lancashire,8883786,St Marys Catholic Primary School and Nursery Chorley,178,17780,10372,7408
888,Lancashire,8883789,St Gregorys Catholic Primary School Chorley,187,17870,10424,7446
888,Lancashire,8883790,St Bedes Catholic Primary School,169,17690,10319,7371
888,Lancashire,8883791,St Oswalds Catholic Primary School Coppull,110,17100,9975,7125
888,Lancashire,8883792,St. Marys Catholic Primary School Euxton,180,17800,10383,7417
888,Lancashire,8883793,Leyland St Marys Roman Catholic Primary School,243,18430,10751,7679
888,Lancashire,8883794,St Peter and Paul Catholic Primary School Mawdesley,38,16380,9555,6825
888,Lancashire,8883795,St Chads Catholic Primary School,121,17210,10039,7171
888,Lancashire,8883796,St Josephs Catholic Primary School Withnell,73,16730,9759,6971
888,Lancashire,8883800,St Johns Catholic Primary School Burscough,82,16820,9812,7008
888,Lancashire,8883801,Ormskirk St Annes Catholic Primary School,357,19570,11416,8154
888,Lancashire,8883803,St Marys Catholic Primary School Scarisbrick,93,16930,9876,7054
888,Lancashire,8883804,St Richards Catholic Primary School Skelmersdale,188,17880,10430,7450
888,Lancashire,8883805,St Josephs Catholic Primary School Barnoldswick,115,17150,10004,7146
888,Lancashire,8883807,Grindleton Church of England Voluntary Aided Primary School,37,16370,9549,6821
888,Lancashire,8883808,Waddington and West Bradford Church of England Voluntary Aided Primary School,134,17340,10115,7225
888,Lancashire,8883809,Bolton by Bowland Church of England Voluntary Aided Primary School,39,16390,9561,6829
888,Lancashire,8883810,Thorneyholme Roman Catholic Primary School Dunsop Bridge,25,16250,9479,6771
888,Lancashire,8883811,St John with St Michael Church of England Primary School Shawforth,100,17000,9917,7083
888,Lancashire,8883814,Heyhouses Endowed Church of England Primary School,518,21180,12355,8825
888,Lancashire,8883831,Our Lady and All Saints Roman Catholic Primary School Parbold,88,16880,9847,7033
888,Lancashire,8883833,St Teresas Catholic Primary School,175,17750,10354,7396
888,Lancashire,8883834,St Josephs Catholic Primary School Wrightington,112,17120,9987,7133
888,Lancashire,8883889,Our Lady and St Anselms Roman Catholic Primary School Whitworth,170,17700,10325,7375
888,Lancashire,8883949,St Anthonys Catholic Primary School Fulwood Preston,272,18720,10920,7800
888,Lancashire,8883953,Penwortham St Teresas Catholic Primary School,238,18380,10722,7658
888,Lancashire,8883954,St Teresas Catholic Primary School Preston,145,17450,10179,7271
888,Lancashire,8883976,Treales Church of England Primary School,49,16490,9619,6871
888,Lancashire,8883979,Wheatley Lane Methodist Voluntary Aided Primary School,174,17740,10348,7392
888,Lancashire,8883980,St Marys Roman Catholic Primary School Burnley,181,17810,10389,7421
888,Lancashire,8883981,St Marys and St Benedicts Roman Catholic Primary School,259,18590,10844,7746
888,Lancashire,8883995,Brookfield Park Primary School,140,17400,10150,7250
888,Lancashire,8883996,Woodlands Community Primary School,293,18930,11043,7887
888,Lancashire,8883997,Brinscall St Johns CofE and Methodist Primary School,178,17780,10372,7408
888,Lancashire,8883998,St Francis of Assisi Catholic Primary School,191,17910,10448,7462
888,Lancashire,8885200,Newton Bluecoat Church of England Primary School,164,17640,10290,7350
888,Lancashire,8885201,Chorley St Peters Church of England Primary School,280,18800,10967,7833
888,Lancashire,8885202,Salesbury Church of England Primary School,236,18360,10710,7650
888,Lancashire,8885203,Barnacre Road Primary School,151,17510,10214,7296
888,Lancashire,8885206,Rufford CofE School,115,17150,10004,7146
888,Lancashire,8885207,Trinity Church of England/Methodist Primary School Buckshaw Village,424,20240,11807,8433
888,Lancashire,8887007,Bleasdale School,7,7000,4083,2917
888,Lancashire,8887034,Morecambe Road School,54,16540,9648,6892
888,Lancashire,8887037,Chorley Astley Park School,61,16610,9689,6921
888,Lancashire,8887040,Great Arley School,30,16300,9508,6792
888,Lancashire,8887044,Rawtenstall Cribden House Community Special School,63,16630,9701,6929
888,Lancashire,8887049,Lostock Hall Moor Hey School,28,16280,9497,6783
888,Lancashire,8887076,Kirkham Pear Tree School,35,16350,9538,6812
888,Lancashire,8887089,Mayfield School,53,16530,9643,6887
888,Lancashire,8887097,The Loyne Specialist School,29,16290,9503,6787
888,Lancashire,8887098,The Coppice School,23,16230,9468,6762
888,Lancashire,8887099,Oswaldtwistle White Ash School,86,16860,9835,7025
888,Lancashire,8887102,Thornton-Cleveleys Red Marsh School,32,16320,9520,6800
888,Lancashire,8887109,Hillside Specialist School and College,39,16390,9561,6829
888,Lancashire,8887110,Royal Cross Primary School,20,16200,9450,6750
888,Lancashire,8887112,Pendle View Primary School,98,16980,9905,7075
888,Lancashire,8887114,Holly Grove School,96,16960,9893,7067
888,Lancashire,8887117,Kingsbury Primary Special School,59,16590,9678,6912
888,Lancashire,8887119,Acorns Primary School,63,16630,9701,6929
888,Lancashire,8887120,Elm Tree Community Primary School,76,16760,9777,6983
889,Blackburn with Darwen,8891100,St Thomass Centre,22,16220,9462,6758
889,Blackburn with Darwen,8892000,Audley Junior School,415,20150,11754,8396
889,Blackburn with Darwen,8892001,Griffin Park Primary School,178,17780,10372,7408
889,Blackburn with Darwen,8892006,Intack Primary School,266,18660,10885,7775
889,Blackburn with Darwen,8892007,Longshaw Community Junior School,343,19430,11334,8096
889,Blackburn with Darwen,8892008,Lower Darwen Primary School,291,18910,11031,7879
889,Blackburn with Darwen,8892009,Meadowhead Junior School,253,18530,10809,7721
889,Blackburn with Darwen,8892010,Meadowhead Infant School,109,17090,9969,7121
889,Blackburn with Darwen,8892011,Daisyfield Primary School,238,18380,10722,7658
889,Blackburn with Darwen,8892012,Lammack Primary School,420,20200,11783,8417
889,Blackburn with Darwen,8892013,Longshaw Infant School,159,17590,10261,7329
889,Blackburn with Darwen,8892015,Roe Lee Park Primary School,309,19090,11136,7954
889,Blackburn with Darwen,8892026,Audley Infant School,210,18100,10558,7542
889,Blackburn with Darwen,8892070,Feniscowles Primary School,351,19510,11381,8129
889,Blackburn with Darwen,8892136,Turton Belmont Community Primary School,83,16830,9818,7012
889,Blackburn with Darwen,8892167,Shadsworth Infant School,119,17190,10028,7162
889,Blackburn with Darwen,8892168,Shadsworth Junior School,234,18340,10698,7642
889,Blackburn with Darwen,8892169,Cedars Primary School,359,19590,11428,8162
889,Blackburn with Darwen,8892515,Avondale Primary School,346,19460,11352,8108
889,Blackburn with Darwen,8892823,Brookhouse Primary School,183,17830,10401,7429
889,Blackburn with Darwen,8893002,Blackburn St Thomas Church of England Primary School,358,19580,11422,8158
889,Blackburn with Darwen,8893003,St Michael With St John CofE Primary School,317,19170,11183,7987
889,Blackburn with Darwen,8893005,Holy Trinity VC School,199,17990,10494,7496
889,Blackburn with Darwen,8893183,Turton and Edgworth CofE/Methodist Controlled Primary School,199,17990,10494,7496
889,Blackburn with Darwen,8893311,Livesey Saint Francis Church of England School,172,17720,10337,7383
889,Blackburn with Darwen,8893333,St Stephens Church of England Primary School,369,19690,11486,8204
889,Blackburn with Darwen,8893373,Hoddlesden St Pauls Church of England Primary School,170,17700,10325,7375
889,Blackburn with Darwen,8893378,Darwen St Peters Church of England Primary School,250,18500,10792,7708
889,Blackburn with Darwen,8893380,St Stephens Tockholes CofE Primary School,38,16380,9555,6825
889,Blackburn with Darwen,8893465,St Barnabas and St Pauls Church of England Voluntary Aided Primary School,307,19070,11124,7946
889,Blackburn with Darwen,8893467,St Gabriels Church of England Primary School,182,17820,10395,7425
889,Blackburn with Darwen,8893468,St James Church of England Primary School Blackburn,340,19400,11317,8083
889,Blackburn with Darwen,8893469,St James Church of England Primary School,175,17750,10354,7396
889,Blackburn with Darwen,8893471,St Matthews Church of England Primary School,231,18310,10681,7629
889,Blackburn with Darwen,8893500,Sacred Heart Roman Catholic Primary School Blackburn,154,17540,10232,7308
889,Blackburn with Darwen,8893504,St Annes Roman Catholic Primary School Blackburn,172,17720,10337,7383
889,Blackburn with Darwen,8893505,Our Lady of Perpetual Succour Roman Catholic Primary School Blackburn,157,17570,10249,7321
889,Blackburn with Darwen,8893508,St Marys and St Josephs Roman Catholic Primary School Blackburn,176,17760,10360,7400
889,Blackburn with Darwen,8893510,St Peters Roman Catholic Primary School Blackburn,358,19580,11422,8158
889,Blackburn with Darwen,8893512,St Antonys RC Primary School,176,17760,10360,7400
889,Blackburn with Darwen,8893514,Holy Souls Roman Catholic Primary School Blackburn,180,17800,10383,7417
889,Blackburn with Darwen,8893675,St Cuthberts Church of England Primary School,187,17870,10424,7446
889,Blackburn with Darwen,8893751,St Pauls Roman Catholic Primary School Feniscowles Blackburn,179,17790,10378,7412
889,Blackburn with Darwen,8893778,St Edwards Roman Catholic Primary School Blackburn,174,17740,10348,7392
889,Blackburn with Darwen,8893779,St Josephs Roman Catholic Primary School Darwen,126,17260,10068,7192
889,Blackburn with Darwen,8893998,Blackburn the Redeemer CofE Primary,361,19610,11439,8171
889,Blackburn with Darwen,8893999,St Albans Roman Catholic Primary School Blackburn,171,17710,10331,7379
889,Blackburn with Darwen,8895204,Ashleigh Primary School,202,18020,10512,7508
889,Blackburn with Darwen,8897107,Newfield School,59,16590,9678,6912
890,Blackpool,8901100,Educational Diversity,10,10000,5833,4167
890,Blackpool,8902208,Layton Primary School,511,21110,12314,8796
890,Blackpool,8902834,Kincraig Primary School,133,17330,10109,7221
890,Blackpool,8902835,Boundary Primary School,311,19110,11148,7962
890,Blackpool,8903192,Bispham Endowed Church of England Primary School,351,19510,11381,8129
890,Blackpool,8903620,Blackpool St Nicholas CofE Primary School,341,19410,11323,8087
890,Blackpool,8903621,Blackpool St Johns Church of England Primary School,178,17780,10372,7408
890,Blackpool,8903622,Our Lady of the Assumption Catholic Primary School,181,17810,10389,7421
890,Blackpool,8903624,St John Vianneys Catholic Primary School,355,19550,11404,8146
890,Blackpool,8903626,St Kentigerns Catholic Primary School,179,17790,10378,7412
890,Blackpool,8903629,Holy Family Catholic Primary School,178,17780,10372,7408
890,Blackpool,8903812,St Bernadettes Catholic Primary School,175,17750,10354,7396
890,Blackpool,8903813,St Teresas Catholic Primary School,170,17700,10325,7375
890,Blackpool,8903815,Moor Park Primary School,320,19200,11200,8000
890,Blackpool,8903816,Stanley Primary School,516,21160,12343,8817
890,Blackpool,8907020,Highfurlong School,25,16250,9479,6771
890,Blackpool,8907025,Woodlands School,48,16480,9613,6867
891,Nottinghamshire,8912000,Brierley Forest Primary and Nursery School,340,19400,11317,8083
891,Nottinghamshire,8912002,St Augustines School,348,19480,11363,8117
891,Nottinghamshire,8912006,Farnsfield St Michaels Church of England Primary (Voluntary Aided) School,237,18370,10716,7654
891,Nottinghamshire,8912010,Annesley Primary and Nursery School,177,17770,10366,7404
891,Nottinghamshire,8912018,Holgate Primary and Nursery School,345,19450,11346,8104
891,Nottinghamshire,8912031,The Lanes Primary School,476,20760,12110,8650
891,Nottinghamshire,8912093,Nettleworth Infant and Nursery School,139,17390,10144,7246
891,Nottinghamshire,8912094,Leas Park Junior School,278,18780,10955,7825
891,Nottinghamshire,8912107,John T Rice Infant and Nursery School,99,16990,9911,7079
891,Nottinghamshire,8912108,Newlands Junior School,183,17830,10401,7429
891,Nottinghamshire,8912126,Croft Primary School,357,19570,11416,8154
891,Nottinghamshire,8912140,Priestsic Primary and Nursery School,356,19560,11410,8150
891,Nottinghamshire,8912150,Woodland View Primary School,289,18890,11019,7871
891,Nottinghamshire,8912165,Healdswood Infants and Nursery School,96,16960,9893,7067
891,Nottinghamshire,8912167,Dalestorth Primary and Nursery School,252,18520,10803,7717
891,Nottinghamshire,8912174,Hetts Lane Infant and Nursery School,113,17130,9993,7137
891,Nottinghamshire,8912175,Eastlands Junior School,133,17330,10109,7221
891,Nottinghamshire,8912176,Netherfield Infant School,67,16670,9724,6946
891,Nottinghamshire,8912180,Sherwood Junior School,221,18210,10623,7587
891,Nottinghamshire,8912200,Arno Vale Junior School,239,18390,10728,7662
891,Nottinghamshire,8912202,Arnold Woodthorpe Infant School,120,17200,10033,7167
891,Nottinghamshire,8912203,Richard Bonington Primary and Nursery School,362,19620,11445,8175
891,Nottinghamshire,8912213,Coppice Farm Primary School,163,17630,10284,7346
891,Nottinghamshire,8912223,Pinewood Infant and Nursery School,117,17170,10016,7154
891,Nottinghamshire,8912228,Mapperley Plains Primary and Nursery School,265,18650,10879,7771
891,Nottinghamshire,8912237,Standhill Infants School,87,16870,9841,7029
891,Nottinghamshire,8912238,Priory Junior School,231,18310,10681,7629
891,Nottinghamshire,8912239,Phoenix Infant and Nursery School,115,17150,10004,7146
891,Nottinghamshire,8912248,Westdale Infant School,119,17190,10028,7162
891,Nottinghamshire,8912271,Bramcote Hills Primary School,356,19560,11410,8150
891,Nottinghamshire,8912274,John Clifford Primary School,341,19410,11323,8087
891,Nottinghamshire,8912282,Beeston Rylands Junior School,174,17740,10348,7392
891,Nottinghamshire,8912286,Trent Vale Infant School,99,16990,9911,7079
891,Nottinghamshire,8912299,Eskdale Junior School,254,18540,10815,7725
891,Nottinghamshire,8912300,Albany Junior School,195,17950,10471,7479
891,Nottinghamshire,8912301,Albany Infant and Nursery School,114,17140,9998,7142
891,Nottinghamshire,8912308,William Lilley Infant and Nursery School,116,17160,10010,7150
891,Nottinghamshire,8912316,Toton Bispham Drive Junior School,241,18410,10739,7671
891,Nottinghamshire,8912317,Toton Banks Road Infant and Nursery School,112,17120,9987,7133
891,Nottinghamshire,8912346,Hallcroft Infant and Nursery School,61,16610,9689,6921
891,Nottinghamshire,8912361,Forest Glade Primary School,180,17800,10383,7417
891,Nottinghamshire,8912362,Hillocks Primary and Nursery School,244,18440,10757,7683
891,Nottinghamshire,8912395,Brinsley Primary and Nursery School,153,17530,10226,7304
891,Nottinghamshire,8912406,Lawrence View Primary and Nursery School,156,17560,10243,7317
891,Nottinghamshire,8912416,Larkfields Junior School,242,18420,10745,7675
891,Nottinghamshire,8912436,Bagthorpe Primary School,154,17540,10232,7308
891,Nottinghamshire,8912440,Holly Hill Primary and Nursery School,261,18610,10856,7754
891,Nottinghamshire,8912444,Jacksdale Primary and Nursery School,191,17910,10448,7462
891,Nottinghamshire,8912450,Westwood Infant and Nursery School,23,16230,9468,6762
891,Nottinghamshire,8912464,Beardall Fields Primary and Nursery School,248,18480,10780,7700
891,Nottinghamshire,8912466,Broomhill Junior School,250,18500,10792,7708
891,Nottinghamshire,8912470,Butlers Hill Infant and Nursery School,130,17300,10092,7208
891,Nottinghamshire,8912471,Edgewood Primary and Nursery School,264,18640,10873,7767
891,Nottinghamshire,8912490,Leen Mills Primary School,358,19580,11422,8158
891,Nottinghamshire,8912532,Lovers Lane Primary and Nursery School,167,17670,10308,7362
891,Nottinghamshire,8912560,Lady Bay Primary School,362,19620,11445,8175
891,Nottinghamshire,8912565,Jesse Gray Primary School,392,19920,11620,8300
891,Nottinghamshire,8912568,West Bridgford Infant School,162,17620,10278,7342
891,Nottinghamshire,8912571,Abbey Road Primary School,389,19890,11603,8287
891,Nottinghamshire,8912574,West Bridgford Junior School,341,19410,11323,8087
891,Nottinghamshire,8912611,Redlands Primary and Nursery School,350,19500,11375,8125
891,Nottinghamshire,8912614,Haggonfields Primary and Nursery School,69,16690,9736,6954
891,Nottinghamshire,8912616,Sir Edmund Hillary Primary and Nursery School,341,19410,11323,8087
891,Nottinghamshire,8912673,Manners Sutton Primary School,25,16250,9479,6771
891,Nottinghamshire,8912674,Chuter Ede Primary School,528,21280,12413,8867
891,Nottinghamshire,8912678,John Hunt Primary School,331,19310,11264,8046
891,Nottinghamshire,8912679,Beckingham Primary School,81,16810,9806,7004
891,Nottinghamshire,8912685,Hawthorne Primary and Nursery School,172,17720,10337,7383
891,Nottinghamshire,8912693,Carnarvon Primary School,425,20250,11813,8437
891,Nottinghamshire,8912700,Manor Park Infant and Nursery School,88,16880,9847,7033
891,Nottinghamshire,8912704,Ramsden Primary School,162,17620,10278,7342
891,Nottinghamshire,8912705,Clarborough Primary School,123,17230,10051,7179
891,Nottinghamshire,8912718,John Blow Primary School,173,17730,10343,7387
891,Nottinghamshire,8912731,Lantern Lane Primary and Nursery School,325,19250,11229,8021
891,Nottinghamshire,8912732,Brookside Primary School,176,17760,10360,7400
891,Nottinghamshire,8912734,East Markham Primary School,98,16980,9905,7075
891,Nottinghamshire,8912737,King Edwin Primary and Nursery School,289,18890,11019,7871
891,Nottinghamshire,8912741,Elkesley Primary and Nursery School,60,16600,9683,6917
891,Nottinghamshire,8912742,Everton Primary School,80,16800,9800,7000
891,Nottinghamshire,8912748,Gotham Primary School,167,17670,10308,7362
891,Nottinghamshire,8912751,Queen Eleanor Primary School,50,16500,9625,6875
891,Nottinghamshire,8912768,Willow Brook Primary School,155,17550,10238,7312
891,Nottinghamshire,8912769,Kinoulton Primary School,108,17080,9963,7117
891,Nottinghamshire,8912772,Kirklington Primary School,74,16740,9765,6975
891,Nottinghamshire,8912775,Lambley Primary School,115,17150,10004,7146
891,Nottinghamshire,8912779,Mattersey Primary School,31,16310,9514,6796
891,Nottinghamshire,8912781,Misson Primary School,86,16860,9835,7025
891,Nottinghamshire,8912784,Misterton Primary and Nursery School,164,17640,10290,7350
891,Nottinghamshire,8912787,Newstead Primary and Nursery School,97,16970,9899,7071
891,Nottinghamshire,8912788,Abbey Gates Primary School,176,17760,10360,7400
891,Nottinghamshire,8912790,Normanton-on-Soar Primary School,48,16480,9613,6867
891,Nottinghamshire,8912793,North Clifton Primary School,25,16250,9479,6771
891,Nottinghamshire,8912796,Muskham Primary School,167,17670,10308,7362
891,Nottinghamshire,8912802,Maun Infant and Nursery School,119,17190,10028,7162
891,Nottinghamshire,8912806,Orston Primary School,136,17360,10127,7233
891,Nottinghamshire,8912810,Radcliffe-on-Trent Infant and Nursery School,147,17470,10191,7279
891,Nottinghamshire,8912812,Radcliffe-on-Trent Junior School,303,19030,11101,7929
891,Nottinghamshire,8912813,Rampton Primary School,51,16510,9631,6879
891,Nottinghamshire,8912821,Lake View Primary and Nursery School,153,17530,10226,7304
891,Nottinghamshire,8912822,James Peacock Infant and Nursery School,181,17810,10389,7421
891,Nottinghamshire,8912824,Lowes Wong Infant School,141,17410,10156,7254
891,Nottinghamshire,8912826,Sutton Bonington Primary School,164,17640,10290,7350
891,Nottinghamshire,8912829,Sutton-On-Trent Primary and Nursery School,87,16870,9841,7029
891,Nottinghamshire,8912844,Walkeringham Primary School,55,16550,9654,6896
891,Nottinghamshire,8912850,Willoughby Primary School,36,16360,9543,6817
891,Nottinghamshire,8912853,Winthorpe Primary School,84,16840,9823,7017
891,Nottinghamshire,8912901,Round Hill Primary School,391,19910,11614,8296
891,Nottinghamshire,8912911,Stanhope Primary and Nursery School,238,18380,10722,7658
891,Nottinghamshire,8912912,Kingsway Primary School,264,18640,10873,7767
891,Nottinghamshire,8912913,Morven Park Primary and Nursery School,354,19540,11398,8142
891,Nottinghamshire,8912916,Arnold Mill Primary and Nursery School,274,18740,10932,7808
891,Nottinghamshire,8912918,Orchard Primary School and Nursery,266,18660,10885,7775
891,Nottinghamshire,8912923,Holly Primary School,258,18580,10838,7742
891,Nottinghamshire,8912925,Prospect Hill Infant and Nursery School,104,17040,9940,7100
891,Nottinghamshire,8912926,Prospect Hill Junior School,208,18080,10547,7533
891,Nottinghamshire,8912927,Church Vale Primary School and Foundation Unit,170,17700,10325,7375
891,Nottinghamshire,8912928,Carr Hill Primary and Nursery School,345,19450,11346,8104
891,Nottinghamshire,8912930,Heatherley Primary School,211,18110,10564,7546
891,Nottinghamshire,8912937,Forest Town Primary School,294,18940,11048,7892
891,Nottinghamshire,8912941,Gateford Park Primary School,177,17770,10366,7404
891,Nottinghamshire,8912942,Arnold View Primary School,258,18580,10838,7742
891,Nottinghamshire,8912946,Pierrepont Gamston Primary School,223,18230,10634,7596
891,Nottinghamshire,8912947,Berry Hill Primary School,356,19560,11410,8150
891,Nottinghamshire,8912948,Crescent Primary School,291,18910,11031,7879
891,Nottinghamshire,8913004,St Edmunds CofE (C) Primary School,180,17800,10383,7417
891,Nottinghamshire,8913008,St Andrews CofE Primary and Nursery School,274,18740,10932,7808
891,Nottinghamshire,8913018,All Hallows CofE Primary School,182,17820,10395,7425
891,Nottinghamshire,8913021,St Johns CofE Primary School,88,16880,9847,7033
891,Nottinghamshire,8913031,Selston CofE Infant and Nursery School,48,16480,9613,6867
891,Nottinghamshire,8913032,Underwood Church of England Primary School,156,17560,10243,7317
891,Nottinghamshire,8913040,Mount CofE Primary and Nursery School,170,17700,10325,7375
891,Nottinghamshire,8913061,Ranby CofE Primary School,85,16850,9829,7021
891,Nottinghamshire,8913065,Bleasby CofE Primary School,138,17380,10138,7242
891,Nottinghamshire,8913072,Bunny CofE Primary School,75,16750,9771,6979
891,Nottinghamshire,8913073,St Wilfrids CofE Primary School,186,17860,10418,7442
891,Nottinghamshire,8913076,Caunton Dean Hole CofE Primary School,42,16420,9578,6842
891,Nottinghamshire,8913081,Coddington CofE Primary and Nursery School,347,19470,11358,8112
891,Nottinghamshire,8913084,Costock CofE Primary School,77,16770,9783,6987
891,Nottinghamshire,8913087,Cuckney CofE Primary School,116,17160,10010,7150
891,Nottinghamshire,8913088,Dunham-on-Trent CofE Primary School,89,16890,9853,7037
891,Nottinghamshire,8913104,Halam CofE Primary School,86,16860,9835,7025
891,Nottinghamshire,8913112,Kneesall CofE Primary School,92,16920,9870,7050
891,Nottinghamshire,8913113,Langar CofE Primary School,80,16800,9800,7000
891,Nottinghamshire,8913117,St Matthews CofE Primary School,30,16300,9508,6792
891,Nottinghamshire,8913119,Norwell CofE Primary School,39,16390,9561,6829
891,Nottinghamshire,8913126,St Peters CofE Junior School,366,19660,11468,8192
891,Nottinghamshire,8913132,Holy Trinity CofE Infant School,39,16390,9561,6829
891,Nottinghamshire,8913133,Lowes Wong Anglican Methodist Junior School,384,19840,11573,8267
891,Nottinghamshire,8913143,Trowell CofE Primary School,168,17680,10313,7367
891,Nottinghamshire,8913145,Walesby CofE Primary School,116,17160,10010,7150
891,Nottinghamshire,8913287,North Wheatley Church of England Primary School,70,16700,9742,6958
891,Nottinghamshire,8913290,Ravenshead CofE Primary School,352,19520,11387,8133
891,Nottinghamshire,8913293,Northfield Primary and Nursery School,315,19150,11171,7979
891,Nottinghamshire,8913295,Heathlands Primary School,134,17340,10115,7225
891,Nottinghamshire,8913297,Abbey Primary School,328,19280,11247,8033
891,Nottinghamshire,8913298,Wynndale Primary School,182,17820,10395,7425
891,Nottinghamshire,8913331,Springbank Primary School,176,17760,10360,7400
891,Nottinghamshire,8913352,St Johns CofE Primary School,170,17700,10325,7375
891,Nottinghamshire,8913370,Bramcote CofE Primary School,172,17720,10337,7383
891,Nottinghamshire,8913450,Christ Church CofE Infant  & Nursery School,31,16310,9514,6796
891,Nottinghamshire,8913494,St Lukes CofE (Aided) Primary School,101,17010,9923,7087
891,Nottinghamshire,8913496,St Annes CofE (Aided) Primary School,181,17810,10389,7421
891,Nottinghamshire,8913514,The Primary School of St Mary and St Martin,96,16960,9893,7067
891,Nottinghamshire,8913530,Cotgrave CofE Primary School,95,16950,9888,7062
891,Nottinghamshire,8913534,Edwinstowe CofE Primary School,81,16810,9806,7004
891,Nottinghamshire,8913539,All Saints Anglican/Methodist Primary School,85,16850,9829,7021
891,Nottinghamshire,8913546,Gamston CofE (Aided) Primary School,82,16820,9812,7008
891,Nottinghamshire,8913548,St Peters CofE Primary School,70,16700,9742,6958
891,Nottinghamshire,8913566,Lowdham CofE Primary School,179,17790,10378,7412
891,Nottinghamshire,8913568,Linby-cum-Papplewick CofE (VA) Primary School,100,17000,9917,7083
891,Nottinghamshire,8913586,Sturton CofE Primary School,66,16660,9718,6942
891,Nottinghamshire,8913592,Sutton-Cum-Lound CofE School,56,16560,9660,6900
891,Nottinghamshire,8913606,Woods Foundation CofE Primary School,174,17740,10348,7392
891,Nottinghamshire,8913764,St Patricks Catholic Primary School,85,16850,9829,7021
891,Nottinghamshire,8913768,Holy Family Catholic Primary School,172,17720,10337,7383
891,Nottinghamshire,8913772,Ordsall Primary School,380,19800,11550,8250
891,Nottinghamshire,8913774,Huthwaite All Saints CofE (Aided) Infant School,51,16510,9631,6879
891,Nottinghamshire,8913775,Sutton Road Primary School,376,19760,11527,8233
891,Nottinghamshire,8913776,High Oakham Primary School,362,19620,11445,8175
891,Nottinghamshire,8913779,King Edward Primary School,364,19640,11457,8183
891,Nottinghamshire,8913780,Intake Farm Primary School,171,17710,10331,7379
891,Nottinghamshire,8913781,Farmilo Primary School and Nursery,187,17870,10424,7446
891,Nottinghamshire,8913782,Asquith Primary School,262,18620,10862,7758
891,Nottinghamshire,8913789,Brookhill Leys Primary and Nursery School,332,19320,11270,8050
891,Nottinghamshire,8913791,Hucknall National Church of England (VA) Primary School,360,19600,11433,8167
891,Nottinghamshire,8913793,Blidworth Oaks Primary School,260,18600,10850,7750
891,Nottinghamshire,8913795,Greasley Beauvale Primary School,305,19050,11113,7937
891,Nottinghamshire,8913796,Wadsworth Fields Primary School,262,18620,10862,7758
891,Nottinghamshire,8913797,Abbey Hill Primary & Nursery,179,17790,10378,7412
891,Nottinghamshire,8917009,Fountaindale School,25,16250,9479,6771
891,Nottinghamshire,8917012,Derrymount School,15,15000,8750,6250
891,Nottinghamshire,8917019,Carlton Digby School,21,16210,9456,6754
891,Nottinghamshire,8917021,St Giles School,34,16340,9532,6808
891,Nottinghamshire,8917023,Ash Lea School,19,16190,9444,6746
891,Nottinghamshire,8917032,Bracken Hill School,46,16460,9602,6858
891,Nottinghamshire,8917041,Newark Orchard School,27,16270,9491,6779
892,Nottingham,8922006,Berridge Primary and Nursery School,527,21270,12408,8862
892,Nottingham,8922007,Seely Primary School,446,20460,11935,8525
892,Nottingham,8922016,Fernwood Primary School,781,23810,13889,9921
892,Nottingham,8922045,Bentinck Primary and Nursery School,177,17770,10366,7404
892,Nottingham,8922056,Cantrell Primary and Nursery School,353,19530,11393,8137
892,Nottingham,8922057,Carrington Primary and Nursery School,178,17780,10372,7408
892,Nottingham,8922061,Dunkirk Primary and Nursery School,380,19800,11550,8250
892,Nottingham,8922079,Melbury Primary School,183,17830,10401,7429
892,Nottingham,8922080,Middleton Primary and Nursery School,364,19640,11457,8183
892,Nottingham,8922095,Heathfield Primary and Nursery School,408,20080,11713,8367
892,Nottingham,8922117,Walter Halls Primary and Early Years School,345,19450,11346,8104
892,Nottingham,8922128,Southwold Primary School and Early Years Centre,172,17720,10337,7383
892,Nottingham,8922151,Rise Park Primary and Nursery School,359,19590,11428,8162
892,Nottingham,8922153,Crabtree Farm Primary School,344,19440,11340,8100
892,Nottingham,8922157,Welbeck Primary School,261,18610,10856,7754
892,Nottingham,8922158,Mellers Primary School,210,18100,10558,7542
892,Nottingham,8922163,Haydn Primary School,359,19590,11428,8162
892,Nottingham,8922170,Hempshill Hall Primary School,357,19570,11416,8154
892,Nottingham,8922360,Glade Hill Primary & Nursery School,214,18140,10582,7558
892,Nottingham,8922894,Claremont Primary and Nursery School,341,19410,11323,8087
892,Nottingham,8922897,Snape Wood Primary and Nursery School,162,17620,10278,7342
892,Nottingham,8922929,Forest Fields Primary and Nursery School,493,20930,12209,8721
892,Nottingham,8923323,Dovecote Primary and Nursery School,334,19340,11282,8058
892,Nottingham,8923324,Greenfields Community School,174,17740,10348,7392
892,Nottingham,8923326,Southglade Primary School,355,19550,11404,8146
892,Nottingham,8923327,Westglade Primary School,233,18330,10693,7637
892,Nottingham,8923328,Henry Whipple Primary School,177,17770,10366,7404
892,Nottingham,8923329,Robin Hood Primary School,362,19620,11445,8175
892,Nottingham,8923332,Rufford Primary and Nursery School,319,19190,11194,7996
892,Nottingham,8927035,Rosehill School,58,16580,9672,6908
892,Nottingham,8927042,Oak Field School and Specialist Sports College,44,16440,9590,6850
893,Shropshire,8931100,Tuition Medical and Behaviour Support Service,13,13000,7583,5417
893,Shropshire,8932032,Cheswardine Primary and Nursery School,60,16600,9683,6917
893,Shropshire,8932034,Church Preen Primary School,64,16640,9707,6933
893,Shropshire,8932046,Gobowen Primary School,150,17500,10208,7292
893,Shropshire,8932052,Highley Community Primary School,184,17840,10407,7433
893,Shropshire,8932054,Hinstock Primary School,98,16980,9905,7075
893,Shropshire,8932055,Hodnet Primary School,150,17500,10208,7292
893,Shropshire,8932072,Minsterley Primary School,123,17230,10051,7179
893,Shropshire,8932075,Norbury Primary School and Nursery,56,16560,9660,6900
893,Shropshire,8932088,Crowmoor Primary School and Nursery,167,17670,10308,7362
893,Shropshire,8932090,Harlescott Junior School,354,19540,11398,8142
893,Shropshire,8932098,Sundorne Infant School,178,17780,10372,7408
893,Shropshire,8932099,Sheriffhales Primary School,74,16740,9765,6975
893,Shropshire,8932101,Buntingsdale Primary School and Nursery,61,16610,9689,6921
893,Shropshire,8932103,Stoke-on-Tern Primary School,86,16860,9835,7025
893,Shropshire,8932110,Weston Rhyn Primary School,117,17170,10016,7154
893,Shropshire,8932113,Woore Primary and Nursery School,48,16480,9613,6867
893,Shropshire,8932117,Much Wenlock Primary School,166,17660,10302,7358
893,Shropshire,8932120,Albrighton Primary School & Nursery,155,17550,10238,7312
893,Shropshire,8932146,Shifnal Primary School,256,18560,10827,7733
893,Shropshire,8932159,John Wilkinson Primary School and Nursery,161,17610,10273,7337
893,Shropshire,8932164,Belvidere Primary School,204,18040,10523,7517
893,Shropshire,8932179,The Martin Wilson School,157,17570,10249,7321
893,Shropshire,8932194,The Meadows Primary School,243,18430,10751,7679
893,Shropshire,8933001,Adderley CofE Primary School,30,16300,9508,6792
893,Shropshire,8933003,St Marys CofE Primary School,149,17490,10203,7287
893,Shropshire,8933010,Beckbury CofE Primary School,49,16490,9619,6871
893,Shropshire,8933012,Bicton CofE Primary School and Nursery,122,17220,10045,7175
893,Shropshire,8933015,Brockton CofE Primary School,59,16590,9678,6912
893,Shropshire,8933022,Chirbury CofE VC Primary School,48,16480,9613,6867
893,Shropshire,8933024,St Lawrence CofE Primary School,238,18380,10722,7658
893,Shropshire,8933026,Clive CofE Primary School,63,16630,9701,6929
893,Shropshire,8933027,Cockshutt CofE Primary School and Nursery,69,16690,9736,6954
893,Shropshire,8933030,Christ Church CofE Primary School,70,16700,9742,6958
893,Shropshire,8933031,Criftins CofE Primary School,89,16890,9853,7037
893,Shropshire,8933041,Farlow CofE Primary School,41,16410,9573,6837
893,Shropshire,8933044,St Andrews CofE Primary School,41,16410,9573,6837
893,Shropshire,8933046,Hadnall CofE Primary School,71,16710,9748,6962
893,Shropshire,8933057,Kinlet CofE Primary School,29,16290,9503,6787
893,Shropshire,8933058,Kinnerley Church of England Controlled Primary School,62,16620,9695,6925
893,Shropshire,8933068,Longnor CofE Primary School,91,16910,9864,7046
893,Shropshire,8933074,Morda CofE Primary School,133,17330,10109,7221
893,Shropshire,8933077,Moreton Say CofE  Primary School,72,16720,9753,6967
893,Shropshire,8933079,Myddle CofE Primary School,81,16810,9806,7004
893,Shropshire,8933081,Newcastle CofE Primary School,19,16190,9444,6746
893,Shropshire,8933083,Newtown CofE Primary School,126,17260,10068,7192
893,Shropshire,8933084,Norton-in-Hales CofE Primary School,67,16670,9724,6946
893,Shropshire,8933087,Pontesbury CofE Primary School & Nursery,197,17970,10483,7487
893,Shropshire,8933090,Bomere Heath CofE Primary School,104,17040,9940,7100
893,Shropshire,8933093,Rushbury CofE Primary School,43,16430,9584,6846
893,Shropshire,8933094,St John the Baptist CofE (Controlled) Primary School,91,16910,9864,7046
893,Shropshire,8933097,Selattyn CofE Primary School,77,16770,9783,6987
893,Shropshire,8933100,St Andrews CofE Primary School,256,18560,10827,7733
893,Shropshire,8933103,Oxon CofE Primary School,362,19620,11445,8175
893,Shropshire,8933104,St Giles CofE Primary School,273,18730,10926,7804
893,Shropshire,8933112,Trefonen CofE Primary School,119,17190,10028,7162
893,Shropshire,8933113,St Lucias CofE Primary School,89,16890,9853,7037
893,Shropshire,8933115,Welshampton CofE Primary School,70,16700,9742,6958
893,Shropshire,8933117,West Felton CofE Primary School,106,17060,9952,7108
893,Shropshire,8933119,Weston Lullingfields CofE School,35,16350,9538,6812
893,Shropshire,8933123,Wistanstow CofE Primary School,44,16440,9590,6850
893,Shropshire,8933126,Long Mountain CofE Primary School,76,16760,9777,6983
893,Shropshire,8933127,Stiperstones CofE Primary School,28,16280,9497,6783
893,Shropshire,8933133,Broseley CE Primary School,189,17890,10436,7454
893,Shropshire,8933134,St Marys Church of England Primary School,171,17710,10331,7379
893,Shropshire,8933135,St Thomas and St Anne CofE Primary School,86,16860,9835,7025
893,Shropshire,8933155,Bryn Offa CofE Primary School,122,17220,10045,7175
893,Shropshire,8933156,St Laurence CofE Primary School,164,17640,10290,7350
893,Shropshire,8933159,Brown Clee CofE Primary School,85,16850,9829,7021
893,Shropshire,8933160,Trinity CofE Primary School,126,17260,10068,7192
893,Shropshire,8933301,Baschurch CofE Primary School,153,17530,10226,7304
893,Shropshire,8933305,St Marys Bluecoat CofE (VA) Primary School,132,17320,10103,7217
893,Shropshire,8933307,St Marys CofE Primary School,43,16430,9584,6846
893,Shropshire,8933311,Claverley CofE Primary School,94,16940,9882,7058
893,Shropshire,8933313,Clunbury CofE Primary School,42,16420,9578,6842
893,Shropshire,8933321,Longden CofE Primary School,100,17000,9917,7083
893,Shropshire,8933322,Lydbury North CofE (A) Primary School,30,16300,9508,6792
893,Shropshire,8933329,Whittington CofE (VA) Primary School,175,17750,10354,7396
893,Shropshire,8933330,Worfield Endowed CofE Primary School,155,17550,10238,7312
893,Shropshire,8933350,St Johns Catholic Primary School,186,17860,10418,7442
893,Shropshire,8933353,Our Lady and St Oswalds Catholic Primary School,118,17180,10022,7158
893,Shropshire,8933354,Shrewsbury Cathedral Catholic Primary School and Nursery,144,17440,10173,7267
893,Shropshire,8933360,Corvedale CofE Primary School,74,16740,9765,6975
893,Shropshire,8933361,Onny CofE (A) Primary School,56,16560,9660,6900
893,Shropshire,8935204,Oakmeadow Church of England Primary and Nursery School,316,19160,11177,7983
893,Shropshire,8935205,Mereside Church of England Primary School,249,18490,10786,7704
893,Shropshire,8935206,Meole Brace Church of England Primary and Nursery,303,19030,11101,7929
893,Shropshire,8935207,Bishop Hooper Church of England Primary,71,16710,9748,6962
893,Shropshire,8937006,Woodlands School,13,13000,7583,5417
894,Telford and Wrekin,8941100,The Linden Centre,8,8000,4667,3333
894,Telford and Wrekin,8942033,Church Aston Infant School,35,16350,9538,6812
894,Telford and Wrekin,8942038,Crudgington Primary School,101,17010,9923,7087
894,Telford and Wrekin,8942041,Donnington Wood Infant School and Nursery Centre,110,17100,9975,7125
894,Telford and Wrekin,8942051,High Ercall Primary School,112,17120,9987,7133
894,Telford and Wrekin,8942061,Lawley Primary School,362,19620,11445,8175
894,Telford and Wrekin,8942062,Lilleshall Primary School,186,17860,10418,7442
894,Telford and Wrekin,8942074,Newport Infant School,167,17670,10308,7362
894,Telford and Wrekin,8942112,Wombridge Primary School,216,18160,10593,7567
894,Telford and Wrekin,8942116,Wrockwardine Wood Infant School and Nursery,130,17300,10092,7208
894,Telford and Wrekin,8942128,Queenswood Primary School and Nursery,92,16920,9870,7050
894,Telford and Wrekin,8942153,Holmer Lake Primary School,223,18230,10634,7596
894,Telford and Wrekin,8942158,William Reynolds Primary School,339,19390,11311,8079
894,Telford and Wrekin,8942168,Ladygrove Primary School,234,18340,10698,7642
894,Telford and Wrekin,8942172,Randlay Primary School,289,18890,11019,7871
894,Telford and Wrekin,8942174,Captain Webb Primary School,324,19240,11223,8017
894,Telford and Wrekin,8942175,Aqueduct Primary School,219,18190,10611,7579
894,Telford and Wrekin,8942176,John Randall Primary School,177,17770,10366,7404
894,Telford and Wrekin,8942190,Apley Wood Primary School,361,19610,11439,8171
894,Telford and Wrekin,8942191,Teagues Bridge Primary School,203,18030,10518,7512
894,Telford and Wrekin,8942195,Muxton Primary School,350,19500,11375,8125
894,Telford and Wrekin,8942200,Hollinswood Primary School,331,19310,11264,8046
894,Telford and Wrekin,8942202,Sir Alexander Fleming Primary School,297,18970,11066,7904
894,Telford and Wrekin,8942203,Newdale Primary School & Nursery,353,19530,11393,8137
894,Telford and Wrekin,8942204,Wrekin View Primary School,337,19370,11299,8071
894,Telford and Wrekin,8943035,Donnington Wood CofE Voluntary Controlled Junior School,196,17960,10477,7483
894,Telford and Wrekin,8943039,St Peters Church of England Controlled Primary School,183,17830,10401,7429
894,Telford and Wrekin,8943082,Newport Church of England Voluntary Controlled Junior School,333,19330,11276,8054
894,Telford and Wrekin,8943091,St Lawrence Church of England Voluntary Controlled Primary School,77,16770,9783,6987
894,Telford and Wrekin,8943109,Tibberton Church of England Primary School,130,17300,10092,7208
894,Telford and Wrekin,8943129,Wrockwardine Wood Church of England Junior School,259,18590,10844,7746
894,Telford and Wrekin,8943152,John Fletcher of Madeley Primary School,341,19410,11323,8087
894,Telford and Wrekin,8943154,St Georges Church of England Primary School,423,20230,11801,8429
894,Telford and Wrekin,8943157,St Peters Church of England Controlled Primary School Bratton,354,19540,11398,8142
894,Telford and Wrekin,8943315,Coalbrookdale and Ironbridge CofE Primary School,188,17880,10430,7450
894,Telford and Wrekin,8943352,St Peter and St Paul Catholic Primary School,169,17690,10319,7371
894,Telford and Wrekin,8943356,St Patricks Catholic Primary School,197,17970,10483,7487
894,Telford and Wrekin,8943357,St Marys Catholic Primary School,176,17760,10360,7400
894,Telford and Wrekin,8943358,St Matthews Church of England Aided Primary School and Nursery Centre,234,18340,10698,7642
894,Telford and Wrekin,8943359,St Lukes Catholic Primary School,136,17360,10127,7233
894,Telford and Wrekin,8943361,Millbrook Primary School,286,18860,11002,7858
894,Telford and Wrekin,8943362,Meadows Primary School and Nursery,329,19290,11253,8037
894,Telford and Wrekin,8943363,Woodlands Primary School,352,19520,11387,8133
894,Telford and Wrekin,8943364,Short Wood Primary School,410,20100,11725,8375
894,Telford and Wrekin,8943366,Old Park Primary School,467,20670,12058,8612
894,Telford and Wrekin,8943367,Lightmoor Village Primary School,178,17780,10372,7408
894,Telford and Wrekin,8943368,Dothill Primary School,361,19610,11439,8171
894,Telford and Wrekin,8945203,Moorfield Primary School,255,18550,10821,7729
894,Telford and Wrekin,8947001,Haughton School,125,17250,10063,7187
894,Telford and Wrekin,8947017,The Bridge at HLC,96,16960,9893,7067
895,Cheshire East,8952129,Alderley Edge Community Primary School,178,17780,10372,7408
895,Cheshire East,8952131,Styal Primary School,103,17030,9934,7096
895,Cheshire East,8952139,Disley Primary School,211,18110,10564,7546
895,Cheshire East,8952152,Lower Park School,242,18420,10745,7675
895,Cheshire East,8952161,Lindow Community Primary School,168,17680,10313,7367
895,Cheshire East,8952162,Alsager Highfields Community Primary School,268,18680,10897,7783
895,Cheshire East,8952163,Buglawton Primary School,170,17700,10325,7375
895,Cheshire East,8952169,Scholar Green Primary School,152,17520,10220,7300
895,Cheshire East,8952175,Havannah Primary School,167,17670,10308,7362
895,Cheshire East,8952201,Brierley Primary School,177,17770,10366,7404
895,Cheshire East,8952216,Haslington Primary School,228,18280,10663,7617
895,Cheshire East,8952220,Sound and District Primary School,112,17120,9987,7133
895,Cheshire East,8952225,Wrenbury Primary School,90,16900,9858,7042
895,Cheshire East,8952227,Millfields Primary School and Nursery,179,17790,10378,7412
895,Cheshire East,8952228,The Dingle Primary School,281,18810,10973,7837
895,Cheshire East,8952256,High Legh Primary School,127,17270,10074,7196
895,Cheshire East,8952328,Vine Tree Primary School,177,17770,10366,7404
895,Cheshire East,8952332,Dean Valley Community Primary School,169,17690,10319,7371
895,Cheshire East,8952349,Rode Heath Primary School,177,17770,10366,7404
895,Cheshire East,8952356,Elworth Hall Primary School,171,17710,10331,7379
895,Cheshire East,8952367,Weaver Primary School,179,17790,10378,7412
895,Cheshire East,8952377,Edleston Primary School,177,17770,10366,7404
895,Cheshire East,8952378,Goostrey Community Primary School,182,17820,10395,7425
895,Cheshire East,8952664,Rainow Primary School,156,17560,10243,7317
895,Cheshire East,8952693,Beechwood Primary School and Nursery,300,19000,11083,7917
895,Cheshire East,8952699,Mablins Lane Community Primary School,474,20740,12098,8642
895,Cheshire East,8952702,Pebble Brook Primary School,245,18450,10763,7687
895,Cheshire East,8952705,Daven Primary School,136,17360,10127,7233
895,Cheshire East,8952710,Ashdene Primary School,352,19520,11387,8133
895,Cheshire East,8952715,Bexton Primary School,370,19700,11492,8208
895,Cheshire East,8952716,Hurdsfield Community Primary School,114,17140,9998,7142
895,Cheshire East,8952720,Manor Park School and Nursery,172,17720,10337,7383
895,Cheshire East,8952731,Middlewich Primary School,353,19530,11393,8137
895,Cheshire East,8953108,Little Bollington CofE Primary School,82,16820,9812,7008
895,Cheshire East,8953113,Bollington Cross CofE Primary School,166,17660,10302,7358
895,Cheshire East,8953114,Bosley St Marys CofE Primary School,44,16440,9590,6850
895,Cheshire East,8953115,Chelford CofE Primary School,46,16460,9602,6858
895,Cheshire East,8953120,Woodcocks Well CofE Primary School,91,16910,9864,7046
895,Cheshire East,8953121,Elworth CofE Primary School,266,18660,10885,7775
895,Cheshire East,8953141,Audlem St James CofE Primary School,144,17440,10173,7267
895,Cheshire East,8953142,Bickerton Holy Trinity CofE Primary School,125,17250,10063,7187
895,Cheshire East,8953157,Mobberley CofE Primary School,154,17540,10232,7308
895,Cheshire East,8953169,St Annes Fulshaw C of E Primary School,113,17130,9993,7137
895,Cheshire East,8953513,St Benedicts Catholic Primary School,170,17700,10325,7375
895,Cheshire East,8953516,Bollington St Johns CofE Primary School,86,16860,9835,7025
895,Cheshire East,8953518,Prestbury CofE Primary School,270,18700,10908,7792
895,Cheshire East,8953520,Wincle CofE Primary School,47,16470,9608,6862
895,Cheshire East,8953521,St Gregorys Catholic Primary School,93,16930,9876,7054
895,Cheshire East,8953524,Marton and District CofE Aided Primary School,150,17500,10208,7292
895,Cheshire East,8953526,St John the Evangelist CofE Primary School Macclesfield,260,18600,10850,7750
895,Cheshire East,8953530,St Johns CofE Primary School,137,17370,10133,7237
895,Cheshire East,8953536,St Gabriels Catholic Primary School,175,17750,10354,7396
895,Cheshire East,8953537,St Marys Catholic Primary School,194,17940,10465,7475
895,Cheshire East,8953541,St Marys Catholic Primary School Crewe,522,21220,12378,8842
895,Cheshire East,8953543,Bridgemere CofE Primary School,58,16580,9672,6908
895,Cheshire East,8953547,St Annes Catholic Primary School,184,17840,10407,7433
895,Cheshire East,8953559,St Vincents Catholic Primary School,185,17850,10413,7437
895,Cheshire East,8953562,Bollinbrook CofE Primary School,158,17580,10255,7325
895,Cheshire East,8953810,Gainsborough Primary and Nursery School,355,19550,11404,8146
895,Cheshire East,8953818,Vernon Primary School,308,19080,11130,7950
895,Cheshire East,8953821,Cledford Primary School,284,18840,10990,7850
895,Cheshire East,8955200,Kettleshulme St James CofE (VA) Primary School,44,16440,9590,6850
895,Cheshire East,8955203,Pott Shrigley Church School,23,16230,9468,6762
895,Cheshire East,8955205,Christ the King Catholic and Church of England Primary School,140,17400,10150,7250
895,Cheshire East,8957111,Springfield School,60,16600,9683,6917
895,Cheshire East,8957112,Park Lane School,29,16290,9503,6787
896,Cheshire West and Chester,8962012,Hoole Church of England Primary School,323,19230,11218,8012
896,Cheshire West and Chester,8962013,The Oaks Community Primary School,126,17260,10068,7192
896,Cheshire West and Chester,8962014,Saughall All Saints Church of England Primary School,247,18470,10774,7696
896,Cheshire West and Chester,8962055,Newton Primary School,337,19370,11299,8071
896,Cheshire West and Chester,8962065,J H Godwin Primary School,162,17620,10278,7342
896,Cheshire West and Chester,8962066,Belgrave Primary School,180,17800,10383,7417
896,Cheshire West and Chester,8962100,Neston Primary School,168,17680,10313,7367
896,Cheshire West and Chester,8962108,Aston by Sutton Primary School,87,16870,9841,7029
896,Cheshire West and Chester,8962111,Kingsley Community Primary School and Nursery,140,17400,10150,7250
896,Cheshire West and Chester,8962113,Whitley Village School,54,16540,9648,6892
896,Cheshire West and Chester,8962115,Manley Village School,64,16640,9707,6933
896,Cheshire West and Chester,8962119,Alvanley Primary School,54,16540,9648,6892
896,Cheshire West and Chester,8962123,Helsby Hillside Primary School,187,17870,10424,7446
896,Cheshire West and Chester,8962178,Eaton Primary School,129,17290,10086,7204
896,Cheshire West and Chester,8962181,Sandiway Primary School,185,17850,10413,7437
896,Cheshire West and Chester,8962182,Little Leigh Primary School,142,17420,10162,7258
896,Cheshire West and Chester,8962183,Moulton School,178,17780,10372,7408
896,Cheshire West and Chester,8962186,Charles Darwin Community Primary School,301,19010,11089,7921
896,Cheshire West and Chester,8962187,Weaverham Forest Primary School,180,17800,10383,7417
896,Cheshire West and Chester,8962189,Byley Primary School,63,16630,9701,6929
896,Cheshire West and Chester,8962190,Wimboldsley Community Primary School,110,17100,9975,7125
896,Cheshire West and Chester,8962191,Winsford High Street Community Primary School,399,19990,11661,8329
896,Cheshire West and Chester,8962196,Cuddington Primary School,200,18000,10500,7500
896,Cheshire West and Chester,8962233,Mickle Trafford Village School,170,17700,10325,7375
896,Cheshire West and Chester,8962235,Cambridge Road Community Primary and Nursery School,177,17770,10366,7404
896,Cheshire West and Chester,8962237,William Stockton Community Primary School,245,18450,10763,7687
896,Cheshire West and Chester,8962239,Westminster Community Primary School,100,17000,9917,7083
896,Cheshire West and Chester,8962240,Whitby Heath Primary School,334,19340,11282,8058
896,Cheshire West and Chester,8962247,Huntington Community Primary School,228,18280,10663,7617
896,Cheshire West and Chester,8962260,Upton Westlea Primary School,160,17600,10267,7333
896,Cheshire West and Chester,8962268,Sutton Green Primary School,179,17790,10378,7412
896,Cheshire West and Chester,8962272,Waverton Community Primary School,173,17730,10343,7387
896,Cheshire West and Chester,8962273,Farndon Primary School,192,17920,10453,7467
896,Cheshire West and Chester,8962274,Tattenhall Park Primary School,178,17780,10372,7408
896,Cheshire West and Chester,8962275,Ashton Hayes Primary School,119,17190,10028,7162
896,Cheshire West and Chester,8962276,Tarvin Primary School,215,18150,10588,7562
896,Cheshire West and Chester,8962279,Rossmore School,154,17540,10232,7308
896,Cheshire West and Chester,8962282,Frodsham Weaver Vale Primary School,91,16910,9864,7046
896,Cheshire West and Chester,8962288,Hartford Primary School,344,19440,11340,8100
896,Cheshire West and Chester,8962298,Parkgate Primary School,151,17510,10214,7296
896,Cheshire West and Chester,8962301,Horns Mill Primary School,169,17690,10319,7371
896,Cheshire West and Chester,8962311,Darnhall Primary School,231,18310,10681,7629
896,Cheshire West and Chester,8962316,Leftwich Community Primary School,169,17690,10319,7371
896,Cheshire West and Chester,8962329,Hartford Manor Primary School & Nursery,287,18870,11008,7862
896,Cheshire West and Chester,8962334,Christleton Primary School,181,17810,10389,7421
896,Cheshire West and Chester,8962339,Comberbach Primary School,150,17500,10208,7292
896,Cheshire West and Chester,8962350,Wincham Community Primary School,244,18440,10757,7683
896,Cheshire West and Chester,8962678,Acresfield Community Primary School,187,17870,10424,7446
896,Cheshire West and Chester,8962688,Cherry Grove Primary School,235,18350,10704,7646
896,Cheshire West and Chester,8962695,Winnington Park Community Primary and Nursery School,230,18300,10675,7625
896,Cheshire West and Chester,8962701,Dee Point Primary School,350,19500,11375,8125
896,Cheshire West and Chester,8962708,Elton Primary School,154,17540,10232,7308
896,Cheshire West and Chester,8962713,Oldfield Primary School,181,17810,10389,7421
896,Cheshire West and Chester,8962718,Meadow Community Primary School,364,19640,11457,8183
896,Cheshire West and Chester,8962719,Frodsham Manor House Primary School,185,17850,10413,7437
896,Cheshire West and Chester,8962725,Rivacre Valley Primary School,202,18020,10512,7508
896,Cheshire West and Chester,8962727,Highfield Community Primary School,174,17740,10348,7392
896,Cheshire West and Chester,8962729,Lache Primary School,198,17980,10488,7492
896,Cheshire West and Chester,8962732,Brookside Primary School,173,17730,10343,7387
896,Cheshire West and Chester,8963101,Willaston CofE Primary School,181,17810,10389,7421
896,Cheshire West and Chester,8963103,Frodsham CofE Primary School,175,17750,10354,7396
896,Cheshire West and Chester,8963104,Great Budworth CofE Primary School,65,16650,9713,6937
896,Cheshire West and Chester,8963105,Norley CofE VA Primary School,86,16860,9835,7025
896,Cheshire West and Chester,8963132,Tarporley CofE Primary School,186,17860,10418,7442
896,Cheshire West and Chester,8963133,Utkinton St Pauls CofE Primary School,51,16510,9631,6879
896,Cheshire West and Chester,8963134,St Chads CofE Primary School,171,17710,10331,7379
896,Cheshire West and Chester,8963135,Over St Johns CofE Primary School,119,17190,10028,7162
896,Cheshire West and Chester,8963149,Barrow CofE Primary School,67,16670,9724,6946
896,Cheshire West and Chester,8963150,Capenhurst CofE Primary School,48,16480,9613,6867
896,Cheshire West and Chester,8963151,Dodleston CofE Primary School,80,16800,9800,7000
896,Cheshire West and Chester,8963152,Guilden Sutton CofE Primary School,182,17820,10395,7425
896,Cheshire West and Chester,8963163,Duddon St Peters CofE Primary School,98,16980,9905,7075
896,Cheshire West and Chester,8963164,Malpas Alport Endowed Primary School,211,18110,10564,7546
896,Cheshire West and Chester,8963165,Shocklach Oviatt CofE Primary School,36,16360,9543,6817
896,Cheshire West and Chester,8963166,Tilston Parochial CofE Primary School,87,16870,9841,7029
896,Cheshire West and Chester,8963167,Tushingham-with-Grindley CofE Primary School,82,16820,9812,7008
896,Cheshire West and Chester,8963168,Huxley CofE Primary School,40,16400,9567,6833
896,Cheshire West and Chester,8963171,Lostock Gralam CofE Primary School,169,17690,10319,7371
896,Cheshire West and Chester,8963172,Overleigh St Marys CofE Primary School,346,19460,11352,8108
896,Cheshire West and Chester,8963415,St Clares Catholic Primary School,133,17330,10109,7221
896,Cheshire West and Chester,8963500,Bishop Wilson Church of England Primary School,61,16610,9689,6921
896,Cheshire West and Chester,8963501,St Winefrides Catholic Primary School,159,17590,10261,7329
896,Cheshire West and Chester,8963507,Kingsley St Johns CofE (VA) Primary School,59,16590,9678,6912
896,Cheshire West and Chester,8963532,Crowton Christ Church CofE Primary School,62,16620,9695,6925
896,Cheshire West and Chester,8963533,Lower Peover CofE Primary School,165,17650,10296,7354
896,Cheshire West and Chester,8963534,Whitegate CofE Primary School,104,17040,9940,7100
896,Cheshire West and Chester,8963538,St Bedes Catholic Primary School Weaverham,173,17730,10343,7387
896,Cheshire West and Chester,8963550,Eccleston CofE Primary School,86,16860,9835,7025
896,Cheshire West and Chester,8963551,Saighton CofE Primary School,91,16910,9864,7046
896,Cheshire West and Chester,8963552,Ellesmere Port Christ Church CofE Primary School,134,17340,10115,7225
896,Cheshire West and Chester,8963558,St Mary of the Angels Catholic Primary School,177,17770,10366,7404
896,Cheshire West and Chester,8963633,St Lukes Catholic Primary School,162,17620,10278,7342
896,Cheshire West and Chester,8963641,St Werburghs and St Columbas Catholic Primary School,279,18790,10961,7829
896,Cheshire West and Chester,8963643,St. Josephs Catholic Primary School,272,18720,10920,7800
896,Cheshire West and Chester,8963645,Davenham CofE Primary School,268,18680,10897,7783
896,Cheshire West and Chester,8963646,St Theresas Catholic Primary School,164,17640,10290,7350
896,Cheshire West and Chester,8963647,St Oswalds CofE Aided Primary School,128,17280,10080,7200
896,Cheshire West and Chester,8963800,Witton Church Walk CofE Primary School,236,18360,10710,7650
896,Cheshire West and Chester,8963802,Kingsmead Primary School,253,18530,10809,7721
896,Cheshire West and Chester,8963803,The Acorns Primary and Nursery School,254,18540,10815,7725
896,Cheshire West and Chester,8963804,The Arches Community Primary School,203,18030,10518,7512
896,Cheshire West and Chester,8963807,Woodfall Primary School,365,19650,11463,8187
896,Cheshire West and Chester,8963813,Woodlands Primary School,457,20570,11999,8571
896,Cheshire West and Chester,8963815,Our Lady Star of the Sea Catholic Primary School,357,19570,11416,8154
896,Cheshire West and Chester,8963817,Willow Wood Community Primary School,243,18430,10751,7679
896,Cheshire West and Chester,8963820,St Saviours Catholic Primary and Nursery School,147,17470,10191,7279
896,Cheshire West and Chester,8963822,Wharton CofE Primary School,333,19330,11276,8054
896,Cheshire West and Chester,8965202,St Wilfrids Catholic Primary School,253,18530,10809,7721
896,Cheshire West and Chester,8965204,Antrobus St Marks CofE Primary School,54,16540,9648,6892
896,Cheshire West and Chester,8965205,Chester Blue Coat Church of England Primary School,331,19310,11264,8046
896,Cheshire West and Chester,8967000,Dee Banks School,50,16500,9625,6875
896,Cheshire West and Chester,8967109,Hebden Green Community School,34,16340,9532,6808
896,Cheshire West and Chester,8967115,Hinderton School,36,16360,9543,6817
896,Cheshire West and Chester,8967118,Dorin Park School & Specialist SEN College,51,16510,9631,6879
896,Cheshire West and Chester,8967120,Rosebank School,46,16460,9602,6858
896,Cheshire West and Chester,8967208,Archers Brook SEMH Residential School,7,7000,4083,2917
908,Cornwall,9082003,Trythall Community Primary School,63,16630,9701,6929
908,Cornwall,9082004,Marazion School,113,17130,9993,7137
908,Cornwall,9082006,Heamoor Community Primary School,164,17640,10290,7350
908,Cornwall,9082018,St Ives Junior School,235,18350,10704,7646
908,Cornwall,9082025,St Levan Primary School,39,16390,9561,6829
908,Cornwall,9082109,Germoe Community Primary School,51,16510,9631,6879
908,Cornwall,9082116,Mylor Community Primary School,125,17250,10063,7187
908,Cornwall,9082126,Boskenwyn Community Primary School,58,16580,9672,6908
908,Cornwall,9082219,St Day and Carharrack Community School,157,17570,10249,7321
908,Cornwall,9082221,Treleigh Community Primary School,212,18120,10570,7550
908,Cornwall,9082227,Gwinear Community Primary School,82,16820,9812,7008
908,Cornwall,9082230,Penpol School,321,19210,11206,8004
908,Cornwall,9082232,Stithians Community Primary School,154,17540,10232,7308
908,Cornwall,9082302,Kea Community Primary School,181,17810,10389,7421
908,Cornwall,9082306,Perran-Ar-Worthal Community Primary School,120,17200,10033,7167
908,Cornwall,9082307,Goonhavern Primary School,186,17860,10418,7442
908,Cornwall,9082317,St Erme with Trispen Community Primary School,109,17090,9969,7121
908,Cornwall,9082318,Devoran School,177,17770,10366,7404
908,Cornwall,9082321,Bosvigo School,280,18800,10967,7833
908,Cornwall,9082400,Cubert School,164,17640,10290,7350
908,Cornwall,9082403,Gorran School,95,16950,9888,7062
908,Cornwall,9082441,Nanpean Community Primary School,129,17290,10086,7204
908,Cornwall,9082444,St Wenn School,59,16590,9678,6912
908,Cornwall,9082504,Port Isaac Community Primary School,41,16410,9573,6837
908,Cornwall,9082507,Nanstallon Community Primary School,87,16870,9841,7029
908,Cornwall,9082606,Boscastle Community Primary School,60,16600,9683,6917
908,Cornwall,9082608,Kilkhampton Junior and Infant School,97,16970,9899,7071
908,Cornwall,9082613,Trekenner Community Primary School,58,16580,9672,6908
908,Cornwall,9082627,Whitstone Community Primary School,50,16500,9625,6875
908,Cornwall,9082630,Jacobstow Community Primary School,86,16860,9835,7025
908,Cornwall,9082633,South Petherwin Community Primary School,94,16940,9882,7058
908,Cornwall,9082634,Tregadillett Primary School,123,17230,10051,7179
908,Cornwall,9082701,Calstock Community Primary School,64,16640,9707,6933
908,Cornwall,9082713,Fourlanesend Community Primary School,87,16870,9841,7029
908,Cornwall,9082718,Pensilva Primary School,108,17080,9963,7117
908,Cornwall,9082719,St Neot Community Primary School,75,16750,9771,6979
908,Cornwall,9082723,St Stephens (Saltash) Community Primary School,284,18840,10990,7850
908,Cornwall,9082724,Stoke Climsland School,174,17740,10348,7392
908,Cornwall,9082725,Torpoint Nursery and Infant School,170,17700,10325,7375
908,Cornwall,9082726,Carbeile Junior School,364,19640,11457,8183
908,Cornwall,9082730,Burraton Community Primary School,353,19530,11393,8137
908,Cornwall,9082736,Menheniot Primary School,131,17310,10098,7212
908,Cornwall,9082741,Marlborough School,187,17870,10424,7446
908,Cornwall,9082746,St Germans Primary School,86,16860,9835,7025
908,Cornwall,9082747,Stratton Primary School,291,18910,11031,7879
908,Cornwall,9082748,Pondhu Primary School,229,18290,10669,7621
908,Cornwall,9083033,Flushing School,62,16620,9695,6925
908,Cornwall,9083091,St Marys CofE School Truro,178,17780,10372,7408
908,Cornwall,9083184,St Marks CofE Primary School Morwenstow,74,16740,9765,6975
908,Cornwall,9083300,St Madderns CofE School Madron,30,16300,9508,6792
908,Cornwall,9083302,St Marys CofE Primary School Penzance,145,17450,10179,7271
908,Cornwall,9083385,Mawnan CofE VA Primary School,99,16990,9911,7079
908,Cornwall,9083882,St Dominic CofE VA School,44,16440,9590,6850
908,Cornwall,9083884,St Mellion CofE VA School,56,16560,9660,6900
908,Cornwall,9083888,Bishop Cornish CofE VA Primary School,180,17800,10383,7417
909,Cumbria,9091100,Gillford Centre,8,8000,4667,3333
909,Cumbria,9091103,West Cumbria Learning Centre,2,2000,1167,833
909,Cumbria,9091105,Newbridge House PRU,3,3000,1750,1250
909,Cumbria,9092000,St Martin & St Mary Church of England Primary School,306,19060,11118,7942
909,Cumbria,9092001,Allonby Primary School,14,14000,8167,5833
909,Cumbria,9092002,Cambridge Primary School,166,17660,10302,7358
909,Cumbria,9092004,Alston Primary School,74,16740,9765,6975
909,Cumbria,9092005,Armathwaite School,54,16540,9648,6892
909,Cumbria,9092008,Bewcastle School,15,15000,8750,6250
909,Cumbria,9092010,Blennerhasset School,45,16450,9596,6854
909,Cumbria,9092014,Burgh by Sands School,86,16860,9835,7025
909,Cumbria,9092019,Cummersdale School,84,16840,9823,7017
909,Cumbria,9092020,Cumwhinton School,154,17540,10232,7308
909,Cumbria,9092027,Great Orton Primary School,40,16400,9567,6833
909,Cumbria,9092028,Greystoke School,20,16200,9450,6750
909,Cumbria,9092032,Holme St Cuthbert School,56,16560,9660,6900
909,Cumbria,9092033,Irthington Village School,67,16670,9724,6946
909,Cumbria,9092035,Kirkbride Primary School,66,16660,9718,6942
909,Cumbria,9092040,Nenthead Primary School,17,16170,9433,6737
909,Cumbria,9092045,Brunswick School,100,17000,9917,7083
909,Cumbria,9092046,North Lakes School,212,18120,10570,7550
909,Cumbria,9092054,Plumpton School,67,16670,9724,6946
909,Cumbria,9092058,Skelton School,77,16770,9783,6987
909,Cumbria,9092059,Stoneraise School,90,16900,9858,7042
909,Cumbria,9092060,Thursby Primary School,89,16890,9853,7037
909,Cumbria,9092069,Thomlinson Junior School,226,18260,10652,7608
909,Cumbria,9092070,Wigton Infant School,102,17020,9928,7092
909,Cumbria,9092071,Aspatria Richmond Hill School,150,17500,10208,7292
909,Cumbria,9092103,Broughton Moor Primary School,46,16460,9602,6858
909,Cumbria,9092117,Grasslot Infant School,44,16440,9590,6850
909,Cumbria,9092124,Ellenborough and Ewanrigg Infant School,18,16180,9438,6742
909,Cumbria,9092125,Maryport Infant School,51,16510,9631,6879
909,Cumbria,9092126,Ewanrigg Junior School,161,17610,10273,7337
909,Cumbria,9092127,Netherton Infant School,45,16450,9596,6854
909,Cumbria,9092143,St Michaels Nursery and Infant School,34,16340,9532,6808
909,Cumbria,9092144,Victoria Infant and Nursery School,106,17060,9952,7108
909,Cumbria,9092146,Victoria Junior School,284,18840,10990,7850
909,Cumbria,9092147,Ashfield Infant & Nursery School,120,17200,10033,7167
909,Cumbria,9092148,Ashfield Junior School,246,18460,10768,7692
909,Cumbria,9092200,Arlecdon Primary School,51,16510,9631,6879
909,Cumbria,9092207,Bookwell Primary School,179,17790,10378,7412
909,Cumbria,9092211,Frizington Community Primary School,108,17080,9963,7117
909,Cumbria,9092212,Haverigg Primary School,154,17540,10232,7308
909,Cumbria,9092216,Lowca Community School,52,16520,9637,6883
909,Cumbria,9092219,Millom Infant School,48,16480,9613,6867
909,Cumbria,9092220,Black Combe Junior School,101,17010,9923,7087
909,Cumbria,9092222,Moor Row Community Primary School,45,16450,9596,6854
909,Cumbria,9092223,Moresby Primary School,88,16880,9847,7033
909,Cumbria,9092224,Seascale Primary School,115,17150,10004,7146
909,Cumbria,9092225,St Bees Village Primary School,152,17520,10220,7300
909,Cumbria,9092226,Thornhill Primary School,46,16460,9602,6858
909,Cumbria,9092227,Thwaites School,48,16480,9613,6867
909,Cumbria,9092228,Bransty Primary School,148,17480,10197,7283
909,Cumbria,9092230,Kells Infant School,60,16600,9683,6917
909,Cumbria,9092231,Monkwray Junior School,129,17290,10086,7204
909,Cumbria,9092237,Jericho Primary School,334,19340,11282,8058
909,Cumbria,9092301,Bolton Primary School,53,16530,9643,6887
909,Cumbria,9092302,Brough Primary School,53,16530,9643,6887
909,Cumbria,9092305,Clifton Primary School,62,16620,9695,6925
909,Cumbria,9092308,Holme Primary School,82,16820,9812,7008
909,Cumbria,9092310,Kirkby Stephen Primary School,155,17550,10238,7312
909,Cumbria,9092311,Kirkby Thore School,45,16450,9596,6854
909,Cumbria,9092313,Long Marton School,69,16690,9736,6954
909,Cumbria,9092314,Milburn School,7,7000,4083,2917
909,Cumbria,9092315,Milnthorpe Primary School,154,17540,10232,7308
909,Cumbria,9092321,Heron Hill Primary School,329,19290,11253,8037
909,Cumbria,9092322,Goodly Dale Primary School,67,16670,9724,6946
909,Cumbria,9092403,Chapel Street Infants and Nursery School,64,16640,9707,6933
909,Cumbria,9092404,Lindal and Marton Primary School,77,16770,9783,6987
909,Cumbria,9092406,Newton Primary School,40,16400,9567,6833
909,Cumbria,9092407,Hawkshead Esthwaite Primary School,49,16490,9619,6871
909,Cumbria,9092413,Croftlands Infant School,71,16710,9748,6962
909,Cumbria,9092414,Croftlands Junior School,150,17500,10208,7292
909,Cumbria,9092502,Brisbane Park Infant School,76,16760,9777,6983
909,Cumbria,9092509,Greengate Junior School,231,18310,10681,7629
909,Cumbria,9092511,Roose School,149,17490,10203,7287
909,Cumbria,9092512,Ramsden Infant School,60,16600,9683,6917
909,Cumbria,9092513,Vickerstown School,157,17570,10249,7321
909,Cumbria,9092514,Victoria Infant and Nursery School,133,17330,10109,7221
909,Cumbria,9092515,South Walney Junior School,203,18030,10518,7512
909,Cumbria,9092518,South Walney Infant and Nursery School,84,16840,9823,7017
909,Cumbria,9092521,Dane Ghyll School,169,17690,10319,7371
909,Cumbria,9092606,Inglewood Junior School,294,18940,11048,7892
909,Cumbria,9092607,Inglewood Infant School,152,17520,10220,7300
909,Cumbria,9092608,Newtown Community Primary School,89,16890,9853,7037
909,Cumbria,9092609,Norman Street Primary School,296,18960,11060,7900
909,Cumbria,9092610,Petteril Bank School,121,17210,10039,7171
909,Cumbria,9092618,Newlaithes Junior School,233,18330,10693,7637
909,Cumbria,9092620,Newlaithes Infant School,120,17200,10033,7167
909,Cumbria,9092622,Belle Vue Primary School,356,19560,11410,8150
909,Cumbria,9092623,Kingmoor Junior School,304,19040,11107,7933
909,Cumbria,9092625,Kingmoor Nursery and Infant School,163,17630,10284,7346
909,Cumbria,9092626,Brook Street Primary School,198,17980,10488,7492
909,Cumbria,9092627,Sir John Barrow School,175,17750,10354,7396
909,Cumbria,9092700,Sedbergh Primary School,142,17420,10162,7258
909,Cumbria,9092701,George Romney Junior School,127,17270,10074,7196
909,Cumbria,9092703,Silloth Primary School,140,17400,10150,7250
909,Cumbria,9092704,Barrow Island Community Primary School,128,17280,10080,7200
909,Cumbria,9092705,Caldew Lea School,227,18270,10658,7612
909,Cumbria,9092706,Fellview Primary School,45,16450,9596,6854
909,Cumbria,9092707,Derwent Vale Primary and Nursery School,95,16950,9888,7062
909,Cumbria,9092708,North Walney Primary Nursery & Pre- School,79,16790,9794,6996
909,Cumbria,9092710,Robert Ferguson Primary School,329,19290,11253,8037
909,Cumbria,9092711,Upperby Primary School,316,19160,11177,7983
909,Cumbria,9092712,Newbarns Primary & Nursery  School,356,19560,11410,8150
909,Cumbria,9092713,Pennine Way Primary School,295,18950,11054,7896
909,Cumbria,9092714,Orgill Primary School,168,17680,10313,7367
909,Cumbria,9092715,Ormsgill Nursery and Primary School,135,17350,10121,7229
909,Cumbria,9092716,Montreal CofE Primary School,128,17280,10080,7200
909,Cumbria,9092717,St Patricks Catholic Primary School,203,18030,10518,7512
909,Cumbria,9092718,Distington Community School,101,17010,9923,7087
909,Cumbria,9092720,Westfield Nursery and Primary School,166,17660,10302,7358
909,Cumbria,9092721,The Bishop Harvey Goodwin School (Church of England Voluntary Aided),217,18170,10599,7571
909,Cumbria,9092722,Hensingham Community Primary School,116,17160,10010,7150
909,Cumbria,9093002,Boltons CofE School,59,16590,9678,6912
909,Cumbria,9093007,St Michaels CofE Primary School,189,17890,10436,7454
909,Cumbria,9093013,High Hesket CofE School,143,17430,10168,7262
909,Cumbria,9093014,Holm Cultram Abbey CofE School,43,16430,9584,6846
909,Cumbria,9093015,Houghton CofE School,132,17320,10103,7217
909,Cumbria,9093017,Ireby CofE School,23,16230,9468,6762
909,Cumbria,9093018,Kirkbampton CofE School,87,16870,9841,7029
909,Cumbria,9093019,Kirkoswald CofE School,76,16760,9777,6983
909,Cumbria,9093020,Lanercost CofE Primary School,60,16600,9683,6917
909,Cumbria,9093021,Langwathby CofE Primary School,105,17050,9946,7104
909,Cumbria,9093023,Lees Hill CofE School,21,16210,9456,6754
909,Cumbria,9093030,Raughton Head CofE School,29,16290,9503,6787
909,Cumbria,9093031,Rockcliffe CofE School,103,17030,9934,7096
909,Cumbria,9093032,Shankhill CofE Primary School,31,16310,9514,6796
909,Cumbria,9093037,Wreay CofE Primary School,102,17020,9928,7092
909,Cumbria,9093054,Levens CofE School,59,16590,9678,6912
909,Cumbria,9093056,Old Hutton CofE School,75,16750,9771,6979
909,Cumbria,9093057,Staveley CofE School,108,17080,9963,7117
909,Cumbria,9093058,Storth CofE School,45,16450,9596,6854
909,Cumbria,9093059,Temple Sowerby CofE Primary School,41,16410,9573,6837
909,Cumbria,9093061,Asby Endowed School,16,16000,9333,6667
909,Cumbria,9093064,Vicarage Park CofE Primary School,170,17700,10325,7375
909,Cumbria,9093100,Bridekirk Dovenby CofE Primary School,116,17160,10010,7150
909,Cumbria,9093101,St Bridgets CofE School,90,16900,9858,7042
909,Cumbria,9093102,All Saints CofE School,164,17640,10290,7350
909,Cumbria,9093103,Crosscanonby St Johns CofE School,45,16450,9596,6854
909,Cumbria,9093112,Maryport C of E Junior School,130,17300,10092,7208
909,Cumbria,9093114,Plumbland CofE School,48,16480,9613,6867
909,Cumbria,9093115,Threlkeld CofE Primary School,55,16550,9654,6896
909,Cumbria,9093116,Seaton St. Pauls CofE Junior School,257,18570,10833,7737
909,Cumbria,9093122,Coniston CofE Primary School,39,16390,9561,6829
909,Cumbria,9093123,Grange CofE Primary School,123,17230,10051,7179
909,Cumbria,9093124,Burlington CofE School,62,16620,9695,6925
909,Cumbria,9093125,Allithwaite CofE Primary School,78,16780,9788,6992
909,Cumbria,9093126,Cartmel CofE Primary School,42,16420,9578,6842
909,Cumbria,9093128,Pennington CofE School,150,17500,10208,7292
909,Cumbria,9093130,Lindale CofE Primary School,37,16370,9549,6821
909,Cumbria,9093132,Broughton CofE School,65,16650,9713,6937
909,Cumbria,9093150,St Georges CofE School,169,17690,10319,7371
909,Cumbria,9093200,Captain Shaws CofE School,26,16260,9485,6775
909,Cumbria,9093204,Ennerdale and Kinniside CofE Primary School,38,16380,9555,6825
909,Cumbria,9093206,Gosforth CofE School,85,16850,9829,7021
909,Cumbria,9093207,Lamplugh CofE School,1,1000,583,417
909,Cumbria,9093209,St Bridgets CofE School,70,16700,9742,6958
909,Cumbria,9093210,St James CofE Infant School,84,16840,9823,7017
909,Cumbria,9093211,St James CofE Junior School,161,17610,10273,7337
909,Cumbria,9093212,Low Furness CofE Primary School,110,17100,9975,7125
909,Cumbria,9093301,Blackford CofE Primary School,49,16490,9619,6871
909,Cumbria,9093304,Calthwaite CofE School,56,16560,9660,6900
909,Cumbria,9093305,Culgaith CofE School,44,16440,9590,6850
909,Cumbria,9093309,Ivegill CofE School,70,16700,9742,6958
909,Cumbria,9093315,St Catherines Catholic Primary School,111,17110,9981,7129
909,Cumbria,9093316,Rosley CofE School,58,16580,9672,6908
909,Cumbria,9093319,Stainton CofE Primary School,129,17290,10086,7204
909,Cumbria,9093322,St Matthews CofE School,43,16430,9584,6846
909,Cumbria,9093324,Wiggonby CofE School,39,16390,9561,6829
909,Cumbria,9093328,St Cuthberts Catholic Primary School,75,16750,9771,6979
909,Cumbria,9093354,Beetham CofE Primary School,53,16530,9643,6887
909,Cumbria,9093355,St Oswalds CofE Primary School,69,16690,9736,6954
909,Cumbria,9093356,Crosby Ravensworth CofE School,20,16200,9450,6750
909,Cumbria,9093357,Crosscrake CofE Primary School,60,16600,9683,6917
909,Cumbria,9093358,Crosthwaite CofE School,71,16710,9748,6962
909,Cumbria,9093359,St Patricks CofE School,52,16520,9637,6883
909,Cumbria,9093360,Grasmere CofE Primary School,62,16620,9695,6925
909,Cumbria,9093361,Grayrigg CofE School,23,16230,9468,6762
909,Cumbria,9093362,Langdale CofE School,33,16330,9526,6804
909,Cumbria,9093365,St Thomass CofE Primary School,156,17560,10243,7317
909,Cumbria,9093367,St Marys CofE Primary School,179,17790,10378,7412
909,Cumbria,9093368,Morland Area CofE Primary School,83,16830,9818,7012
909,Cumbria,9093370,St Marks CofE Primary School,147,17470,10191,7279
909,Cumbria,9093372,Patterdale CofE School,26,16260,9485,6775
909,Cumbria,9093373,Selside Endowed CofE Primary School,48,16480,9613,6867
909,Cumbria,9093374,Shap Endowed CofE Primary School,71,16710,9748,6962
909,Cumbria,9093381,Dent CofE Voluntary Aided Primary School,29,16290,9503,6787
909,Cumbria,9093400,St Michaels CofE Primary School,43,16430,9584,6846
909,Cumbria,9093401,Borrowdale CofE Primary School,43,16430,9584,6846
909,Cumbria,9093404,St Josephs Catholic Primary School,62,16620,9695,6925
909,Cumbria,9093410,Our Lady and St Patricks Catholic Primary,150,17500,10208,7292
909,Cumbria,9093414,St Marys Catholic Primary School,125,17250,10063,7187
909,Cumbria,9093415,St Gregorys Catholic Primary School,182,17820,10395,7425
909,Cumbria,9093416,St Patricks Catholic Primary School,177,17770,10366,7404
909,Cumbria,9093450,Dean Gibson Catholic Primary School,150,17500,10208,7292
909,Cumbria,9093451,Lowther Endowed School,69,16690,9736,6954
909,Cumbria,9093452,Dean Barwick Primary School,40,16400,9567,6833
909,Cumbria,9093453,St Cuthberts Catholic Primary School,56,16560,9660,6900
909,Cumbria,9093500,Beckermet CofE School,68,16680,9730,6950
909,Cumbria,9093506,St Bridgets Catholic Primary School,148,17480,10197,7283
909,Cumbria,9093508,St Begas CofE Primary School,18,16180,9438,6742
909,Cumbria,9093510,St Josephs Catholic Primary School,71,16710,9748,6962
909,Cumbria,9093514,St James Catholic Primary School,171,17710,10331,7379
909,Cumbria,9093516,Waberthwaite CofE School,47,16470,9608,6862
909,Cumbria,9093519,St Marys Catholic Primary School,148,17480,10197,7283
909,Cumbria,9093520,St Beghs Catholic Junior School,267,18670,10891,7779
909,Cumbria,9093521,St Gregory and St Patricks Catholic Infant School,145,17450,10179,7271
909,Cumbria,9093550,Leven Valley CofE Primary School,53,16530,9643,6887
909,Cumbria,9093551,Our Lady of the Rosary Catholic Primary School,78,16780,9788,6992
909,Cumbria,9093552,St Marys Catholic Primary School,100,17000,9917,7083
909,Cumbria,9093557,Church Walk CofE Primary School,84,16840,9823,7017
909,Cumbria,9093601,St James CofE Junior School,137,17370,10133,7237
909,Cumbria,9093602,Sacred Heart Catholic Primary School,151,17510,10214,7296
909,Cumbria,9093603,St Columbas Catholic Primary School,169,17690,10319,7371
909,Cumbria,9093606,St Pius X Catholic Primary School,137,17370,10133,7237
909,Cumbria,9093607,Holy Family Catholic Primary School,179,17790,10378,7412
909,Cumbria,9093652,St Bedes Catholic Primary School,165,17650,10296,7354
909,Cumbria,9093653,St Cuthberts Catholic Community School,85,16850,9829,7021
909,Cumbria,9093654,St Margaret Mary Catholic Primary School,180,17800,10383,7417
909,Cumbria,9093656,Warcop CofE Primary School,79,16790,9794,6996
909,Cumbria,9093661,Valley Primary School and Nursery,192,17920,10453,7467
909,Cumbria,9093662,Beckstone Primary School,267,18670,10891,7779
909,Cumbria,9093663,St Herberts CofE (VA) Primary and Nursery School,243,18430,10751,7679
909,Cumbria,9095200,Hayton CofE Primary School,133,17330,10109,7221
909,Cumbria,9095201,Scotby CofE Primary School,227,18270,10658,7612
909,Cumbria,9095202,Warwick Bridge Primary School,99,16990,9911,7079
909,Cumbria,9095203,Brampton Primary School,199,17990,10494,7496
909,Cumbria,9095204,St Pauls CofE Junior School,94,16940,9882,7058
909,Cumbria,9095206,Appleby Primary School,135,17350,10121,7229
909,Cumbria,9095207,Askam Village School,129,17290,10086,7204
909,Cumbria,9095208,Flookburgh CofE Primary School,53,16530,9643,6887
909,Cumbria,9095210,Dalton St Marys CofE Primary School,172,17720,10337,7383
909,Cumbria,9095212,Bowness-on-Solway Primary School,48,16480,9613,6867
909,Cumbria,9095213,Ireleth St Peters CofE Primary School,41,16410,9573,6837
909,Cumbria,9095215,Hallbankgate Village School,44,16440,9590,6850
909,Cumbria,9095217,Orton CofE School,63,16630,9701,6929
909,Cumbria,9095218,Fir Ends Primary School,91,16910,9864,7046
909,Cumbria,9095221,Beaconside CofE Primary School,363,19630,11451,8179
909,Cumbria,9095225,Penruddock Primary School,64,16640,9707,6933
909,Cumbria,9095226,Oughterside Primary School,55,16550,9654,6896
909,Cumbria,9097002,Mayfield School,50,16500,9625,6875
909,Cumbria,9097006,Sandgate School,24,16240,9473,6767
909,Cumbria,9097013,Sandside Lodge School,13,13000,7583,5417
916,Gloucestershire,9161105,Cheltenham and Tewkesbury Alternative Provision School,10,10000,5833,4167
916,Gloucestershire,9161106,Gloucester and Forest Alternative Provision School,8,8000,4667,3333
916,Gloucestershire,9161107,Stroud and Cotswold Alternative Provision School,4,4000,2333,1667
916,Gloucestershire,9162000,Widden Primary School,319,19190,11194,7996
916,Gloucestershire,9162002,Tredworth Junior School,296,18960,11060,7900
916,Gloucestershire,9162004,Linden Primary School,385,19850,11579,8271
916,Gloucestershire,9162005,Hatherley Infant School,114,17140,9998,7142
916,Gloucestershire,9162008,Calton Primary School,466,20660,12052,8608
916,Gloucestershire,9162013,Elmbridge Primary School,525,21250,12396,8854
916,Gloucestershire,9162025,Harewood Infant School,176,17760,10360,7400
916,Gloucestershire,9162026,Harewood Junior School,305,19050,11113,7937
916,Gloucestershire,9162028,Hillview Primary School,180,17800,10383,7417
916,Gloucestershire,9162030,Dinglewell Junior School,359,19590,11428,8162
916,Gloucestershire,9162031,Longlevens Junior School,482,20820,12145,8675
916,Gloucestershire,9162033,Longlevens Infant School,239,18390,10728,7662
916,Gloucestershire,9162034,Dinglewell Infant School,180,17800,10383,7417
916,Gloucestershire,9162040,Ashchurch Primary School,118,17180,10022,7158
916,Gloucestershire,9162041,Avening Primary School,86,16860,9835,7025
916,Gloucestershire,9162042,Blakeney Primary School,87,16870,9841,7029
916,Gloucestershire,9162044,Eastcombe Primary School,57,16570,9666,6904
916,Gloucestershire,9162045,Bledington Primary School,71,16710,9748,6962
916,Gloucestershire,9162047,Leighterton Primary School,75,16750,9771,6979
916,Gloucestershire,9162050,Chalford Hill Primary School,179,17790,10378,7412
916,Gloucestershire,9162051,Churcham Primary School,47,16470,9608,6862
916,Gloucestershire,9162052,Churchdown Parton Manor Infant School,111,17110,9981,7129
916,Gloucestershire,9162053,Churchdown Village Junior School,241,18410,10739,7671
916,Gloucestershire,9162056,Birdlip Primary School,91,16910,9864,7046
916,Gloucestershire,9162062,Drybrook Primary School,115,17150,10004,7146
916,Gloucestershire,9162064,Woodside Primary School,94,16940,9882,7058
916,Gloucestershire,9162065,St Whites Primary School,251,18510,10798,7712
916,Gloucestershire,9162066,Soudley School,65,16650,9713,6937
916,Gloucestershire,9162067,Steam Mills Primary School,103,17030,9934,7096
916,Gloucestershire,9162068,Eastington Primary School,120,17200,10033,7167
916,Gloucestershire,9162070,The Rissington School,195,17950,10471,7479
916,Gloucestershire,9162072,Sharpness Primary School,104,17040,9940,7100
916,Gloucestershire,9162075,Kingswood Primary School,98,16980,9905,7075
916,Gloucestershire,9162077,Lydbrook Primary School,122,17220,10045,7175
916,Gloucestershire,9162081,Mickleton Primary School,120,17200,10033,7167
916,Gloucestershire,9162084,Sheepscombe Primary School,43,16430,9584,6846
916,Gloucestershire,9162085,Rodmarton School,32,16320,9520,6800
916,Gloucestershire,9162086,Slimbridge Primary School,103,17030,9934,7096
916,Gloucestershire,9162089,Tredington Community Primary School,90,16900,9858,7042
916,Gloucestershire,9162090,Park Junior School,190,17900,10442,7458
916,Gloucestershire,9162091,Stow-on-the-Wold Primary School,113,17130,9993,7137
916,Gloucestershire,9162094,Stroud Valley Community Primary School,221,18210,10623,7587
916,Gloucestershire,9162097,Uplands Community Primary School,95,16950,9888,7062
916,Gloucestershire,9162098,Thrupp School,114,17140,9998,7142
916,Gloucestershire,9162099,Tibberton Community Primary School,89,16890,9853,7037
916,Gloucestershire,9162101,Twyning School,80,16800,9800,7000
916,Gloucestershire,9162102,Walmore Hill Primary School,44,16440,9590,6850
916,Gloucestershire,9162103,Berry Hill Primary School,157,17570,10249,7321
916,Gloucestershire,9162105,Coalway Junior School,237,18370,10716,7654
916,Gloucestershire,9162106,Coalway Community Infant School,110,17100,9975,7125
916,Gloucestershire,9162107,Ellwood Primary School,114,17140,9998,7142
916,Gloucestershire,9162108,Parkend Primary School,53,16530,9643,6887
916,Gloucestershire,9162109,Pillowell Community Primary School,74,16740,9765,6975
916,Gloucestershire,9162110,Yorkley Primary School,123,17230,10051,7179
916,Gloucestershire,9162114,Woolaston Primary School,146,17460,10185,7275
916,Gloucestershire,9162116,Queen Margaret Primary School and Childrens Centre,145,17450,10179,7271
916,Gloucestershire,9162117,Cashes Green Primary School,161,17610,10273,7337
916,Gloucestershire,9162118,Innsworth Junior School,143,17430,10168,7262
916,Gloucestershire,9162119,Northway Infant School,89,16890,9853,7037
916,Gloucestershire,9162122,Churchdown Parton Manor Junior School,180,17800,10383,7417
916,Gloucestershire,9162123,Rodborough Community Primary School,179,17790,10378,7412
916,Gloucestershire,9162130,The Croft Primary School,126,17260,10068,7192
916,Gloucestershire,9162132,Castle Hill Primary School,175,17750,10354,7396
916,Gloucestershire,9162134,Callowell Primary School,157,17570,10249,7321
916,Gloucestershire,9162136,Foxmoor Primary School,223,18230,10634,7596
916,Gloucestershire,9162137,Gastrells Community Primary School,156,17560,10243,7317
916,Gloucestershire,9162138,Cam Woodfield Infant School,81,16810,9806,7004
916,Gloucestershire,9162141,Woodmancote School,359,19590,11428,8162
916,Gloucestershire,9162142,Glenfall Community Primary School,180,17800,10383,7417
916,Gloucestershire,9162143,Cam Everlands Primary School,170,17700,10325,7375
916,Gloucestershire,9162145,Innsworth Infant School,79,16790,9794,6996
916,Gloucestershire,9162146,Stonehouse Park Infant School,117,17170,10016,7154
916,Gloucestershire,9162147,Dunalley Primary School,314,19140,11165,7975
916,Gloucestershire,9162150,Gloucester Road Primary School,164,17640,10290,7350
916,Gloucestershire,9162151,Greatfield Park Primary School,181,17810,10389,7421
916,Gloucestershire,9162155,Naunton Park Primary School,373,19730,11509,8221
916,Gloucestershire,9162160,Lakeside Primary School,414,20140,11748,8392
916,Gloucestershire,9162165,Benhall Infant School,120,17200,10033,7167
916,Gloucestershire,9162171,Beech Green Primary School,358,19580,11422,8158
916,Gloucestershire,9162172,Abbeymead Primary School,393,19930,11626,8304
916,Gloucestershire,9162173,Tuffley Primary School,201,18010,10506,7504
916,Gloucestershire,9162175,Coney Hill Community Primary School,211,18110,10564,7546
916,Gloucestershire,9162177,Gardners Lane Primary School,262,18620,10862,7758
916,Gloucestershire,9162178,Hesters Way Primary School,158,17580,10255,7325
916,Gloucestershire,9162179,Meadowside Primary School,209,18090,10553,7537
916,Gloucestershire,9162180,The John Moore Primary School,210,18100,10558,7542
916,Gloucestershire,9162181,Grangefield Primary School,221,18210,10623,7587
916,Gloucestershire,9162184,Hope Brook CofE Primary School,101,17010,9923,7087
916,Gloucestershire,9162185,Coopers Edge School,263,18630,10868,7762
916,Gloucestershire,9162200,Finlay Community School,239,18390,10728,7662
916,Gloucestershire,9163004,St Pauls Church of England Primary School,175,17750,10354,7396
916,Gloucestershire,9163006,St James Church of England Junior School,159,17590,10261,7329
916,Gloucestershire,9163010,Kingsholm Church of England Primary School,534,21340,12448,8892
916,Gloucestershire,9163011,Hempsted Church of England Primary School,180,17800,10383,7417
916,Gloucestershire,9163017,Cold Aston Church of England Primary School,76,16760,9777,6983
916,Gloucestershire,9163018,Aylburton Church of England Primary School,56,16560,9660,6900
916,Gloucestershire,9163020,Bisley Blue Coat Church of England Primary School,67,16670,9724,6946
916,Gloucestershire,9163024,Watermoor Church of England Primary School,146,17460,10185,7275
916,Gloucestershire,9163025,Stratton Church of England Primary School,181,17810,10389,7421
916,Gloucestershire,9163027,Coberley Church of England Primary School,58,16580,9672,6908
916,Gloucestershire,9163030,Deerhurst and Apperley Church of England Primary School,60,16600,9683,6917
916,Gloucestershire,9163034,English Bicknor Church of England Primary School,58,16580,9672,6908
916,Gloucestershire,9163035,Fairford Church of England Primary School,200,18000,10500,7500
916,Gloucestershire,9163039,Haresfield Church of England Primary School,89,16890,9853,7037
916,Gloucestershire,9163040,Hartpury Church of England Primary School,86,16860,9835,7025
916,Gloucestershire,9163041,Hatherop Church of England Primary School,65,16650,9713,6937
916,Gloucestershire,9163042,Kempsford Church of England Primary School,85,16850,9829,7021
916,Gloucestershire,9163044,Littledean Church of England Primary School,96,16960,9893,7067
916,Gloucestershire,9163045,Longborough Church of England Primary School,41,16410,9573,6837
916,Gloucestershire,9163048,Lydney Church of England Community School (VC),177,17770,10366,7404
916,Gloucestershire,9163050,Meysey Hampton Church of England Primary School,91,16910,9864,7046
916,Gloucestershire,9163052,Nailsworth Church of England Primary School,164,17640,10290,7350
916,Gloucestershire,9163053,Clearwell Church of England Primary School,34,16340,9532,6808
916,Gloucestershire,9163054,Redbrook Church of England Primary School,33,16330,9526,6804
916,Gloucestershire,9163056,Northleach Church of England Primary School,144,17440,10173,7267
916,Gloucestershire,9163057,Norton Church of England Primary School,111,17110,9981,7129
916,Gloucestershire,9163060,Pauntley Church of England Primary School,39,16390,9561,6829
916,Gloucestershire,9163063,Randwick Church of England Primary School,65,16650,9713,6937
916,Gloucestershire,9163065,Ruardean Church of England Primary School,77,16770,9783,6987
916,Gloucestershire,9163067,Sherborne Church of England Primary School,43,16430,9584,6846
916,Gloucestershire,9163068,Shurdington Church of England Primary School,121,17210,10039,7171
916,Gloucestershire,9163069,Ann Edwards Church of England Primary School,253,18530,10809,7721
916,Gloucestershire,9163070,Southrop Church of England Primary School,45,16450,9596,6854
916,Gloucestershire,9163071,Swell Church of England Primary School,35,16350,9538,6812
916,Gloucestershire,9163072,Temple Guiting Church of England School,83,16830,9818,7012
916,Gloucestershire,9163073,Tewkesbury Church of England Primary School,335,19350,11288,8062
916,Gloucestershire,9163074,Tutshill Church of England Primary School,179,17790,10378,7412
916,Gloucestershire,9163076,Uley Church of England Primary School,89,16890,9853,7037
916,Gloucestershire,9163077,Upton St Leonards Church of England Primary School,357,19570,11416,8154
916,Gloucestershire,9163078,Bream Church of England Primary School,127,17270,10074,7196
916,Gloucestershire,9163080,Whitminster Endowed Church of England Primary School,100,17000,9917,7083
916,Gloucestershire,9163081,Willersey Church of England Primary School,29,16290,9503,6787
916,Gloucestershire,9163086,Ashleworth Church of England Primary School,33,16330,9526,6804
916,Gloucestershire,9163087,Down Ampney Church of England Primary School,31,16310,9514,6796
916,Gloucestershire,9163093,Holy Trinity Church of England Primary School,177,17770,10366,7404
916,Gloucestershire,9163094,Leckhampton Church of England Primary School,379,19790,11544,8246
916,Gloucestershire,9163097,St Johns Church of England Primary School,169,17690,10319,7371
916,Gloucestershire,9163099,Oak Hill Church of England Primary School,76,16760,9777,6983
916,Gloucestershire,9163308,Ampney Crucis Church of England Primary School,80,16800,9800,7000
916,Gloucestershire,9163310,Oakridge Parochial School,39,16390,9561,6829
916,Gloucestershire,9163311,Bromesberrow St Marys Church of England (Aided) Primary School,53,16530,9643,6887
916,Gloucestershire,9163313,Cam Hopton Church of England Primary School,176,17760,10360,7400
916,Gloucestershire,9163314,Christ Church Church of England Primary School,27,16270,9491,6779
916,Gloucestershire,9163315,Bussage Church of England Primary School,174,17740,10348,7392
916,Gloucestershire,9163316,Holy Apostles Church of England Primary School,183,17830,10401,7429
916,Gloucestershire,9163317,St Andrews Church of England Primary School,67,16670,9724,6946
916,Gloucestershire,9163319,Powells Church of England Primary School,359,19590,11428,8162
916,Gloucestershire,9163322,Cranham Church of England Primary School,49,16490,9619,6871
916,Gloucestershire,9163323,Ann Cam Church of England Primary School,90,16900,9858,7042
916,Gloucestershire,9163327,Horsley Church of England Primary School,89,16890,9853,7037
916,Gloucestershire,9163328,Huntley Church of England Primary School,72,16720,9753,6967
916,Gloucestershire,9163331,Leonard Stanley Church of England Primary School,177,17770,10366,7404
916,Gloucestershire,9163334,Amberley Parochial School,94,16940,9882,7058
916,Gloucestershire,9163335,Brimscombe Church of England (VA) Primary School,88,16880,9847,7033
916,Gloucestershire,9163337,Miserden Church of England Primary School,30,16300,9508,6792
916,Gloucestershire,9163338,Mitcheldean Endowed Primary School,173,17730,10343,7387
916,Gloucestershire,9163340,Newnham St Peters Church of England Primary School,95,16950,9888,7062
916,Gloucestershire,9163341,North Nibley Church of England Primary School,93,16930,9876,7054
916,Gloucestershire,9163343,Prestbury St Marys Church of England Junior School,239,18390,10728,7662
916,Gloucestershire,9163344,St Briavels Parochial Church of England Primary School,112,17120,9987,7133
916,Gloucestershire,9163345,Sapperton Church of England Primary School,51,16510,9631,6879
916,Gloucestershire,9163346,St Matthews Church of England Primary School,176,17760,10360,7400
916,Gloucestershire,9163348,St Marys Church of England VA Primary School,280,18800,10967,7833
916,Gloucestershire,9163350,Westbury-on-Severn Church of England Primary School,67,16670,9724,6946
916,Gloucestershire,9163352,Withington Church of England Primary School,34,16340,9532,6808
916,Gloucestershire,9163353,Woodchester Endowed Church of England Aided Primary School,122,17220,10045,7175
916,Gloucestershire,9163354,St Catharines Catholic Primary School,115,17150,10004,7146
916,Gloucestershire,9163356,St Josephs Catholic Primary School,132,17320,10103,7217
916,Gloucestershire,9163359,St Thomas More Catholic Primary School,169,17690,10319,7371
916,Gloucestershire,9163360,St Marys Church of England Infant School,119,17190,10028,7162
916,Gloucestershire,9163363,St Marks Church of England Junior School,259,18590,10844,7746
916,Gloucestershire,9163364,St James and Ebrington Church of England Primary School,167,17670,10308,7362
916,Gloucestershire,9163365,Barnwood Church of England Primary School,178,17780,10372,7408
916,Gloucestershire,9163367,Hillesley Church of England Primary School,36,16360,9543,6817
916,Gloucestershire,9163370,St Peters Catholic Primary School,363,19630,11451,8179
916,Gloucestershire,9163372,Kings Stanley CofE Primary School,177,17770,10366,7404
916,Gloucestershire,9163373,Kingsway Primary School,362,19620,11445,8175
916,Gloucestershire,9163374,Isbourne Valley School,69,16690,9736,6954
916,Gloucestershire,9163375,Cirencester Primary School,341,19410,11323,8087
916,Gloucestershire,9165201,The Catholic School of Saint Gregory the Great,355,19550,11404,8146
916,Gloucestershire,9165203,Picklenash Junior School,152,17520,10220,7300
916,Gloucestershire,9165204,Blue Coat CofE Primary School,277,18770,10949,7821
916,Gloucestershire,9165205,Andoversford Primary School,81,16810,9806,7004
916,Gloucestershire,9165208,Tirlebrook Primary School,178,17780,10372,7408
916,Gloucestershire,9165209,The British School,147,17470,10191,7279
916,Gloucestershire,9165210,Warden Hill Primary School,384,19840,11573,8267
916,Gloucestershire,9165211,Glebe Infants School,85,16850,9829,7021
916,Gloucestershire,9165214,Swindon Village Primary School,356,19560,11410,8150
916,Gloucestershire,9165219,Heron Primary School,358,19580,11422,8158
916,Gloucestershire,9165220,Carrant Brook Junior School,161,17610,10273,7337
916,Gloucestershire,9165221,Oakwood Primary School,291,18910,11031,7879
916,Gloucestershire,9167015,Bettridge School,55,16550,9654,6896
916,Gloucestershire,9167017,The Shrubberies School,33,16330,9526,6804
916,Gloucestershire,9167018,Paternoster School,30,16300,9508,6792
916,Gloucestershire,9167019,Alderman Knight School,33,16330,9526,6804
916,Gloucestershire,9167022,Battledown Centre for Children and Families,21,16210,9456,6754
916,Gloucestershire,9167023,Belmont School,35,16350,9538,6812
916,Gloucestershire,9167024,The Milestone School,164,17640,10290,7350
916,Gloucestershire,9167025,Heart of the Forest Community Special School,34,16340,9532,6808
919,Hertfordshire,9192000,Abbots Langley School,414,20140,11748,8392
919,Hertfordshire,9192002,Ashwell Primary School,184,17840,10407,7433
919,Hertfordshire,9192005,Featherstone Wood Primary School,154,17540,10232,7308
919,Hertfordshire,9192007,Birchwood Avenue Primary School,175,17750,10354,7396
919,Hertfordshire,9192008,Lodge Farm Primary School,350,19500,11375,8125
919,Hertfordshire,9192011,Jenyns First School and Nursery,59,16590,9678,6912
919,Hertfordshire,9192012,Bushey Heath Primary School,209,18090,10553,7537
919,Hertfordshire,9192013,Highwood Primary School,358,19580,11422,8158
919,Hertfordshire,9192014,Merry Hill Infant School and Nursery,119,17190,10028,7162
919,Hertfordshire,9192016,Holdbrook Primary School,158,17580,10255,7325
919,Hertfordshire,9192017,Four Swannes Primary School,142,17420,10162,7258
919,Hertfordshire,9192019,Chorleywood Primary School,182,17820,10395,7425
919,Hertfordshire,9192022,Shepherd Primary,226,18260,10652,7608
919,Hertfordshire,9192023,Hobletts Manor Junior School,236,18360,10710,7650
919,Hertfordshire,9192025,The Russell School,204,18040,10523,7517
919,Hertfordshire,9192026,Oughton Primary and Nursery School,195,17950,10471,7479
919,Hertfordshire,9192027,Swallow Dell Primary and Nursery School,354,19540,11398,8142
919,Hertfordshire,9192030,Cowley Hill School,340,19400,11317,8083
919,Hertfordshire,9192031,Flamstead Village School,84,16840,9823,7017
919,Hertfordshire,9192032,Gaddesden Row JMI School,40,16400,9567,6833
919,Hertfordshire,9192033,Sauncey Wood Primary School,168,17680,10313,7367
919,Hertfordshire,9192034,Manland Primary School,208,18080,10547,7533
919,Hertfordshire,9192039,Green Lanes Primary School,358,19580,11422,8158
919,Hertfordshire,9192040,George Street Primary School,176,17760,10360,7400
919,Hertfordshire,9192041,Boxmoor Primary School,181,17810,10389,7421
919,Hertfordshire,9192044,Two Waters Primary School,180,17800,10383,7417
919,Hertfordshire,9192045,Tudor Primary School,339,19390,11311,8079
919,Hertfordshire,9192047,South Hill Primary School,292,18920,11037,7883
919,Hertfordshire,9192050,Abel Smith School,181,17810,10389,7421
919,Hertfordshire,9192053,Hexton Junior Mixed and Infant School,50,16500,9625,6875
919,Hertfordshire,9192055,Highbury Infant School and Nursery,119,17190,10028,7162
919,Hertfordshire,9192056,Strathmore Infant and Nursery School,120,17200,10033,7167
919,Hertfordshire,9192057,Highover Junior Mixed and Infant School,372,19720,11503,8217
919,Hertfordshire,9192061,Hunsdon Junior Mixed and Infant School,92,16920,9870,7050
919,Hertfordshire,9192062,Kimpton Primary School,145,17450,10179,7271
919,Hertfordshire,9192064,Breachwood Green Junior Mixed and Infant School,88,16880,9847,7033
919,Hertfordshire,9192066,Knebworth Primary and Nursery School,337,19370,11299,8071
919,Hertfordshire,9192069,Hillshott Infant School and Nursery,123,17230,10051,7179
919,Hertfordshire,9192072,Hertford Heath Primary and Nursery School,169,17690,10319,7371
919,Hertfordshire,9192073,Little Hadham Primary School,113,17130,9993,7137
919,Hertfordshire,9192074,Markyate Village School and Nursery,212,18120,10570,7550
919,Hertfordshire,9192077,Pirton School,127,17270,10074,7196
919,Hertfordshire,9192078,Reed First School,30,16300,9508,6792
919,Hertfordshire,9192079,Yorke Mead Primary School,324,19240,11223,8017
919,Hertfordshire,9192082,Harvey Road Primary School,181,17810,10389,7421
919,Hertfordshire,9192083,Little Green Junior School,361,19610,11439,8171
919,Hertfordshire,9192084,Malvern Way Infant and Nursery School,178,17780,10372,7408
919,Hertfordshire,9192085,Tannery Drift School,186,17860,10418,7442
919,Hertfordshire,9192090,Bernards Heath Infant and Nursery School,180,17800,10383,7417
919,Hertfordshire,9192091,Camp Primary and Nursery School,177,17770,10366,7404
919,Hertfordshire,9192095,Garden Fields Junior Mixed and Infant School,415,20150,11754,8396
919,Hertfordshire,9192096,St Peters School,171,17710,10331,7379
919,Hertfordshire,9192098,Aboyne Lodge Junior Mixed and Infant School,176,17760,10360,7400
919,Hertfordshire,9192100,Bernards Heath Junior School,360,19600,11433,8167
919,Hertfordshire,9192101,St Pauls Walden Primary School,87,16870,9841,7029
919,Hertfordshire,9192102,Colney Heath Junior Mixed Infant and Nursery School,181,17810,10389,7421
919,Hertfordshire,9192103,London Colney Primary & Nursery School,120,17200,10033,7167
919,Hertfordshire,9192105,Sandon Junior Mixed and Infant School,84,16840,9823,7017
919,Hertfordshire,9192106,Sandridge School,174,17740,10348,7392
919,Hertfordshire,9192107,Fawbert and Barnard Infants School,121,17210,10039,7171
919,Hertfordshire,9192108,Shenley Primary School,219,18190,10611,7579
919,Hertfordshire,9192109,Letchmore Infants and Nursery School,172,17720,10337,7383
919,Hertfordshire,9192111,Therfield First School,42,16420,9578,6842
919,Hertfordshire,9192114,Walkern Primary School,119,17190,10028,7162
919,Hertfordshire,9192116,Central Primary School,338,19380,11305,8075
919,Hertfordshire,9192117,Bushey and Oxhey Infant School,119,17190,10028,7162
919,Hertfordshire,9192120,Chater Junior School,240,18400,10733,7667
919,Hertfordshire,9192122,Chater Infant School,120,17200,10033,7167
919,Hertfordshire,9192123,Field Junior School,264,18640,10873,7767
919,Hertfordshire,9192124,Watford Field School (Infant & Nursery),138,17380,10138,7242
919,Hertfordshire,9192125,Parkgate Junior School,228,18280,10663,7617
919,Hertfordshire,9192126,Parkgate Infants and Nursery School,114,17140,9998,7142
919,Hertfordshire,9192131,St Meryl School,175,17750,10354,7396
919,Hertfordshire,9192132,Cassiobury Junior School,358,19580,11422,8158
919,Hertfordshire,9192133,Kingsway Junior School,243,18430,10751,7679
919,Hertfordshire,9192139,Watton-at-Stone Primary and Nursery School,206,18060,10535,7525
919,Hertfordshire,9192140,Peartree Primary School,156,17560,10243,7317
919,Hertfordshire,9192142,Templewood Primary School,176,17760,10360,7400
919,Hertfordshire,9192143,Holwell Primary School,253,18530,10809,7721
919,Hertfordshire,9192145,Widford School,43,16430,9584,6846
919,Hertfordshire,9192146,Wymondley Junior Mixed and Infant School,88,16880,9847,7033
919,Hertfordshire,9192147,Tanners Wood Junior Mixed and Infant School,352,19520,11387,8133
919,Hertfordshire,9192151,Hurst Drive Primary School,328,19280,11247,8033
919,Hertfordshire,9192153,Woodlands Primary School,176,17760,10360,7400
919,Hertfordshire,9192154,Summerswood Primary School,337,19370,11299,8071
919,Hertfordshire,9192155,Kenilworth Primary School,177,17770,10366,7404
919,Hertfordshire,9192165,Icknield Infant and Nursery School,174,17740,10348,7392
919,Hertfordshire,9192166,Bowmansgreen Primary School,338,19380,11305,8075
919,Hertfordshire,9192168,Margaret Wix Primary School,180,17800,10383,7417
919,Hertfordshire,9192169,Broom Barns Primary School,176,17760,10360,7400
919,Hertfordshire,9192177,Greenfields Primary School,146,17460,10185,7275
919,Hertfordshire,9192178,Woodhall Primary School,166,17660,10302,7358
919,Hertfordshire,9192181,Saffron Green Primary School,167,17670,10308,7362
919,Hertfordshire,9192184,Hobletts Manor Infants School,119,17190,10028,7162
919,Hertfordshire,9192188,Bedwell Primary School,243,18430,10751,7679
919,Hertfordshire,9192193,Chaulden Infants and Nursery,86,16860,9835,7025
919,Hertfordshire,9192198,Peartree Spring Primary School,517,21170,12349,8821
919,Hertfordshire,9192203,Roundwood Primary School,269,18690,10903,7787
919,Hertfordshire,9192206,Wheatfields Junior Mixed School,360,19600,11433,8167
919,Hertfordshire,9192210,Chambersbury Primary School,169,17690,10319,7371
919,Hertfordshire,9192219,Windermere Primary School,168,17680,10313,7367
919,Hertfordshire,9192223,Anstey First School,23,16230,9468,6762
919,Hertfordshire,9192224,Monksmead School,181,17810,10389,7421
919,Hertfordshire,9192225,Howe Dell Primary School,350,19500,11375,8125
919,Hertfordshire,9192226,Almond Hill Junior School,249,18490,10786,7704
919,Hertfordshire,9192227,Oakwood Primary School,272,18720,10920,7800
919,Hertfordshire,9192228,Northfields Infants and Nursery School,120,17200,10033,7167
919,Hertfordshire,9192229,Purwell Primary School,179,17790,10378,7412
919,Hertfordshire,9192237,Harwood Hill Junior Mixed Infant and Nursery School,170,17700,10325,7375
919,Hertfordshire,9192240,Creswick Primary & Nursery School,343,19430,11334,8096
919,Hertfordshire,9192242,Thorley Hill Primary School,181,17810,10389,7421
919,Hertfordshire,9192243,Micklem Primary School,161,17610,10273,7337
919,Hertfordshire,9192250,Brookland Junior School,332,19320,11270,8050
919,Hertfordshire,9192251,The Reddings Primary School,166,17660,10302,7358
919,Hertfordshire,9192252,How Wood Primary and Nursery School,169,17690,10319,7371
919,Hertfordshire,9192253,Redbourn Infants and Nursery School,368,19680,11480,8200
919,Hertfordshire,9192258,Skyswood Primary & Nursery School,182,17820,10395,7425
919,Hertfordshire,9192261,Bushey Manor Junior School,236,18360,10710,7650
919,Hertfordshire,9192263,Goffs Oak Primary & Nursery School,176,17760,10360,7400
919,Hertfordshire,9192266,Eastbury Farm Primary School,254,18540,10815,7725
919,Hertfordshire,9192274,Gade Valley Primary School,178,17780,10372,7408
919,Hertfordshire,9192280,Cunningham Hill Junior School,239,18390,10728,7662
919,Hertfordshire,9192283,Homerswood Primary and Nursery School,176,17760,10360,7400
919,Hertfordshire,9192287,Whitehill Junior School,243,18430,10751,7679
919,Hertfordshire,9192288,Westfield Primary School and Nursery,209,18090,10553,7537
919,Hertfordshire,9192289,Downfield Primary School,319,19190,11194,7996
919,Hertfordshire,9192293,Pixies Hill Primary School,173,17730,10343,7387
919,Hertfordshire,9192299,The Grove Junior School,356,19560,11410,8150
919,Hertfordshire,9192300,Pixmore Junior School,235,18350,10704,7646
919,Hertfordshire,9192301,Swing Gate Infant School and Nursery,106,17060,9952,7108
919,Hertfordshire,9192302,Oaklands Primary School,163,17630,10284,7346
919,Hertfordshire,9192304,Hollybush Primary School,169,17690,10319,7371
919,Hertfordshire,9192308,Maple Cross Junior Mixed Infant and Nursery School,153,17530,10226,7304
919,Hertfordshire,9192311,Wheatfields Infants and Nursery School,180,17800,10383,7417
919,Hertfordshire,9192312,Moss Bury Primary School and Nursery,280,18800,10967,7833
919,Hertfordshire,9192314,Westfield Community Primary School,164,17640,10290,7350
919,Hertfordshire,9192316,Priors Wood Primary School,171,17710,10331,7379
919,Hertfordshire,9192317,Brookland Infant and Nursery School,171,17710,10331,7379
919,Hertfordshire,9192322,Goldfield Infants and Nursery School,119,17190,10028,7162
919,Hertfordshire,9192326,Greenway Primary and Nursery School,268,18680,10897,7783
919,Hertfordshire,9192327,Thorn Grove Primary School,178,17780,10372,7408
919,Hertfordshire,9192331,Icknield Walk First School,237,18370,10716,7654
919,Hertfordshire,9192332,Cunningham Hill Infant School,119,17190,10028,7162
919,Hertfordshire,9192333,Reedings Junior School,243,18430,10751,7679
919,Hertfordshire,9192336,The Grove Infant and Nursery School,173,17730,10343,7387
919,Hertfordshire,9192338,Kings Langley Primary School,355,19550,11404,8146
919,Hertfordshire,9192339,Forres Primary School,292,18920,11037,7883
919,Hertfordshire,9192341,Martins Wood Primary School,513,21130,12326,8804
919,Hertfordshire,9192343,Dundale Primary School and Nursery,169,17690,10319,7371
919,Hertfordshire,9192348,Arnett Hills Junior Mixed and Infant School,183,17830,10401,7429
919,Hertfordshire,9192349,Holywell Primary School,425,20250,11813,8437
919,Hertfordshire,9192353,Trotts Hill Primary and Nursery School,177,17770,10366,7404
919,Hertfordshire,9192354,Cassiobury Infant and Nursery School,179,17790,10378,7412
919,Hertfordshire,9192356,Panshanger Primary School,180,17800,10383,7417
919,Hertfordshire,9192360,Bournehall Primary School,210,18100,10558,7542
919,Hertfordshire,9192362,Mill Mead Primary School,179,17790,10378,7412
919,Hertfordshire,9192364,Maple Primary School,218,18180,10605,7575
919,Hertfordshire,9192365,Round Diamond Primary School,371,19710,11498,8212
919,Hertfordshire,9192375,Andrews Lane Primary School,176,17760,10360,7400
919,Hertfordshire,9192378,Newberries Primary School,177,17770,10366,7404
919,Hertfordshire,9192379,Rickmansworth Park Junior Mixed and Infant School,179,17790,10378,7412
919,Hertfordshire,9192380,Mandeville Primary School,209,18090,10553,7537
919,Hertfordshire,9192381,Giles Junior School,261,18610,10856,7754
919,Hertfordshire,9192386,Millfield First and Nursery School,177,17770,10366,7404
919,Hertfordshire,9192387,Hillmead Primary School,229,18290,10669,7621
919,Hertfordshire,9192389,Nascot Wood Junior School,271,18710,10914,7796
919,Hertfordshire,9192391,The Ryde School,176,17760,10360,7400
919,Hertfordshire,9192392,William Ransom Primary School,250,18500,10792,7708
919,Hertfordshire,9192393,Prae Wood Primary School,320,19200,11200,8000
919,Hertfordshire,9192394,The Giles Infant and Nursery School,173,17730,10343,7387
919,Hertfordshire,9192395,Kingsway Infants School,113,17130,9993,7137
919,Hertfordshire,9192397,Kingshill Infant School,119,17190,10028,7162
919,Hertfordshire,9192401,Woodside Primary School,178,17780,10372,7408
919,Hertfordshire,9192405,Woolenwick Junior School,234,18340,10698,7642
919,Hertfordshire,9192406,Woolenwick Infant and Nursery School,115,17150,10004,7146
919,Hertfordshire,9192407,Leavesden JMI School,238,18380,10722,7658
919,Hertfordshire,9192411,Longlands Primary School and Nursery,168,17680,10313,7367
919,Hertfordshire,9192412,The Lea Primary School and Nursery,178,17780,10372,7408
919,Hertfordshire,9192414,Wheatcroft Primary School,265,18650,10879,7771
919,Hertfordshire,9192415,Mary Exton Primary School,173,17730,10343,7387
919,Hertfordshire,9192416,Lordship Farm Primary School,343,19430,11334,8096
919,Hertfordshire,9192417,Studlands Rise First School,118,17180,10022,7158
919,Hertfordshire,9192422,Lime Walk Primary School,169,17690,10319,7371
919,Hertfordshire,9192424,Fairfields Primary School and Nursery,360,19600,11433,8167
919,Hertfordshire,9192426,Aycliffe Drive Primary School,257,18570,10833,7737
919,Hertfordshire,9192427,Holtsmere End Junior School,207,18070,10541,7529
919,Hertfordshire,9192428,Samuel Lucas Junior Mixed and Infant School,302,19020,11095,7925
919,Hertfordshire,9192433,Coates Way JMI and Nursery School,182,17820,10395,7425
919,Hertfordshire,9192437,High Beeches Primary School,300,19000,11083,7917
919,Hertfordshire,9192442,Stonehill School,186,17860,10418,7442
919,Hertfordshire,9192443,Richard Whittington Primary School,272,18720,10920,7800
919,Hertfordshire,9192446,Watchlytes Junior Mixed Infant and Nursery School,203,18030,10518,7512
919,Hertfordshire,9192448,Brockswood Primary School,189,17890,10436,7454
919,Hertfordshire,9192451,Ashtree Primary School and Nursery,349,19490,11369,8121
919,Hertfordshire,9192452,Sheredes Primary School,361,19610,11439,8171
919,Hertfordshire,9192457,Wood End School,420,20200,11783,8417
919,Hertfordshire,9192462,Bengeo Primary School,387,19870,11591,8279
919,Hertfordshire,9192464,Morgans Primary School & Nursery,368,19680,11480,8200
919,Hertfordshire,9192465,The Leys Primary and Nursery School,402,20020,11678,8342
919,Hertfordshire,9192466,Belswains Primary School,206,18060,10535,7525
919,Hertfordshire,9192467,Bonneygrove Primary School,334,19340,11282,8058
919,Hertfordshire,9192468,Burleigh Primary School,339,19390,11311,8079
919,Hertfordshire,9192469,Hobbs Hill Wood Primary School,361,19610,11439,8171
919,Hertfordshire,9192980,Cranborne Primary School,358,19580,11422,8158
919,Hertfordshire,9192982,Ladbrooke Junior Mixed and Infant School,179,17790,10378,7412
919,Hertfordshire,9192985,Oakmere Primary School,233,18330,10693,7637
919,Hertfordshire,9192991,Nascot Wood Infant and Nursery School,118,17180,10022,7158
919,Hertfordshire,9192994,Hartsfield Junior Mixed and Infant School,389,19890,11603,8287
919,Hertfordshire,9192995,Holtsmere End Infant and Nursery School,117,17170,10016,7154
919,Hertfordshire,9192996,Commonswood Primary & Nursery School,371,19710,11498,8212
919,Hertfordshire,9192997,Millbrook School,150,17500,10208,7292
919,Hertfordshire,9193000,Aldbury Church of England Primary School,78,16780,9788,6992
919,Hertfordshire,9193003,St Johns Church of England Infant and Nursery School,116,17160,10010,7150
919,Hertfordshire,9193004,St Marys Infants School,117,17170,10016,7154
919,Hertfordshire,9193005,St Marys Junior Mixed School,239,18390,10728,7662
919,Hertfordshire,9193006,Barley Church of England Voluntary Controlled First School,30,16300,9508,6792
919,Hertfordshire,9193007,Bayford Church of England Voluntary Controlled Primary School,80,16800,9800,7000
919,Hertfordshire,9193008,Tonwell St Marys Church of England Primary School,31,16310,9514,6796
919,Hertfordshire,9193009,Benington Church of England Primary School,87,16870,9841,7029
919,Hertfordshire,9193011,Layston Church of England First School,120,17200,10033,7167
919,Hertfordshire,9193012,Ashfield Junior School,238,18380,10722,7658
919,Hertfordshire,9193013,Codicote Church of England Primary School,197,17970,10483,7487
919,Hertfordshire,9193015,Essendon CofE (VC) Primary School,75,16750,9771,6979
919,Hertfordshire,9193016,Furneux Pelham Church of England School,110,17100,9975,7125
919,Hertfordshire,9193018,Graveley Primary School,90,16900,9858,7042
919,Hertfordshire,9193020,Ponsbourne St Marys Church of England Primary School,76,16760,9777,6983
919,Hertfordshire,9193025,Hertford St Andrew CofE Primary School,102,17020,9928,7092
919,Hertfordshire,9193026,High Wych Church of England Primary School,180,17800,10383,7417
919,Hertfordshire,9193029,Wormley Primary School,355,19550,11404,8146
919,Hertfordshire,9193030,Ickleford Primary School,179,17790,10378,7412
919,Hertfordshire,9193032,Little Munden Church of England Voluntary Controlled Primary School,51,16510,9631,6879
919,Hertfordshire,9193034,Preston Primary School,76,16760,9777,6983
919,Hertfordshire,9193038,Spellbrook Primary School,92,16920,9870,7050
919,Hertfordshire,9193039,Roger De Clare First CofE School,216,18160,10593,7567
919,Hertfordshire,9193040,St Andrews Church of England Voluntary Controlled Primary School,174,17740,10348,7392
919,Hertfordshire,9193041,Thundridge Church of England Primary School,72,16720,9753,6967
919,Hertfordshire,9193042,St Marys Voluntary Controlled Church of England Junior School,238,18380,10722,7658
919,Hertfordshire,9193043,St Catherines Church of England Primary School,309,19090,11136,7954
919,Hertfordshire,9193045,Wareside Church of England Primary School,37,16370,9549,6821
919,Hertfordshire,9193047,Weston Primary School,111,17110,9981,7129
919,Hertfordshire,9193049,Potten End CofE Primary School,177,17770,10366,7404
919,Hertfordshire,9193053,Dewhurst St Mary CofE Primary School,167,17670,10308,7362
919,Hertfordshire,9193054,Leverstock Green Church of England Primary School,179,17790,10378,7412
919,Hertfordshire,9193301,St Pauls Church of England Primary School Langleybury,179,17790,10378,7412
919,Hertfordshire,9193302,Nash Mills Church of England Primary School,177,17770,10366,7404
919,Hertfordshire,9193303,Albury Church of England Voluntary Aided Primary School,43,16430,9584,6846
919,Hertfordshire,9193304,Hertsmere Jewish Primary School,360,19600,11433,8167
919,Hertfordshire,9193306,Ardeley St Lawrence Church of England Voluntary Aided Primary School,62,16620,9695,6925
919,Hertfordshire,9193307,Aston St Marys Church of England Aided Primary School,107,17070,9958,7112
919,Hertfordshire,9193308,Barkway VA Church of England First School,16,16000,9333,6667
919,Hertfordshire,9193314,Victoria Church of England Infant and Nursery School,86,16860,9835,7025
919,Hertfordshire,9193315,St Marys CofE Primary School Northchurch,164,17640,10290,7350
919,Hertfordshire,9193318,St Josephs Catholic Primary School,263,18630,10868,7762
919,Hertfordshire,9193319,St Michaels Church of England Primary School,179,17790,10378,7412
919,Hertfordshire,9193326,Holy Trinity Church of England Primary School,162,17620,10278,7342
919,Hertfordshire,9193327,St Josephs Catholic Primary School,180,17800,10383,7417
919,Hertfordshire,9193329,All Saints Church of England Voluntary Aided Primary School Datchworth,162,17620,10278,7342
919,Hertfordshire,9193333,St Nicholas Elstree Church of England VA Primary School,153,17530,10226,7304
919,Hertfordshire,9193334,St John the Baptist Voluntary Aided Church of England Primary School,176,17760,10360,7400
919,Hertfordshire,9193335,Great Gaddesden Church of England Primary School,67,16670,9724,6946
919,Hertfordshire,9193336,St Nicholas CofE VA Primary School,132,17320,10103,7217
919,Hertfordshire,9193339,St Johns Voluntary Aided Church of England Primary School Lemsford,88,16880,9847,7033
919,Hertfordshire,9193341,St Josephs Catholic Primary School,177,17770,10366,7404
919,Hertfordshire,9193344,Broxbourne CofE Primary School,180,17800,10383,7417
919,Hertfordshire,9193345,St Augustines Catholic Primary School,175,17750,10354,7396
919,Hertfordshire,9193347,Hormead Church of England (VA) First School,45,16450,9596,6854
919,Hertfordshire,9193348,St Ippolyts Church of England Aided Primary School,138,17380,10138,7242
919,Hertfordshire,9193349,St Pauls Church of England Voluntary Aided Primary School Chipperfield,171,17710,10331,7379
919,Hertfordshire,9193350,Norton St Nicholas CofE (VA) Primary School,178,17780,10372,7408
919,Hertfordshire,9193352,Little Gaddesden Church of England Voluntary Aided Primary School,87,16870,9841,7029
919,Hertfordshire,9193353,St Andrews CofE Primary School and Nursery,169,17690,10319,7371
919,Hertfordshire,9193357,Offley Endowed Primary School,101,17010,9923,7087
919,Hertfordshire,9193358,Cockernhoe Endowed CofE Primary School,83,16830,9818,7012
919,Hertfordshire,9193359,St Marys Church of England Primary School Rickmansworth,170,17700,10325,7375
919,Hertfordshire,9193360,St Peters Church of England Voluntary Aided Primary School,177,17770,10366,7404
919,Hertfordshire,9193361,The Abbey Church of England Voluntary Aided Primary School St Albans,180,17800,10383,7417
919,Hertfordshire,9193362,St Alban and St Stephen Roman Catholic Infant and Nursery School,116,17160,10010,7150
919,Hertfordshire,9193363,St Michaels Church of England Voluntary Aided Primary School St Albans,125,17250,10063,7187
919,Hertfordshire,9193364,Park Street Church of England Voluntary Aided Primary School,169,17690,10319,7371
919,Hertfordshire,9193366,Puller Memorial Church of England Voluntary Aided Primary School,54,16540,9648,6892
919,Hertfordshire,9193367,St Thomas of Canterbury Roman Catholic Primary School,95,16950,9888,7062
919,Hertfordshire,9193368,Stapleford Primary School,52,16520,9637,6883
919,Hertfordshire,9193369,St Nicholas CofE (VA) Primary School and Nursery,178,17780,10372,7408
919,Hertfordshire,9193370,Tewin Cowper Church of England Voluntary Aided Primary School,136,17360,10127,7233
919,Hertfordshire,9193371,Bishop Wood Church of England Junior School Tring,241,18410,10739,7671
919,Hertfordshire,9193373,Long Marston VA Church of England Primary School,122,17220,10045,7175
919,Hertfordshire,9193376,St Johns CofE Primary School,175,17750,10354,7396
919,Hertfordshire,9193378,St Michaels Woolmer Green CofE VA Primary School,172,17720,10337,7383
919,Hertfordshire,9193379,St Helens Church of England Primary School,275,18750,10938,7812
919,Hertfordshire,9193380,St Bartholomews Church of England Voluntary Aided Primary School Wigginton,88,16880,9847,7033
919,Hertfordshire,9193382,Our Lady  Catholic Primary School,176,17760,10360,7400
919,Hertfordshire,9193383,St Joseph Catholic Primary School,177,17770,10366,7404
919,Hertfordshire,9193384,St Teresa Roman Catholic Primary School,178,17780,10372,7408
919,Hertfordshire,9193385,St Andrews Church of England Voluntary Aided Primary School Hitchin,182,17820,10395,7425
919,Hertfordshire,9193386,St Cuthbert Mayne Catholic Junior School,239,18390,10728,7662
919,Hertfordshire,9193388,St Philip Howard Catholic Primary School,339,19390,11311,8079
919,Hertfordshire,9193389,St Adrian Roman Catholic Primary School,182,17820,10395,7425
919,Hertfordshire,9193391,Saint Albert the Great Catholic Primary School,175,17750,10354,7396
919,Hertfordshire,9193393,All Saints Church of England Primary School and Nursery Bishops Stortford,180,17800,10383,7417
919,Hertfordshire,9193394,Christ Church CofE (VA) Primary School and Nursery Ware,261,18610,10856,7754
919,Hertfordshire,9193397,St Margaret Clitherow Roman Catholic Primary School,180,17800,10383,7417
919,Hertfordshire,9193398,St John Catholic Primary School,181,17810,10389,7421
919,Hertfordshire,9193401,St Dominic Catholic Primary School,239,18390,10728,7662
919,Hertfordshire,9193402,St Thomas More Roman Catholic Voluntary Aided Primary School,168,17680,10313,7367
919,Hertfordshire,9193403,St John Fisher Roman Catholic Primary School,168,17680,10313,7367
919,Hertfordshire,9193404,The Holy Family Catholic Primary School,173,17730,10343,7387
919,Hertfordshire,9193408,St Cross Catholic Primary School,179,17790,10378,7412
919,Hertfordshire,9193409,St Roses Catholic Infants School,118,17180,10022,7158
919,Hertfordshire,9193410,Divine Saviour Roman Catholic Primary School,177,17770,10366,7404
919,Hertfordshire,9193415,Sacred Heart Catholic Primary School and Nursery,236,18360,10710,7650
919,Hertfordshire,9193416,Saint Bernadette Catholic Primary School,177,17770,10366,7404
919,Hertfordshire,9193419,Welwyn St Marys Church of England Voluntary Aided Primary School,368,19680,11480,8200
919,Hertfordshire,9193421,Saint Alban and St Stephen Catholic Junior School,240,18400,10733,7667
919,Hertfordshire,9193423,St Pauls Catholic Primary School,157,17570,10249,7321
919,Hertfordshire,9193424,Sacred Heart Catholic Primary School,180,17800,10383,7417
919,Hertfordshire,9193428,St Anthonys Catholic Primary School,345,19450,11346,8104
919,Hertfordshire,9193975,Pope Paul Catholic Primary School,175,17750,10354,7396
919,Hertfordshire,9193976,St Marys Church of England Primary School,114,17140,9998,7142
919,Hertfordshire,9193977,Saint Vincent de Paul Catholic Primary School,355,19550,11404,8146
919,Hertfordshire,9193978,St Catherines Hoddesdon CofE Primary School,286,18860,11002,7858
919,Hertfordshire,9193982,De Havilland Primary School,374,19740,11515,8225
919,Hertfordshire,9193983,Longmeadow Primary School,327,19270,11241,8029
919,Hertfordshire,9193984,Shephalbury Park Primary School,172,17720,10337,7383
919,Hertfordshire,9193985,Holy Rood Catholic Primary School,374,19740,11515,8225
919,Hertfordshire,9193987,Maple Grove Primary School,167,17670,10308,7362
919,Hertfordshire,9193988,Yewtree Primary School,279,18790,10961,7829
919,Hertfordshire,9193989,Oak View Primary and Nursery School,314,19140,11165,7975
919,Hertfordshire,9193990,Galley Hill Primary School and Nursery,307,19070,11124,7946
919,Hertfordshire,9193992,Killigrew Primary and Nursery School,356,19560,11410,8150
919,Hertfordshire,9194144,Bridgewater Primary School,233,18330,10693,7637
919,Hertfordshire,9194506,Edwinstree Church of England Middle School,179,17790,10378,7412
919,Hertfordshire,9194627,The Thomas Coram Church of England School,355,19550,11404,8146
919,Hertfordshire,9195202,Parkside Community Primary School,290,18900,11025,7875
919,Hertfordshire,9195203,Hertingfordbury Cowper Primary School,173,17730,10343,7387
919,Hertfordshire,9195204,St Giles CofE Primary School,84,16840,9823,7017
919,Hertfordshire,9195205,Cuffley School,358,19580,11422,8158
919,Hertfordshire,9195207,Little Heath Primary School,176,17760,10360,7400
919,Hertfordshire,9195209,Northaw Church of England Primary School,89,16890,9853,7037
919,Hertfordshire,9195210,Brookmans Park Primary School,273,18730,10926,7804
919,Hertfordshire,9195213,Clore Shalom School,179,17790,10378,7412
919,Hertfordshire,9197011,Colnbrook School,96,16960,9893,7067
919,Hertfordshire,9197012,St Lukes School,22,16220,9462,6758
919,Hertfordshire,9197013,The Collett School,56,16560,9660,6900
919,Hertfordshire,9197019,Middleton School,84,16840,9823,7017
919,Hertfordshire,9197022,Lonsdale School,20,16200,9450,6750
919,Hertfordshire,9197023,Lakeside School,29,16290,9503,6787
919,Hertfordshire,9197024,Breakspeare School,44,16440,9590,6850
919,Hertfordshire,9197025,Woodfield School,49,16490,9619,6871
919,Hertfordshire,9197026,Watling View School,38,16380,9555,6825
919,Hertfordshire,9197028,Amwell View School,72,16720,9753,6967
919,Hertfordshire,9197032,Heathlands School,39,16390,9561,6829
919,Hertfordshire,9197042,Greenside School,57,16570,9666,6904
919,Hertfordshire,9197043,Meadow Wood School,21,16210,9456,6754
919,Hertfordshire,9197044,Southfield School,75,16750,9771,6979
919,Hertfordshire,9197047,Haywood Grove School,51,16510,9631,6879
921,Isle of Wight,9211102,Island Learning Centre,12,12000,7000,5000
921,Isle of Wight,9212001,Chillerton and Rookley Primary School,70,16700,9742,6958
921,Isle of Wight,9212002,Cowes Primary School,243,18430,10751,7679
921,Isle of Wight,9212005,Gatten and Lake Primary School,174,17740,10348,7392
921,Isle of Wight,9212006,Godshill Primary School,112,17120,9987,7133
921,Isle of Wight,9212007,Gurnard Primary School,324,19240,11223,8017
921,Isle of Wight,9212009,Nettlestone Primary School,184,17840,10407,7433
921,Isle of Wight,9212010,Newchurch Primary School,183,17830,10401,7429
921,Isle of Wight,9212012,Barton Primary School,198,17980,10488,7492
921,Isle of Wight,9212014,Nine Acres Primary School,308,19080,11130,7950
921,Isle of Wight,9212015,Niton Primary School,142,17420,10162,7258
921,Isle of Wight,9212018,Hunnyhill Primary School,268,18680,10897,7783
921,Isle of Wight,9212021,Haylands Primary School,340,19400,11317,8083
921,Isle of Wight,9212024,St Helens Primary School,77,16770,9783,6987
921,Isle of Wight,9212029,Wootton Community Primary School,166,17660,10302,7358
921,Isle of Wight,9212030,Wroxall Primary School,140,17400,10150,7250
921,Isle of Wight,9212033,Broadlea Primary School,323,19230,11218,8012
921,Isle of Wight,9212038,Binstead Primary School,178,17780,10372,7408
921,Isle of Wight,9212039,Green Mount Primary School,349,19490,11369,8121
921,Isle of Wight,9212041,Summerfields Primary School,158,17580,10255,7325
921,Isle of Wight,9212042,Dover Park Primary School,166,17660,10302,7358
921,Isle of Wight,9212043,Queensgate Foundation Primary,349,19490,11369,8121
921,Isle of Wight,9212044,The Bay Church of England Primary,354,19540,11398,8142
921,Isle of Wight,9213000,Arreton St Georges Church of England Controlled Primary School,154,17540,10232,7308
921,Isle of Wight,9213001,Bembridge Church of England Primary School,169,17690,10319,7371
921,Isle of Wight,9213003,Brading Church of England Controlled Primary School,92,16920,9870,7050
921,Isle of Wight,9213004,Carisbrooke Church of England Controlled Primary School,341,19410,11323,8087
921,Isle of Wight,9213006,All Saints Church of England Primary School Freshwater,82,16820,9812,7008
921,Isle of Wight,9213011,Shalfleet Church of England Primary School,145,17450,10179,7271
921,Isle of Wight,9213300,Brighstone Church of England Aided Primary School,108,17080,9963,7117
921,Isle of Wight,9213303,Oakfield Church of England Aided Primary School Ryde,244,18440,10757,7683
921,Isle of Wight,9213304,Yarmouth Church of England Aided Primary School,75,16750,9771,6979
921,Isle of Wight,9213310,St Marys Catholic Primary School,156,17560,10243,7317
921,Isle of Wight,9213311,St Saviours Catholic Primary School,115,17150,10004,7146
921,Isle of Wight,9213313,Holy Cross Catholic Primary School,171,17710,10331,7379
921,Isle of Wight,9213314,St Thomas of Canterbury Catholic Primary School,151,17510,10214,7296
921,Isle of Wight,9213315,Newport Church of England Aided Primary School,252,18520,10803,7717
921,Isle of Wight,9217003,Medina House School,70,16700,9742,6958
925,Lincolnshire,9252003,Billingborough Primary School,110,17100,9975,7125
925,Lincolnshire,9252013,Corby Glen Community Primary School,102,17020,9928,7092
925,Lincolnshire,9252017,Digby the Tedder Primary School,88,16880,9847,7033
925,Lincolnshire,9252019,Eagle Community Primary School,64,16640,9707,6933
925,Lincolnshire,9252025,Helpringham School,86,16860,9835,7025
925,Lincolnshire,9252028,Langtoft Primary School,181,17810,10389,7421
925,Lincolnshire,9252030,The Metheringham Primary School,224,18240,10640,7600
925,Lincolnshire,9252031,Nocton Community Primary School,50,16500,9625,6875
925,Lincolnshire,9252033,North Scarle Primary School,42,16420,9578,6842
925,Lincolnshire,9252034,Osbournby Primary School,85,16850,9829,7021
925,Lincolnshire,9252038,Church Lane Primary School,171,17710,10331,7379
925,Lincolnshire,9252039,The South Hykeham Community Primary School,129,17290,10086,7204
925,Lincolnshire,9252046,Thurlby Community Primary School,178,17780,10372,7408
925,Lincolnshire,9252050,Walcott Primary School,60,16600,9683,6917
925,Lincolnshire,9252054,Belton Lane Community Primary School,227,18270,10658,7612
925,Lincolnshire,9252055,Cliffedale Primary School,269,18690,10903,7787
925,Lincolnshire,9252062,Deeping St James Community Primary School,185,17850,10413,7437
925,Lincolnshire,9252065,Market Deeping Community Primary School,220,18200,10617,7583
925,Lincolnshire,9252066,The Bluecoat School Stamford,164,17640,10290,7350
925,Lincolnshire,9252067,Skellingthorpe the Holt Primary School,169,17690,10319,7371
925,Lincolnshire,9252070,Belmont Community Primary School,174,17740,10348,7392
925,Lincolnshire,9252084,South View Community Primary School,345,19450,11346,8104
925,Lincolnshire,9252085,Deeping St Nicholas Primary School,54,16540,9648,6892
925,Lincolnshire,9252087,Fleet Wood Lane School,142,17420,10162,7258
925,Lincolnshire,9252088,Gedney Church End Primary School,55,16550,9654,6896
925,Lincolnshire,9252089,Gedney Drove End Primary School,47,16470,9608,6862
925,Lincolnshire,9252091,Clough and Risegate Community Primary School,68,16680,9730,6950
925,Lincolnshire,9252094,Kirton Primary School,427,20270,11824,8446
925,Lincolnshire,9252095,Long Sutton Primary School,333,19330,11276,8054
925,Lincolnshire,9252096,Moulton Chapel Primary School,60,16600,9683,6917
925,Lincolnshire,9252097,The John Harrox Primary School Moulton,236,18360,10710,7650
925,Lincolnshire,9252102,Surfleet Primary School,76,16760,9777,6983
925,Lincolnshire,9252104,Sutton St James Community Primary School,80,16800,9800,7000
925,Lincolnshire,9252105,Lutton St Nicholas Primary School,83,16830,9818,7012
925,Lincolnshire,9252107,Shepeau Stow Primary School,71,16710,9748,6962
925,Lincolnshire,9252109,St Pauls Community Primary and Nursery School Spalding,174,17740,10348,7392
925,Lincolnshire,9252113,Hawthorn Tree School,341,19410,11323,8087
925,Lincolnshire,9252114,The Spalding Monkshouse Primary School,313,19130,11159,7971
925,Lincolnshire,9252120,Sir Francis Hill Community Primary School,373,19730,11509,8221
925,Lincolnshire,9252124,Lincoln Monks Abbey Primary School,346,19460,11352,8108
925,Lincolnshire,9252135,Woodlands Infant and Nursery School,79,16790,9794,6996
925,Lincolnshire,9252142,Alford Primary School,311,19110,11148,7962
925,Lincolnshire,9252146,Bucknall Primary School,34,16340,9532,6808
925,Lincolnshire,9252149,The Donington-on-Bain School,65,16650,9713,6937
925,Lincolnshire,9252151,Faldingworth Community Primary School,54,16540,9648,6892
925,Lincolnshire,9252153,Fulstow Community Primary School,30,16300,9508,6792
925,Lincolnshire,9252158,Grainthorpe School,27,16270,9491,6779
925,Lincolnshire,9252159,Great Steeping Primary School,93,16930,9876,7054
925,Lincolnshire,9252162,Holton Le Clay Infant School,63,16630,9701,6929
925,Lincolnshire,9252166,Ingham Primary School,94,16940,9882,7058
925,Lincolnshire,9252169,Legsby Primary School,35,16350,9538,6812
925,Lincolnshire,9252174,Marshchapel Primary School,57,16570,9666,6904
925,Lincolnshire,9252176,The Middle Rasen Primary School,86,16860,9835,7025
925,Lincolnshire,9252177,Morton Trentside Primary School,175,17750,10354,7396
925,Lincolnshire,9252178,Nettleton Community Primary School,67,16670,9724,6946
925,Lincolnshire,9252179,The New Leake Primary School,50,16500,9625,6875
925,Lincolnshire,9252181,Normanby Primary School,53,16530,9643,6887
925,Lincolnshire,9252182,Kelsey Primary School,79,16790,9794,6996
925,Lincolnshire,9252185,Osgodby Primary School,81,16810,9806,7004
925,Lincolnshire,9252187,Pollyplatt Primary School,120,17200,10033,7167
925,Lincolnshire,9252188,Scotter Primary School,216,18160,10593,7567
925,Lincolnshire,9252191,The Skegness Seathorne Primary School,287,18870,11008,7862
925,Lincolnshire,9252195,Sturton by Stow Primary School,137,17370,10133,7237
925,Lincolnshire,9252196,Sutton-on-Sea Community Primary School,166,17660,10302,7358
925,Lincolnshire,9252197,Tealby School,81,16810,9806,7004
925,Lincolnshire,9252198,The Edward Richardson Primary School Tetford,92,16920,9870,7050
925,Lincolnshire,9252199,Tetney Primary School,62,16620,9695,6925
925,Lincolnshire,9252201,Toynton All Saints Primary School,99,16990,9911,7079
925,Lincolnshire,9252203,Waddingham Primary School,68,16680,9730,6950
925,Lincolnshire,9252205,Willoughton Primary School,47,16470,9608,6862
925,Lincolnshire,9252206,Wragby Primary School,149,17490,10203,7287
925,Lincolnshire,9252210,Hemswell Cliff Primary School,67,16670,9724,6946
925,Lincolnshire,9252214,The Gainsborough Charles Baines Community Primary School,172,17720,10337,7383
925,Lincolnshire,9252215,Tattershall Primary School,111,17110,9981,7129
925,Lincolnshire,9252219,The Richmond School Skegness,389,19890,11603,8287
925,Lincolnshire,9252224,Winchelsea Primary School Ruskington,158,17580,10255,7325
925,Lincolnshire,9252229,Holton-le-Clay Junior School,154,17540,10232,7308
925,Lincolnshire,9252232,Linchfield Community Primary School,367,19670,11474,8196
925,Lincolnshire,9252238,Sutton Bridge Westmere Community Primary School,224,18240,10640,7600
925,Lincolnshire,9252241,Cherry Willingham Primary School,216,18160,10593,7567
925,Lincolnshire,9252243,Bythams Primary School,84,16840,9823,7017
925,Lincolnshire,9252244,Horncastle Community Primary School,449,20490,11953,8537
925,Lincolnshire,9252245,Lincoln Birchwood Junior School,289,18890,11019,7871
925,Lincolnshire,9252246,Leslie Manser Primary School,227,18270,10658,7612
925,Lincolnshire,9252248,St Botolphs C of E Primary School,350,19500,11375,8125
925,Lincolnshire,9253000,Allington with Sedgebrook Church of England Primary School,100,17000,9917,7083
925,Lincolnshire,9253001,Ancaster CofE Primary School,142,17420,10162,7258
925,Lincolnshire,9253004,Barrowby Church of England Primary School,220,18200,10617,7583
925,Lincolnshire,9253005,Baston CE Primary School,178,17780,10372,7408
925,Lincolnshire,9253007,The Billinghay Church of England Primary School,127,17270,10074,7196
925,Lincolnshire,9253015,Coleby Church of England (Controlled) Primary School,61,16610,9689,6921
925,Lincolnshire,9253017,Denton CofE School,58,16580,9672,6908
925,Lincolnshire,9253018,Digby Church of England School,66,16660,9718,6942
925,Lincolnshire,9253021,Dunston St Peters Church of England Primary School,82,16820,9812,7008
925,Lincolnshire,9253026,St Annes Church of England Primary School Grantham,177,17770,10366,7404
925,Lincolnshire,9253029,The Gonerby Hill Foot Church of England Primary School,295,18950,11054,7896
925,Lincolnshire,9253031,The Harlaxton Church of England Primary School,172,17720,10337,7383
925,Lincolnshire,9253033,Heckington St Andrews Church of England School,151,17510,10214,7296
925,Lincolnshire,9253037,The Leasingham St Andrews Church of England Primary School,179,17790,10378,7412
925,Lincolnshire,9253041,Mrs Mary Kings CofE (Controlled) Primary School,79,16790,9794,6996
925,Lincolnshire,9253045,Navenby Church of England Primary School,174,17740,10348,7392
925,Lincolnshire,9253047,The North Hykeham All Saints Church of England Primary School,186,17860,10418,7442
925,Lincolnshire,9253050,The Potterhanworth Church of England Primary School,83,16830,9818,7012
925,Lincolnshire,9253052,The Ropsley Church of England Primary School,85,16850,9829,7021
925,Lincolnshire,9253056,St Lawrence Church of England Primary School,159,17590,10261,7329
925,Lincolnshire,9253066,Swinderby All Saints Church of England Primary School,69,16690,9736,6954
925,Lincolnshire,9253068,The St Michaels Church of England Primary School Thorpe on the Hill,145,17450,10179,7271
925,Lincolnshire,9253070,The Uffington Church of England Primary School,80,16800,9800,7000
925,Lincolnshire,9253071,The Welbourn Church of England Primary School,73,16730,9759,6971
925,Lincolnshire,9253078,The Claypole Church of England Primary School,150,17500,10208,7292
925,Lincolnshire,9253088,The Gedney Hill Church of England VC Primary School,51,16510,9631,6879
925,Lincolnshire,9253089,The Holbeach St Marks Church of England Primary School,39,16390,9561,6829
925,Lincolnshire,9253091,The Pinchbeck East Church of England Primary School,322,19220,11212,8008
925,Lincolnshire,9253092,St Bartholomews CofE Primary School,94,16940,9882,7058
925,Lincolnshire,9253093,Quadring Cowley & Browns Primary School,92,16920,9870,7050
925,Lincolnshire,9253096,Weston Hills CofE Primary School,121,17210,10039,7171
925,Lincolnshire,9253098,The Donington Cowley Endowed Primary School,222,18220,10628,7592
925,Lincolnshire,9253102,Swineshead St Marys Church of England Primary School,226,18260,10652,7608
925,Lincolnshire,9253103,The Fourfields Church of England School Sutterton,121,17210,10039,7171
925,Lincolnshire,9253105,The Lincoln St Peter-in-Eastgate Church of England (Controlled) Infants School,60,16600,9683,6917
925,Lincolnshire,9253107,The St Faith and St Martin Church of England Junior School Lincoln,232,18320,10687,7633
925,Lincolnshire,9253108,The St Faiths Church of England Infant School Lincoln,150,17500,10208,7292
925,Lincolnshire,9253111,The Lincoln St Peter at Gowts Church of England Primary School,184,17840,10407,7433
925,Lincolnshire,9253116,Binbrook CofE Primary School,60,16600,9683,6917
925,Lincolnshire,9253118,The St Peter and St Paul CofE Primary School,207,18070,10541,7529
925,Lincolnshire,9253120,Corringham CofE VC Primary School,95,16950,9888,7062
925,Lincolnshire,9253121,Dunholme St Chads Church of England Primary School,188,17880,10430,7450
925,Lincolnshire,9253122,Fiskerton Church of England Primary School,79,16790,9794,6996
925,Lincolnshire,9253123,Grasby All Saints Church of England Primary School,76,16760,9777,6983
925,Lincolnshire,9253124,The Hackthorn Church of England Primary School,54,16540,9648,6892
925,Lincolnshire,9253125,Halton Holegate CofE Primary School,53,16530,9643,6887
925,Lincolnshire,9253128,St Michaels Church of England School Louth,257,18570,10833,7737
925,Lincolnshire,9253130,The Mareham-le-Fen Church of England Primary School,67,16670,9724,6946
925,Lincolnshire,9253131,The Market Rasen Church of England Primary School,247,18470,10774,7696
925,Lincolnshire,9253132,Newton-on-Trent CofE Primary School,41,16410,9573,6837
925,Lincolnshire,9253133,The North Cotes Church of England Primary School,33,16330,9526,6804
925,Lincolnshire,9253134,North Cockerington Church of England Primary School,73,16730,9759,6971
925,Lincolnshire,9253136,Reepham Church of England Primary School,168,17680,10313,7367
925,Lincolnshire,9253139,Saxilby Church of England Primary School,263,18630,10868,7762
925,Lincolnshire,9253140,Scamblesby Church of England Primary School,54,16540,9648,6892
925,Lincolnshire,9253141,Scampton Church of England Primary School,68,16680,9730,6950
925,Lincolnshire,9253151,St Helenas Church of England Primary School Willoughby,102,17020,9928,7092
925,Lincolnshire,9253152,The St Margarets Church of England School Withern,59,16590,9678,6912
925,Lincolnshire,9253154,The Bardney Church of England and Methodist Primary School,145,17450,10179,7271
925,Lincolnshire,9253156,Caistor CofE and Methodist Primary School,266,18660,10885,7775
925,Lincolnshire,9253162,The St Nicholas Church of England Primary School Boston,196,17960,10477,7483
925,Lincolnshire,9253163,Brant Broughton Church of England and Methodist Primary School,82,16820,9812,7008
925,Lincolnshire,9253167,The Holbeach William Stukeley Church of England Voluntary Aided Primary School,238,18380,10722,7658
925,Lincolnshire,9253168,East Wold Church of England Primary School,87,16870,9841,7029
925,Lincolnshire,9253169,St Georges Church of England Community Primary School Gainsborough,172,17720,10337,7383
925,Lincolnshire,9253170,The Sibsey Free Primary School,141,17410,10156,7254
925,Lincolnshire,9253171,Stickney Church of England Primary School,147,17470,10191,7279
925,Lincolnshire,9253313,The St Sebastians Church of England Primary School Great Gonerby,98,16980,9905,7075
925,Lincolnshire,9253314,Great Ponton Church of England School,56,16560,9660,6900
925,Lincolnshire,9253319,Leadenham Church of England Primary School,35,16350,9538,6812
925,Lincolnshire,9253321,The Marston Thorolds Charity Church of England School,81,16810,9806,7004
925,Lincolnshire,9253322,The St Gilbert of Sempringham Church of England Primary School Pointon,78,16780,9788,6992
925,Lincolnshire,9253325,St Georges Church of England Aided Primary School,164,17640,10290,7350
925,Lincolnshire,9253337,The Cowbit St Marys (Endowed) CofE Primary,61,16610,9689,6921
925,Lincolnshire,9253338,The Spalding Parish Church of England Day School,423,20230,11801,8429
925,Lincolnshire,9253339,The Spalding St John the Baptist Church of England Primary School,372,19720,11503,8217
925,Lincolnshire,9253340,The Tydd St Mary Church of England Primary School,89,16890,9853,7037
925,Lincolnshire,9253350,Blyton Cum Laughton Church of England School,126,17260,10068,7192
925,Lincolnshire,9253353,Friskney All Saints Church of England (Aided) Primary School,136,17360,10127,7233
925,Lincolnshire,9253359,The Kirkby-on-Bain Church of England Primary School,82,16820,9812,7008
925,Lincolnshire,9253361,Frances Olive Anderson Church of England (Aided) Primary School,171,17710,10331,7379
925,Lincolnshire,9253364,The Nettleham Church of England Voluntary Aided Junior School,238,18380,10722,7658
925,Lincolnshire,9253366,Partney Church of England Aided Primary School,73,16730,9759,6971
925,Lincolnshire,9253505,The Lincoln Bishop King Church of England Primary School,325,19250,11229,8021
925,Lincolnshire,9253507,The Meadows Primary School,333,19330,11276,8054
925,Lincolnshire,9255207,Cranwell Primary School (Foundation),278,18780,10955,7825
925,Lincolnshire,9255211,Spalding Primary School,417,20170,11766,8404
925,Lincolnshire,9255215,The Old Leake Primary and Nursery School,165,17650,10296,7354
925,Lincolnshire,9255216,The Butterwick Pinchbecks Endowed CofE Primary School,262,18620,10862,7758
925,Lincolnshire,9255217,Grimoldby Primary School,175,17750,10354,7396
925,Lincolnshire,9255218,Wrangle Primary School,57,16570,9666,6904
925,Lincolnshire,9255219,The Lancaster School,106,17060,9952,7108
925,Lincolnshire,9255222,Barkston and Syston CofE Primary School,90,16900,9858,7042
925,Lincolnshire,9255225,North Somercotes CofE Primary School,166,17660,10302,7358
925,Lincolnshire,9255228,William Hildyard Church of England Primary and Nursery School,181,17810,10389,7421
925,Lincolnshire,9257015,The Lincoln St Christophers School,89,16890,9853,7037
925,Lincolnshire,9257016,The St Francis Special School Lincoln,36,16360,9543,6817
925,Lincolnshire,9257028,The Willoughby School,38,16380,9555,6825
925,Lincolnshire,9257031,Fortuna School,71,16710,9748,6962
926,Norfolk,9262000,Aldborough Primary School,117,17170,10016,7154
926,Norfolk,9262001,Necton VA Primary School,169,17690,10319,7371
926,Norfolk,9262004,Rosecroft Primary School,295,18950,11054,7896
926,Norfolk,9262007,Bacton Primary School,64,16640,9707,6933
926,Norfolk,9262010,Barford Primary School,88,16880,9847,7033
926,Norfolk,9262012,The Bawburgh School,88,16880,9847,7033
926,Norfolk,9262017,Blofield Primary School,189,17890,10436,7454
926,Norfolk,9262021,Bressingham Primary School,95,16950,9888,7062
926,Norfolk,9262028,Dersingham Primary School,215,18150,10588,7562
926,Norfolk,9262030,Kelling CE Primary School,49,16490,9619,6871
926,Norfolk,9262032,Buxton Primary School,177,17770,10366,7404
926,Norfolk,9262033,Caister Junior School,353,19530,11393,8137
926,Norfolk,9262034,Caister Infant Nursery School and Childrens Centre,173,17730,10343,7387
926,Norfolk,9262035,Cantley Primary School,81,16810,9806,7004
926,Norfolk,9262036,Walsingham CE VA Primary School,24,16240,9473,6767
926,Norfolk,9262038,Colby Primary School,124,17240,10057,7183
926,Norfolk,9262045,Cromer Junior School,290,18900,11025,7875
926,Norfolk,9262050,Clover Hill VA Infant and Nursery School,110,17100,9975,7125
926,Norfolk,9262064,Freethorpe Community Primary and Nursery School,135,17350,10121,7229
926,Norfolk,9262065,Frettenham Primary School,59,16590,9678,6912
926,Norfolk,9262069,Great Dunham Primary School,77,16770,9783,6987
926,Norfolk,9262070,Great Ellingham Primary School,138,17380,10138,7242
926,Norfolk,9262078,Hempnall Primary School,96,16960,9893,7067
926,Norfolk,9262079,Hemsby Primary School,148,17480,10197,7283
926,Norfolk,9262081,Hevingham Primary School,91,16910,9864,7046
926,Norfolk,9262083,Hingham Primary School,145,17450,10179,7271
926,Norfolk,9262087,Holt Community Primary School,152,17520,10220,7300
926,Norfolk,9262089,Horning Community Primary School,46,16460,9602,6858
926,Norfolk,9262096,Langham Village School,70,16700,9742,6958
926,Norfolk,9262100,Horsford CofE VA Primary School,248,18480,10780,7700
926,Norfolk,9262101,Little Melton Primary School,93,16930,9876,7054
926,Norfolk,9262105,Ludham Primary School and Nursery,84,16840,9823,7017
926,Norfolk,9262107,Marsham Primary School,29,16290,9503,6787
926,Norfolk,9262115,Mundesley Infant School,66,16660,9718,6942
926,Norfolk,9262119,Northrepps Primary School,26,16260,9485,6775
926,Norfolk,9262121,Millfield Primary School,227,18270,10658,7612
926,Norfolk,9262124,Ormesby Village Infant School,93,16930,9876,7054
926,Norfolk,9262127,Poringland Primary School,286,18860,11002,7858
926,Norfolk,9262130,Rackheath Primary School,169,17690,10319,7371
926,Norfolk,9262131,Reedham Primary School,40,16400,9567,6833
926,Norfolk,9262135,Rocklands Community Primary School,62,16620,9695,6925
926,Norfolk,9262138,Roydon Primary School,217,18170,10599,7571
926,Norfolk,9262141,Shelton with Hardwick Community School,21,16210,9456,6754
926,Norfolk,9262142,Sheringham Community Primary School,505,21050,12279,8771
926,Norfolk,9262146,Sprowston Junior School,225,18250,10646,7604
926,Norfolk,9262147,Sprowston Infant School,122,17220,10045,7175
926,Norfolk,9262148,Stalham Community Infant & Pre-School,55,16550,9654,6896
926,Norfolk,9262153,Swanton Abbott Community Primary School,85,16850,9829,7021
926,Norfolk,9262161,St Williams Primary School,354,19540,11398,8142
926,Norfolk,9262167,Trowse Primary School,92,16920,9870,7050
926,Norfolk,9262168,Tunstead Primary School,87,16870,9841,7029
926,Norfolk,9262180,Woodton Primary School,37,16370,9549,6821
926,Norfolk,9262184,Browick Road Primary School,154,17540,10232,7308
926,Norfolk,9262210,Sedgeford Primary School,31,16310,9514,6796
926,Norfolk,9262220,Terrington St John Primary School,44,16440,9590,6850
926,Norfolk,9262223,Tilney St Lawrence Community Primary School,53,16530,9643,6887
926,Norfolk,9262228,Walpole Highway Primary School,47,16470,9608,6862
926,Norfolk,9262229,Watlington Community Primary School,140,17400,10150,7250
926,Norfolk,9262233,West Walton Community Primary School,176,17760,10360,7400
926,Norfolk,9262240,Spixworth Infant School,85,16850,9829,7021
926,Norfolk,9262245,West Winch Primary School,174,17740,10348,7392
926,Norfolk,9262249,South Wootton Infant School,114,17140,9998,7142
926,Norfolk,9262251,Cecil Gowing Infant School,117,17170,10016,7154
926,Norfolk,9262252,Redcastle Family School,181,17810,10389,7421
926,Norfolk,9262253,Fairstead Community Primary and Nursery School,327,19270,11241,8029
926,Norfolk,9262259,Suffield Park Infant and Nursery School Cromer,105,17050,9946,7104
926,Norfolk,9262261,Brundall Primary School,225,18250,10646,7604
926,Norfolk,9262263,Stoke Holy Cross Primary School,179,17790,10378,7412
926,Norfolk,9262264,Bure Valley School,264,18640,10873,7767
926,Norfolk,9262265,Woodland View Junior School,157,17570,10249,7321
926,Norfolk,9262266,Falcon Junior School,400,20000,11667,8333
926,Norfolk,9262267,White Woman Lane Junior School,315,19150,11171,7979
926,Norfolk,9262272,Ormesby Village Junior School,161,17610,10273,7337
926,Norfolk,9262274,Hethersett Woodside Infant & Nursery School,148,17480,10197,7283
926,Norfolk,9262279,St Johns Community Primary School and Nursery,163,17630,10284,7346
926,Norfolk,9262281,Ashleigh Primary School and Nursery Wymondham,326,19260,11235,8025
926,Norfolk,9262287,Attleborough Primary School,350,19500,11375,8125
926,Norfolk,9262291,Avenue Junior School,475,20750,12104,8646
926,Norfolk,9262295,Magdalen Gates Primary School,185,17850,10413,7437
926,Norfolk,9262300,Colman Junior School,237,18370,10716,7654
926,Norfolk,9262301,Colman Infant School,120,17200,10033,7167
926,Norfolk,9262317,West Earlham Infant and Nursery School,119,17190,10028,7162
926,Norfolk,9262321,West Earlham Junior School,233,18330,10693,7637
926,Norfolk,9262344,St Georges Primary & Nursery School Great Yarmouth,145,17450,10179,7271
926,Norfolk,9262346,North Denes Primary School,371,19710,11498,8212
926,Norfolk,9262354,Northgate Primary School Great Yarmouth,301,19010,11089,7921
926,Norfolk,9262357,Hillside Primary School,183,17830,10401,7429
926,Norfolk,9262361,Kinsale Infant School,121,17210,10039,7171
926,Norfolk,9262362,Kinsale Junior School,236,18360,10710,7650
926,Norfolk,9262367,Dereham Toftwood Community Junior School,364,19640,11457,8183
926,Norfolk,9262368,John of Gaunt Infant and Nursery School,79,16790,9794,6996
926,Norfolk,9262371,Mulbarton Primary School,360,19600,11433,8167
926,Norfolk,9262377,Drake Primary School and Nursery,232,18320,10687,7633
926,Norfolk,9262382,Sparhawk Infant School & Nursery,118,17180,10022,7158
926,Norfolk,9262383,Mundesley Junior School,122,17220,10045,7175
926,Norfolk,9262406,Southtown Primary School,174,17740,10348,7392
926,Norfolk,9262409,St Marys Community Primary School Beetley,165,17650,10296,7354
926,Norfolk,9262411,Downham Market Hillcrest Primary School,405,20050,11696,8354
926,Norfolk,9262414,East Ruston Area Infant School,25,16250,9479,6771
926,Norfolk,9262415,Coltishall Primary School,174,17740,10348,7392
926,Norfolk,9262416,Chapel Break Infant School,118,17180,10022,7158
926,Norfolk,9262417,East Harling Primary School and Nursery,186,17860,10418,7442
926,Norfolk,9262420,Terrington St Clement Community School,274,18740,10932,7808
926,Norfolk,9263000,Acle St Edmund Voluntary Controlled Primary School,160,17600,10267,7333
926,Norfolk,9263001,Alburgh with Denton Church of England Primary School,90,16900,9858,7042
926,Norfolk,9263003,Ashill Voluntary Controlled Primary School,91,16910,9864,7046
926,Norfolk,9263004,Aylsham St Michaels Church of England Voluntary Aided Nursery and Infant School,58,16580,9672,6908
926,Norfolk,9263027,Ellingham Voluntary Controlled Primary School,85,16850,9829,7021
926,Norfolk,9263028,Erpingham Voluntary Controlled Church of England Primary School,50,16500,9625,6875
926,Norfolk,9263030,Edmund de Moundeford VC Primary School Feltwell,158,17580,10255,7325
926,Norfolk,9263032,Garboldisham Church Primary School,91,16910,9864,7046
926,Norfolk,9263037,Happisburgh Primary and Early Years School,71,16710,9748,6962
926,Norfolk,9263038,Hapton Church of England Voluntary Aided Primary School,30,16300,9508,6792
926,Norfolk,9263041,Hainford VC Primary School,62,16620,9695,6925
926,Norfolk,9263043,Hethersett VC Junior School,265,18650,10879,7771
926,Norfolk,9263045,Hickling CofE VC Infant School,15,15000,8750,6250
926,Norfolk,9263058,Newton Flotman Church of England Voluntary Controlled Primary School,116,17160,10010,7150
926,Norfolk,9263059,North Elmham Voluntary Controlled Primary School,75,16750,9771,6979
926,Norfolk,9263060,Old Catton CofE VC Junior School,222,18220,10628,7592
926,Norfolk,9263061,Pulham Church of England Primary School,111,17110,9981,7129
926,Norfolk,9263066,Salhouse Voluntary Controlled Primary School,96,16960,9893,7067
926,Norfolk,9263067,Saxlingham Nethergate CofE VC Primary School,48,16480,9613,6867
926,Norfolk,9263068,Scole Church of England Voluntary Controlled Primary School,79,16790,9794,6996
926,Norfolk,9263079,Sutton CofE VC Infant School,44,16440,9590,6850
926,Norfolk,9263081,Swaffham CofE VC Infant & Nursery School,108,17080,9963,7117
926,Norfolk,9263083,Tacolneston Church of England Primary,87,16870,9841,7029
926,Norfolk,9263084,Preston Church of England Voluntary Controlled Primary School,109,17090,9969,7121
926,Norfolk,9263085,Taverham VC CE Junior School,445,20450,11929,8521
926,Norfolk,9263088,Thurton Primary School,90,16900,9858,7042
926,Norfolk,9263094,Worstead Church of England Primary School,90,16900,9858,7042
926,Norfolk,9263096,Scarning Voluntary Controlled Primary School,308,19080,11130,7950
926,Norfolk,9263100,Denver Voluntary Controlled Primary School,94,16940,9882,7058
926,Norfolk,9263119,Fleggburgh Church of England Voluntary Controlled Primary School,49,16490,9619,6871
926,Norfolk,9263120,St Faiths CofE Primary School,84,16840,9823,7017
926,Norfolk,9263121,Swanton Morley VC Primary School,141,17410,10156,7254
926,Norfolk,9263126,Hindringham Church of England Voluntary Controlled Primary School,44,16440,9590,6850
926,Norfolk,9263127,Great Massingham CofE Primary School,36,16360,9543,6817
926,Norfolk,9263131,Neatishead Church of England Primary School,35,16350,9538,6812
926,Norfolk,9263133,Harpley CofE VC Primary School,45,16450,9596,6854
926,Norfolk,9263136,St Nicholas Priory CofE VA Primary School,382,19820,11562,8258
926,Norfolk,9263138,Wreningham VC Primary School,90,16900,9858,7042
926,Norfolk,9263139,Brooke Voluntary Controlled Church of England Primary School,104,17040,9940,7100
926,Norfolk,9263140,Homefield VC CofE Primary School,183,17830,10401,7429
926,Norfolk,9263144,Parkers Church of England Primary School,89,16890,9853,7037
926,Norfolk,9263145,Lyng Church of England Primary School,91,16910,9864,7046
926,Norfolk,9263146,Catfield Voluntary Controlled CofE Primary School,55,16550,9654,6896
926,Norfolk,9263152,Drayton CofE Junior School,339,19390,11311,8079
926,Norfolk,9263306,Blakeney Church of England Voluntary Aided Primary School,39,16390,9561,6829
926,Norfolk,9263309,Carleton Rode Church of England Voluntary Aided Primary School,49,16490,9619,6871
926,Norfolk,9263310,Caston Church of England Voluntary Aided Primary School,70,16700,9742,6958
926,Norfolk,9263313,Cringleford CE VA Primary School,330,19300,11258,8042
926,Norfolk,9263315,Earsham C.E.VA Primary School,88,16880,9847,7033
926,Norfolk,9263322,Forncett St Peter Church of England Voluntary Aided Primary School,90,16900,9858,7042
926,Norfolk,9263329,Little Plumstead Church of England Primary School,177,17770,10366,7404
926,Norfolk,9263339,Morley Church of England Primary School,121,17210,10039,7171
926,Norfolk,9263349,Overstrand the Belfry Church of England Voluntary Aided Primary School,115,17150,10004,7146
926,Norfolk,9263354,St Marys Endowed Voluntary Aided Church of England Primary School,61,16610,9689,6921
926,Norfolk,9263369,All Saints Church of England Voluntary Aided Primary School Winfarthing,68,16680,9730,6950
926,Norfolk,9263373,Yaxham Church of England Voluntary Aided Primary School,86,16860,9835,7025
926,Norfolk,9263377,Brancaster Church of England Voluntary Aided Primary School,28,16280,9497,6783
926,Norfolk,9263383,Ingoldisthorpe Church of England Voluntary Aided Primary School,95,16950,9888,7062
926,Norfolk,9263385,Ashwicken Church of England Voluntary Aided Primary School,111,17110,9981,7129
926,Norfolk,9263395,St Marthas Catholic Primary School Kings Lynn,262,18620,10862,7758
926,Norfolk,9263404,All Saints Church of England VA Primary School,168,17680,10313,7367
926,Norfolk,9263405,St Michaels VA Junior School,395,19950,11638,8312
926,Norfolk,9263406,Alpington and Bergh Apton Church of England Voluntary Aided Primary School,103,17030,9934,7096
926,Norfolk,9263408,St Andrews CofE VA Primary School Lopham,52,16520,9637,6883
926,Norfolk,9263409,Fairhaven Church of England Voluntary Aided Primary School,80,16800,9800,7000
926,Norfolk,9263418,Bluebell Primary School,188,17880,10430,7450
926,Norfolk,9263424,Mile Cross Primary School,346,19460,11352,8108
926,Norfolk,9263425,Catton Grove Primary School,520,21200,12367,8833
926,Norfolk,9263428,Recreation Road Infant School,240,18400,10733,7667
926,Norfolk,9263429,Lakenham Primary School,325,19250,11229,8021
926,Norfolk,9263431,Queens Hill Primary School,345,19450,11346,8104
926,Norfolk,9263433,Holly Meadows School,128,17280,10080,7200
926,Norfolk,9265200,Hunstanton Primary School,160,17600,10267,7333
926,Norfolk,9265202,Loddon Junior School,176,17760,10360,7400
926,Norfolk,9265205,Dereham Church of England Infant & Nursery School,105,17050,9946,7104
926,Norfolk,9265206,Robert Kett Primary School,489,20890,12186,8704
926,Norfolk,9265207,South Wootton Junior School,239,18390,10728,7662
926,Norfolk,9265209,Barnham Broom Church of England Voluntary Aided Primary School,108,17080,9963,7117
926,Norfolk,9265212,Rollesby Primary School,126,17260,10068,7192
926,Norfolk,9265213,Loddon Infant and Nursery School,95,16950,9888,7062
926,Norfolk,9265215,Wicklewood Primary School,182,17820,10395,7425
926,Norfolk,9265216,Toftwood Infant School,177,17770,10366,7404
926,Norfolk,9265217,Docking Primary School,79,16790,9794,6996
926,Norfolk,9267001,Sidestrand Hall School,38,16380,9555,6825
926,Norfolk,9267004,Fred Nicholson School,32,16320,9520,6800
926,Norfolk,9267006,Hall School,39,16390,9561,6829
926,Norfolk,9267007,Sheringham Woodfields School,50,16500,9625,6875
926,Norfolk,9267010,Chapel Green School,32,16320,9520,6800
926,Norfolk,9267013,The Clare School,39,16390,9561,6829
926,Norfolk,9267014,The Parkside School Norwich,48,16480,9613,6867
926,Norfolk,9267016,Harford Manor School Norwich,34,16340,9532,6808
926,Norfolk,9267020,John Grant School Caister-on-Sea,60,16600,9683,6917
928,Northamptonshire,9282001,All Saints CofE VA Primary School,340,19400,11317,8083
928,Northamptonshire,9282002,Blisworth Community Primary School,172,17720,10337,7383
928,Northamptonshire,9282006,Brington Primary School,48,16480,9613,6867
928,Northamptonshire,9282007,Broughton Primary School,177,17770,10366,7404
928,Northamptonshire,9282008,Bugbrooke Community Primary School,254,18540,10815,7725
928,Northamptonshire,9282010,Bridgewater Primary School,511,21110,12314,8796
928,Northamptonshire,9282012,The Bramptons Primary School,82,16820,9812,7008
928,Northamptonshire,9282014,Delapre Primary School,499,20990,12244,8746
928,Northamptonshire,9282015,Cogenhoe Primary School,178,17780,10372,7408
928,Northamptonshire,9282016,Millway Primary School,359,19590,11428,8162
928,Northamptonshire,9282019,Corby Old Village Primary School,177,17770,10366,7404
928,Northamptonshire,9282023,Cosgrove Village Primary School,61,16610,9689,6921
928,Northamptonshire,9282024,Crick Primary School,168,17680,10313,7367
928,Northamptonshire,9282025,Deanshanger Primary School,334,19340,11282,8058
928,Northamptonshire,9282026,Denton Primary School,107,17070,9958,7112
928,Northamptonshire,9282029,Mawsley Primary School,347,19470,11358,8112
928,Northamptonshire,9282041,Great Doddington Primary,113,17130,9993,7137
928,Northamptonshire,9282042,Greatworth Primary School,56,16560,9660,6900
928,Northamptonshire,9282046,Harlestone Primary School,50,16500,9625,6875
928,Northamptonshire,9282047,Helmdon Primary School,118,17180,10022,7158
928,Northamptonshire,9282048,Higham Ferrers Junior School,369,19690,11486,8204
928,Northamptonshire,9282067,Long Buckby Junior School,201,18010,10506,7504
928,Northamptonshire,9282068,Long Buckby Infant School,101,17010,9923,7087
928,Northamptonshire,9282069,Maidwell Primary School,52,16520,9637,6883
928,Northamptonshire,9282072,Nassington Primary School,75,16750,9771,6979
928,Northamptonshire,9282074,Overstone Primary School,91,16910,9864,7046
928,Northamptonshire,9282075,Pitsford Primary School,44,16440,9590,6850
928,Northamptonshire,9282076,John Hellins Primary School,146,17460,10185,7275
928,Northamptonshire,9282077,Raunds Park Infant School,82,16820,9812,7008
928,Northamptonshire,9282079,Roade Primary School,209,18090,10553,7537
928,Northamptonshire,9282082,Alfred Street Junior School Rushden,180,17800,10383,7417
928,Northamptonshire,9282086,South End Infant School,180,17800,10383,7417
928,Northamptonshire,9282087,Tennyson Road Infant School,68,16680,9730,6950
928,Northamptonshire,9282090,Walgrave Primary School,124,17240,10057,7183
928,Northamptonshire,9282091,Warmington School,76,16760,9777,6983
928,Northamptonshire,9282099,Park Junior School Wellingborough,241,18410,10739,7671
928,Northamptonshire,9282100,The Avenue Infant School,120,17200,10033,7167
928,Northamptonshire,9282107,Yardley Hastings Primary School,88,16880,9847,7033
928,Northamptonshire,9282108,Yelvertoft Primary School,81,16810,9806,7004
928,Northamptonshire,9282128,Ruskin Infant School,173,17730,10343,7387
928,Northamptonshire,9282130,South End Junior School,360,19600,11433,8167
928,Northamptonshire,9282137,The Grange School Daventry,359,19590,11428,8162
928,Northamptonshire,9282140,Higham Ferrers Nursery and Infant School,172,17720,10337,7383
928,Northamptonshire,9282144,Meadowside Primary School,343,19430,11334,8096
928,Northamptonshire,9282145,Earls Barton Primary School,397,19970,11649,8321
928,Northamptonshire,9282155,Whitefriars Primary School,360,19600,11433,8167
928,Northamptonshire,9282160,Earl Spencer Primary School,328,19280,11247,8033
928,Northamptonshire,9282174,Vernon Terrace Primary School,169,17690,10319,7371
928,Northamptonshire,9282176,Lyncrest Primary School,178,17780,10372,7408
928,Northamptonshire,9282180,Hayfield Cross CofE School,132,17320,10103,7217
928,Northamptonshire,9282181,Chiltern Primary School,313,19130,11159,7971
928,Northamptonshire,9282183,Whitehills Primary School,361,19610,11439,8171
928,Northamptonshire,9282184,Hopping Hill Primary School,360,19600,11433,8167
928,Northamptonshire,9282188,Boothville Primary School,533,21330,12443,8887
928,Northamptonshire,9282197,Barry Primary School,358,19580,11422,8158
928,Northamptonshire,9282203,Priors Hall - A Learning Community,104,17040,9940,7100
928,Northamptonshire,9282206,Denfield Park Primary School,351,19510,11381,8129
928,Northamptonshire,9282208,Kingsthorpe Grove Primary School,374,19740,11515,8225
928,Northamptonshire,9282210,Duston Eldean Primary School,390,19900,11608,8292
928,Northamptonshire,9282215,Redwell Primary School,479,20790,12128,8662
928,Northamptonshire,9282217,Barton Seagrave Primary School,447,20470,11941,8529
928,Northamptonshire,9282218,Hunsbury Park Primary School,289,18890,11019,7871
928,Northamptonshire,9282230,Henry Chichele Primary School,238,18380,10722,7658
928,Northamptonshire,9282231,Croyland Primary School,357,19570,11416,8154
928,Northamptonshire,9283002,Ashton Church of England Primary School,33,16330,9526,6804
928,Northamptonshire,9283008,Brackley Church of England Junior School,206,18060,10535,7525
928,Northamptonshire,9283012,Brixworth CofE VC Primary School,447,20470,11941,8529
928,Northamptonshire,9283019,Croughton All Saints CofE Primary School,94,16940,9882,7058
928,Northamptonshire,9283026,East Haddon Church of England Primary School,75,16750,9771,6979
928,Northamptonshire,9283028,Flore Church of England Primary School,96,16960,9893,7067
928,Northamptonshire,9283029,Gayton Church of England Primary School,50,16500,9625,6875
928,Northamptonshire,9283030,Geddington Church of England Primary School,165,17650,10296,7354
928,Northamptonshire,9283031,Glapthorn Church of England Primary School,68,16680,9730,6950
928,Northamptonshire,9283033,Grendon Church of England Primary School,94,16940,9882,7058
928,Northamptonshire,9283034,Harpole Primary School,181,17810,10389,7421
928,Northamptonshire,9283049,Pattishall Church of England Primary School,130,17300,10092,7208
928,Northamptonshire,9283050,Paulerspury Church of England Primary School,95,16950,9888,7062
928,Northamptonshire,9283051,Polebrook Church of England Primary School,59,16590,9678,6912
928,Northamptonshire,9283060,Stoke Bruerne Church of England Primary School,49,16490,9619,6871
928,Northamptonshire,9283062,Syresham St James CofE Primary School,66,16660,9718,6942
928,Northamptonshire,9283066,Titchmarsh Church of England Primary School,95,16950,9888,7062
928,Northamptonshire,9283070,All Saints CEVA Primary School and Nursery,177,17770,10366,7404
928,Northamptonshire,9283077,West Haddon Endowed Church of England Primary School,177,17770,10366,7404
928,Northamptonshire,9283080,Whittlebury Church of England Primary School,55,16550,9654,6896
928,Northamptonshire,9283084,Woodford Church of England Primary School,62,16620,9695,6925
928,Northamptonshire,9283088,Yardley Gobion Church of England Primary School,94,16940,9882,7058
928,Northamptonshire,9283200,Brigstock Lathams Church of England Primary School,93,16930,9876,7054
928,Northamptonshire,9283201,Kings Cliffe Endowed Primary School,146,17460,10185,7275
928,Northamptonshire,9283202,Clipston Endowed Voluntary Controlled Primary School,98,16980,9905,7075
928,Northamptonshire,9283203,Rothersthorpe Church of England Primary School,88,16880,9847,7033
928,Northamptonshire,9283205,Kingsthorpe Village Primary School,205,18050,10529,7521
928,Northamptonshire,9283304,St Andrews Ceva Primary School,305,19050,11113,7937
928,Northamptonshire,9283326,Little Houghton Church of England Primary,78,16780,9788,6992
928,Northamptonshire,9283331,Newbottle and Charlton Church of England Primary School,91,16910,9864,7046
928,Northamptonshire,9283339,Sywell Church of England Voluntary Aided Primary School,89,16890,9853,7037
928,Northamptonshire,9283340,Tiffield Church of England Voluntary Aided Primary School,37,16370,9549,6821
928,Northamptonshire,9283345,Wilby Church of England Primary School,76,16760,9777,6983
928,Northamptonshire,9283400,St Marys Catholic Primary School Aston-le-Walls,70,16700,9742,6958
928,Northamptonshire,9283406,St Patricks Catholic Primary School Corby,173,17730,10343,7387
928,Northamptonshire,9283500,The Bliss Charity School,170,17700,10325,7375
928,Northamptonshire,9283501,Our Ladys Catholic Primary School Wellingborough,354,19540,11398,8142
928,Northamptonshire,9283511,Hackleton CofE Primary School,183,17830,10401,7429
928,Northamptonshire,9283514,Little Stanion Primary School,179,17790,10378,7412
928,Northamptonshire,9285200,Moulton Primary School,386,19860,11585,8275
928,Northamptonshire,9285206,Millbrook Infant School,230,18300,10675,7625
928,Northamptonshire,9285207,Millbrook Junior School,473,20730,12093,8637
928,Northamptonshire,9285209,Thrapston Primary School,456,20560,11993,8567
928,Northamptonshire,9285210,Stanion Church of England (Aided) Primary School,91,16910,9864,7046
928,Northamptonshire,9287014,Fairfields School,99,16990,9911,7079
928,Northamptonshire,9287028,Kings Meadow School,35,16350,9538,6812
928,Northamptonshire,9287031,Rowan Gate Primary School -Two Sites,152,17520,10220,7300
929,Northumberland,9291100,Northumberland Pupil Referral Unit,2,2000,1167,833
929,Northumberland,9292002,Acomb First School,47,16470,9608,6862
929,Northumberland,9292009,Allendale Primary School,87,16870,9841,7029
929,Northumberland,9292015,Swansfield Park Primary School,262,18620,10862,7758
929,Northumberland,9292018,Amble Links First School,97,16970,9899,7071
929,Northumberland,9292019,Amble First School,94,16940,9882,7058
929,Northumberland,9292030,Bedlington West End First School,199,17990,10494,7496
929,Northumberland,9292032,Bedlington Station Primary School,167,17670,10308,7362
929,Northumberland,9292033,Stakeford Primary School,113,17130,9993,7137
929,Northumberland,9292035,Cambois Primary School,50,16500,9625,6875
929,Northumberland,9292037,Choppington Primary School,57,16570,9666,6904
929,Northumberland,9292041,Stead Lane Primary School,171,17710,10331,7379
929,Northumberland,9292043,Bellingham First School,41,16410,9573,6837
929,Northumberland,9292046,Spittal Community School,128,17280,10080,7200
929,Northumberland,9292047,Tweedmouth West First School,111,17110,9981,7129
929,Northumberland,9292050,Tweedmouth Prior Park First School,115,17150,10004,7146
929,Northumberland,9292053,Branton Community Primary School,17,16170,9433,6737
929,Northumberland,9292056,Broomley First School,106,17060,9952,7108
929,Northumberland,9292070,West Woodburn First School,21,16210,9456,6754
929,Northumberland,9292074,Cramlington Eastlea Primary School,140,17400,10150,7250
929,Northumberland,9292076,Beaconhill Community Primary School,158,17580,10255,7325
929,Northumberland,9292077,Cramlington Shanklea Primary School,291,18910,11031,7879
929,Northumberland,9292091,Holywell Village First School,116,17160,10010,7150
929,Northumberland,9292098,Broomhill First School,64,16640,9707,6933
929,Northumberland,9292101,Red Row First School,81,16810,9806,7004
929,Northumberland,9292103,Ellington Primary School,157,17570,10249,7321
929,Northumberland,9292105,Linton Primary School,19,16190,9444,6746
929,Northumberland,9292138,Stamfordham Primary School,65,16650,9713,6937
929,Northumberland,9292142,Hexham First School,87,16870,9841,7029
929,Northumberland,9292185,Morpeth First School,240,18400,10733,7667
929,Northumberland,9292207,Seahouses Primary School,79,16790,9794,6996
929,Northumberland,9292209,Otterburn First School,27,16270,9491,6779
929,Northumberland,9292212,Pegswood Primary School,160,17600,10267,7333
929,Northumberland,9292217,Prudhoe Castle First School,52,16520,9637,6883
929,Northumberland,9292219,Mickley First School,61,16610,9689,6921
929,Northumberland,9292224,Rothbury First School,89,16890,9853,7037
929,Northumberland,9292227,Beaufront First School,61,16610,9689,6921
929,Northumberland,9292228,Seaton Delaval First School,139,17390,10144,7246
929,Northumberland,9292229,New Hartley First School,95,16950,9888,7062
929,Northumberland,9292232,Seghill First School,70,16700,9742,6958
929,Northumberland,9292234,Greenhaugh First School,27,16270,9491,6779
929,Northumberland,9292236,Slaley First School,31,16310,9514,6796
929,Northumberland,9292239,Stannington First School,75,16750,9771,6979
929,Northumberland,9292246,Cambo First School,39,16390,9561,6829
929,Northumberland,9292254,Kielder Community First School,7,7000,4083,2917
929,Northumberland,9292268,Seaton Sluice First School,121,17210,10039,7171
929,Northumberland,9292270,Whittonstall First School,50,16500,9625,6875
929,Northumberland,9292277,Wooler First School,104,17040,9940,7100
929,Northumberland,9292278,Wylam First School,103,17030,9934,7096
929,Northumberland,9292281,Shilbottle Primary School,140,17400,10150,7250
929,Northumberland,9292291,Bothal Primary School,490,20900,12192,8708
929,Northumberland,9292293,Swarland Primary School,57,16570,9666,6904
929,Northumberland,9292299,The Sele First School,318,19180,11188,7992
929,Northumberland,9292323,Mowbray Primary School,241,18410,10739,7671
929,Northumberland,9292325,Belford First School,84,16840,9823,7017
929,Northumberland,9292360,Morpeth Stobhillgate First School,120,17200,10033,7167
929,Northumberland,9292370,Ringway Primary School,144,17440,10173,7267
929,Northumberland,9292372,Scremerston First School,60,16600,9683,6917
929,Northumberland,9292397,Horton Grange Primary School,329,19290,11253,8037
929,Northumberland,9292407,New Delaval Primary School,163,17630,10284,7346
929,Northumberland,9292415,Newsham Primary School,343,19430,11334,8096
929,Northumberland,9292525,Hipsburn Primary School,109,17090,9969,7121
929,Northumberland,9292527,Burnside Primary School,355,19550,11404,8146
929,Northumberland,9292529,Hareside Primary School,346,19460,11352,8108
929,Northumberland,9292530,Cramlington Northburn Primary School,257,18570,10833,7737
929,Northumberland,9292531,Central Primary School,552,21520,12553,8967
929,Northumberland,9293046,Berwick St Marys Church of England First School,87,16870,9841,7029
929,Northumberland,9293065,Chollerton Church of England Aided First School,30,16300,9508,6792
929,Northumberland,9293095,Felton Church of England Primary School,55,16550,9654,6896
929,Northumberland,9293135,Henshaw Church of England Voluntary Aided Primary School,40,16400,9567,6833
929,Northumberland,9293173,Longhoughton Church of England Primary School,101,17010,9923,7087
929,Northumberland,9293210,Ovingham Church of England First School,98,16980,9905,7075
929,Northumberland,9293264,Whittingham Church of England Primary School,66,16660,9718,6942
929,Northumberland,9293312,St Michaels Church of England Primary School,123,17230,10051,7179
929,Northumberland,9293333,Bedlington Whitley Memorial Church of England First School,211,18110,10564,7546
929,Northumberland,9293346,Holy Trinity Church of England First School,120,17200,10033,7167
929,Northumberland,9293347,Longhorsley St Helens Church of England Aided First School,66,16660,9718,6942
929,Northumberland,9293349,Greenhead Church of England Primary School,27,16270,9491,6779
929,Northumberland,9293355,Broomhaugh Church of England First School,58,16580,9672,6908
929,Northumberland,9293367,Corbridge Church of England Aided First School,106,17060,9952,7108
929,Northumberland,9293403,Ellingham Church of England Aided Primary School,64,16640,9707,6933
929,Northumberland,9293408,Embleton Vincent Edwards Church of England Primary School,17,16170,9433,6737
929,Northumberland,9293411,Hugh Joicey Church of England First School Ford,55,16550,9654,6896
929,Northumberland,9293443,Whitley Chapel Church of England First School,21,16210,9456,6754
929,Northumberland,9293447,Holy Island Church of England First School,1,1000,583,417
929,Northumberland,9293454,Humshaugh Church of England First School,30,16300,9508,6792
929,Northumberland,9293487,Morpeth All Saints Church of England Aided First School,152,17520,10220,7300
929,Northumberland,9293492,Newbrough Church of England Primary School,43,16430,9584,6846
929,Northumberland,9293542,Tritlington Church of England First School,25,16250,9479,6771
929,Northumberland,9293548,Wark Church of England First School,23,16230,9468,6762
929,Northumberland,9293550,Warkworth Church of England Primary School,53,16530,9643,6887
929,Northumberland,9293560,Whalton Church of England Aided Primary School,44,16440,9590,6850
929,Northumberland,9293711,St Wilfrids Roman Catholic Voluntary Aided Primary School,250,18500,10792,7708
929,Northumberland,9293713,St Pauls RC Voluntary Aided Primary School,157,17570,10249,7321
929,Northumberland,9293726,St Aidans Roman Catholic Voluntary Aided Primary School,223,18230,10634,7596
929,Northumberland,9293732,St Bedes Roman Catholic Voluntary Aided Primary School,179,17790,10378,7412
929,Northumberland,9293746,St Cuthberts Roman Catholic Voluntary Aided First School Berwick,50,16500,9625,6875
929,Northumberland,9293840,St Marys Roman Catholic Voluntary Aided First School,85,16850,9829,7021
929,Northumberland,9293888,St Roberts Roman Catholic Voluntary Aided First School,118,17180,10022,7158
929,Northumberland,9293918,Cragside CofE Controlled Primary School,303,19030,11101,7929
929,Northumberland,9293920,Norham St Ceolwulfs CofE Controlled First School,26,16260,9485,6775
929,Northumberland,9293922,Lowick Church of England Voluntary Controlled First School,19,16190,9444,6746
929,Northumberland,9293923,Grange View Church of England Voluntary Controlled First School,91,16910,9864,7046
929,Northumberland,9294079,Corbridge Middle School,172,17720,10337,7383
929,Northumberland,9294161,Seaton Sluice Middle School,156,17560,10243,7317
929,Northumberland,9294162,Whytrig Community Middle School,113,17130,9993,7137
929,Northumberland,9294198,Highfield Middle School,211,18110,10564,7546
929,Northumberland,9294199,Ovingham Middle School,193,17930,10459,7471
929,Northumberland,9294332,Tweedmouth Community Middle School,158,17580,10255,7325
929,Northumberland,9294361,Bellingham Middle School and Sports College,61,16610,9689,6921
929,Northumberland,9294370,Glendale Middle School,71,16710,9748,6962
929,Northumberland,9294404,Berwick Middle School,191,17910,10448,7462
929,Northumberland,9294439,James Calvert Spence College,217,18170,10599,7571
929,Northumberland,9294654,St Josephs Roman Catholic Voluntary Aided Middle School,164,17640,10290,7350
929,Northumberland,9297003,Cleaswell Hill School,68,16680,9730,6950
929,Northumberland,9297010,Barndale House School,17,16170,9433,6737
929,Northumberland,9297012,The Grove Special School,21,16210,9456,6754
929,Northumberland,9297021,The Dales School,85,16850,9829,7021
929,Northumberland,9297022,Collingwood School & Media Arts College,29,16290,9503,6787
931,Oxfordshire,9312055,Orchard Fields Community School,303,19030,11101,7929
931,Oxfordshire,9312057,Queensway School,305,19050,11113,7937
931,Oxfordshire,9312058,The Grange Community Primary School,266,18660,10885,7775
931,Oxfordshire,9312100,Charlbury Primary School,166,17660,10302,7358
931,Oxfordshire,9312103,Enstone Primary School,87,16870,9841,7029
931,Oxfordshire,9312104,Great Tew County Primary School,86,16860,9835,7025
931,Oxfordshire,9312106,Kingham Primary School,176,17760,10360,7400
931,Oxfordshire,9312200,Five Acres Primary School,299,18990,11078,7912
931,Oxfordshire,9312202,Brookside Primary School,255,18550,10821,7729
931,Oxfordshire,9312207,Longfields Primary and Nursery School,280,18800,10967,7833
931,Oxfordshire,9312208,Whitchurch Primary School,115,17150,10004,7146
931,Oxfordshire,9312210,Kings Meadow Primary School,338,19380,11305,8075
931,Oxfordshire,9312252,Carterton Primary School,217,18170,10599,7571
931,Oxfordshire,9312254,Gateway Primary School,224,18240,10640,7600
931,Oxfordshire,9312352,St Nicholas Primary School,354,19540,11398,8142
931,Oxfordshire,9312353,Stonesfield School,106,17060,9952,7108
931,Oxfordshire,9312354,William Fletcher Primary School,221,18210,10623,7587
931,Oxfordshire,9312357,North Kidlington Primary School,252,18520,10803,7717
931,Oxfordshire,9312450,RAF Benson Community Primary School,171,17710,10331,7379
931,Oxfordshire,9312456,Tetsworth Primary School,50,16500,9625,6875
931,Oxfordshire,9312459,Watlington Primary School,232,18320,10687,7633
931,Oxfordshire,9312463,Barley Hill Primary School,406,20060,11702,8358
931,Oxfordshire,9312465,Mill Lane Community Primary School,152,17520,10220,7300
931,Oxfordshire,9312504,Nettlebed Community School,106,17060,9952,7108
931,Oxfordshire,9312506,Sonning Common Primary School,338,19380,11305,8075
931,Oxfordshire,9312507,South Stoke Primary School,39,16390,9561,6829
931,Oxfordshire,9312510,Woodcote Primary School,165,17650,10296,7354
931,Oxfordshire,9312512,Valley Road School,173,17730,10343,7387
931,Oxfordshire,9312513,Badgemore Primary School,92,16920,9870,7050
931,Oxfordshire,9312525,East Oxford Primary School,252,18520,10803,7717
931,Oxfordshire,9312527,Windmill Primary School,543,21430,12501,8929
931,Oxfordshire,9312533,West Oxford Community Primary School,177,17770,10366,7404
931,Oxfordshire,9312555,Chilton County Primary School,182,17820,10395,7425
931,Oxfordshire,9312560,Drayton Community Primary School,139,17390,10144,7246
931,Oxfordshire,9312563,Harwell Primary School,156,17560,10243,7317
931,Oxfordshire,9312565,Dry Sandford Primary School,91,16910,9864,7046
931,Oxfordshire,9312569,Botley School,313,19130,11159,7971
931,Oxfordshire,9312583,Stockham Primary School,180,17800,10383,7417
931,Oxfordshire,9312587,Thomas Reade Primary School,179,17790,10378,7412
931,Oxfordshire,9312589,Wood Farm Primary School,329,19290,11253,8037
931,Oxfordshire,9312590,Edward Feild Primary School,256,18560,10827,7733
931,Oxfordshire,9312591,John Hampden Primary School,337,19370,11299,8071
931,Oxfordshire,9312594,Stephen Freeman Community Primary School,320,19200,11200,8000
931,Oxfordshire,9312595,Carswell Community Primary School,210,18100,10558,7542
931,Oxfordshire,9312601,West Witney Primary School,281,18810,10973,7837
931,Oxfordshire,9312602,Long Furlong Primary School,175,17750,10354,7396
931,Oxfordshire,9312605,Caldecott Primary School,290,18900,11025,7875
931,Oxfordshire,9312608,Langford Village Community School,356,19560,11410,8150
931,Oxfordshire,9312610,Bure Park Primary School,390,19900,11608,8292
931,Oxfordshire,9312613,St John the Evangelist CofE VA Primary School,343,19430,11334,8096
931,Oxfordshire,9313000,Cropredy Church of England Primary School,149,17490,10203,7287
931,Oxfordshire,9313043,Chadlington Church of England Primary School,89,16890,9853,7037
931,Oxfordshire,9313044,Hook Norton Church of England Primary School,181,17810,10389,7421
931,Oxfordshire,9313064,Bloxham Church of England Primary School,364,19640,11457,8183
931,Oxfordshire,9313065,Fritwell Church of England Primary School,105,17050,9946,7104
931,Oxfordshire,9313081,Charlton-on-Otmoor Church of England Primary School,70,16700,9742,6958
931,Oxfordshire,9313082,Chesterton Church of England Voluntary Aided Primary School,117,17170,10016,7154
931,Oxfordshire,9313083,Fringford Church of England Primary School,80,16800,9800,7000
931,Oxfordshire,9313085,Launton Church of England Primary School,118,17180,10022,7158
931,Oxfordshire,9313090,Finmere Church of England Primary School,27,16270,9491,6779
931,Oxfordshire,9313100,Clanfield CofE Primary School,123,17230,10051,7179
931,Oxfordshire,9313120,Aston and Cote Church of England Primary School,130,17300,10092,7208
931,Oxfordshire,9313122,Ducklington Primary School,164,17640,10290,7350
931,Oxfordshire,9313123,Hailey Church of England Primary School,82,16820,9812,7008
931,Oxfordshire,9313125,St Kenelms Church of England (VC) School,84,16840,9823,7017
931,Oxfordshire,9313141,Bletchingdon Parochial Church of England Primary School,65,16650,9713,6937
931,Oxfordshire,9313142,Combe Church of England Primary School,92,16920,9870,7050
931,Oxfordshire,9313145,Woodstock Church of England Primary School,269,18690,10903,7787
931,Oxfordshire,9313146,Bladon Church of England Primary School,83,16830,9818,7012
931,Oxfordshire,9313180,Aston Rowant Church of England Primary School,52,16520,9637,6883
931,Oxfordshire,9313181,Benson Church of England Primary School,148,17480,10197,7283
931,Oxfordshire,9313182,St Andrews Church of England Primary School,253,18530,10809,7721
931,Oxfordshire,9313183,Clifton Hampden Church of England Primary School,60,16600,9683,6917
931,Oxfordshire,9313184,Lewknor Church of England Primary School,66,16660,9718,6942
931,Oxfordshire,9313186,Dorchester St Birinus Church of England School,78,16780,9788,6992
931,Oxfordshire,9313187,Great Milton Church of England Primary School,133,17330,10109,7221
931,Oxfordshire,9313188,Marsh Baldon Church of England Controlled School,42,16420,9578,6842
931,Oxfordshire,9313190,Culham Parochial Church of England School,37,16370,9549,6821
931,Oxfordshire,9313200,Crowmarsh Gifford Church of England School,179,17790,10378,7412
931,Oxfordshire,9313205,Peppard Church of England Primary School,84,16840,9823,7017
931,Oxfordshire,9313206,Stoke Row Church of England School,78,16780,9788,6992
931,Oxfordshire,9313210,Church Cowley St James Church of England Primary School,350,19500,11375,8125
931,Oxfordshire,9313211,St Andrews Church of England Primary School,181,17810,10389,7421
931,Oxfordshire,9313213,New Hinksey Church of England Primary School,131,17310,10098,7212
931,Oxfordshire,9313216,St Michaels CofE Primary School,179,17790,10378,7412
931,Oxfordshire,9313223,Cumnor Church of England School (Voluntary Controlled),182,17820,10395,7425
931,Oxfordshire,9313231,The Ridgeway Church of England (C) Primary School,57,16570,9666,6904
931,Oxfordshire,9313233,Long Wittenham (Church of England) Primary School,81,16810,9806,7004
931,Oxfordshire,9313234,Longworth Primary School,69,16690,9736,6954
931,Oxfordshire,9313235,Marcham Church of England (Voluntary Controlled) Primary School,123,17230,10051,7179
931,Oxfordshire,9313238,Radley Church of England Primary School,85,16850,9829,7021
931,Oxfordshire,9313240,Stanford in the Vale Church of England Primary School,173,17730,10343,7387
931,Oxfordshire,9313241,St Michaels Church of England Primary School Steventon,156,17560,10243,7317
931,Oxfordshire,9313242,Sunningwell Church of England Primary School,79,16790,9794,6996
931,Oxfordshire,9313247,St Nicolas Church of England Primary School Abingdon,350,19500,11375,8125
931,Oxfordshire,9313248,Blewbury Endowed Church of England Primary School,141,17410,10156,7254
931,Oxfordshire,9313249,Hagbourne Church of England Primary School,176,17760,10360,7400
931,Oxfordshire,9313251,Uffington Church of England Primary School,83,16830,9818,7012
931,Oxfordshire,9313253,St Francis Church of England Primary School,224,18240,10640,7600
931,Oxfordshire,9313254,Trinity Church of England Primary School,243,18430,10751,7679
931,Oxfordshire,9313257,Wychwood Church of England Primary School,244,18440,10757,7683
931,Oxfordshire,9313258,St Swithuns CofE Primary School,315,19150,11171,7979
931,Oxfordshire,9313260,St Blaise CofE Primary School,58,16580,9672,6908
931,Oxfordshire,9313262,St Leonards Church of England Primary School,311,19110,11148,7962
931,Oxfordshire,9313350,St Johns Catholic Primary School Banbury,253,18530,10809,7721
931,Oxfordshire,9313408,Great Rollright Church of England (Aided) Primary School,90,16900,9858,7042
931,Oxfordshire,9313453,Christopher Rawlins Church of England Voluntary Aided Primary School,167,17670,10308,7362
931,Oxfordshire,9313500,Kirtlington Church of England Primary School,62,16620,9695,6925
931,Oxfordshire,9313505,St Edburgs Church of England (VA) School,213,18130,10576,7554
931,Oxfordshire,9313752,Ewelme CofE Primary School,71,16710,9748,6962
931,Oxfordshire,9313755,Little Milton Church of England Primary School,58,16580,9672,6908
931,Oxfordshire,9313760,St Laurence Church of England (A) School,84,16840,9823,7017
931,Oxfordshire,9313801,Checkendon Church of England (A) Primary School,84,16840,9823,7017
931,Oxfordshire,9313803,Goring Church of England Aided Primary School,205,18050,10529,7521
931,Oxfordshire,9313810,Shiplake Church of England School,158,17580,10255,7325
931,Oxfordshire,9313820,Sacred Heart Catholic Primary School Henley-on-Thames,145,17450,10179,7271
931,Oxfordshire,9313824,St Marys Catholic Primary School Bicester,235,18350,10704,7646
931,Oxfordshire,9313832,St Barnabas Church of England Aided Primary School,167,17670,10308,7362
931,Oxfordshire,9313833,St Ebbes Church of England Aided Primary School,306,19060,11118,7942
931,Oxfordshire,9313834,St Mary and John Church of England Primary School,342,19420,11328,8092
931,Oxfordshire,9313835,St Philip and James Church of England Aided Primary School Oxford,356,19560,11410,8150
931,Oxfordshire,9313838,St Josephs Catholic Primary School Oxford,356,19560,11410,8150
931,Oxfordshire,9313842,St Aloysius Catholic Primary School,174,17740,10348,7392
931,Oxfordshire,9313850,Appleton Church of England (A) Primary School,160,17600,10267,7333
931,Oxfordshire,9313851,Ashbury with Compton Beauchamp Church of England (A) Primary School,62,16620,9695,6925
931,Oxfordshire,9313853,Shellingford Church of England (Voluntary Aided) School,75,16750,9771,6979
931,Oxfordshire,9313854,Wootton St Peters Church of England Primary School,81,16810,9806,7004
931,Oxfordshire,9313855,St Amands Catholic Primary School,107,17070,9958,7112
931,Oxfordshire,9313856,St Edmunds Catholic Primary School,188,17880,10430,7450
931,Oxfordshire,9313858,St Marys Church of England (Aided) Primary School Chipping Norton,225,18250,10646,7604
931,Oxfordshire,9313859,All Saints Church of England (Aided) Primary School,352,19520,11387,8133
931,Oxfordshire,9313861,Dunmore Primary School,371,19710,11498,8212
931,Oxfordshire,9315200,Shenington Church of England Primary School,81,16810,9806,7004
931,Oxfordshire,9317002,Woodeaton Manor School,5,5000,2917,2083
931,Oxfordshire,9317010,Frank Wise School,42,16420,9578,6842
931,Oxfordshire,9317011,John Watson School,32,16320,9520,6800
931,Oxfordshire,9317012,Springfield School,55,16550,9654,6896
931,Oxfordshire,9317020,Mabel Prichard School,42,16420,9578,6842
931,Oxfordshire,9317029,Bardwell School,31,16310,9514,6796
931,Oxfordshire,9317030,Bishopswood School,31,16310,9514,6796
931,Oxfordshire,9317031,Northfield School,4,4000,2333,1667
933,Somerset,9331109,Tor School,1,1000,583,417
933,Somerset,9331112,South Somerset Partnership School,2,2000,1167,833
933,Somerset,9331114,Taunton Deane Partnership College,4,4000,2333,1667
933,Somerset,9331115,The Bridge School Sedgemoor,3,3000,1750,1250
933,Somerset,9332008,Castle Cary Community Primary School,191,17910,10448,7462
933,Somerset,9332019,Coxley Primary School,44,16440,9590,6850
933,Somerset,9332020,Ditcheat Primary School,73,16730,9759,6971
933,Somerset,9332022,Dunster First School,115,17150,10004,7146
933,Somerset,9332028,Vallis First School,217,18170,10599,7571
933,Somerset,9332038,Keinton Mandeville Primary School,119,17190,10028,7162
933,Somerset,9332041,Kingsbury Episcopi Primary School,136,17360,10127,7233
933,Somerset,9332045,Meare Village Primary School,99,16990,9911,7079
933,Somerset,9332046,Merriott First School,97,16970,9899,7071
933,Somerset,9332047,Milborne Port Primary School,148,17480,10197,7283
933,Somerset,9332057,Priddy Primary School,28,16280,9497,6783
933,Somerset,9332062,Shepton Mallet Community Infants School & Nursery,97,16970,9899,7071
933,Somerset,9332067,Stoke St Michael Primary School,42,16420,9578,6842
933,Somerset,9332068,Elmhurst Junior School,311,19110,11148,7962
933,Somerset,9332069,Hindhayes Infant School,170,17700,10325,7375
933,Somerset,9332081,Wincanton Primary School,323,19230,11218,8012
933,Somerset,9332082,Winsham Primary School,24,16240,9473,6767
933,Somerset,9332085,Wookey Primary School,82,16820,9812,7008
933,Somerset,9332106,Bowlish Infant School,79,16790,9794,6996
933,Somerset,9332110,Neroche Primary School,173,17730,10343,7387
933,Somerset,9332150,Ashcott Primary School,101,17010,9923,7087
933,Somerset,9332152,Eastover Community Primary School,361,19610,11439,8171
933,Somerset,9332157,Hamp Nursery and Infants School,166,17660,10302,7358
933,Somerset,9332165,Burnham-on-Sea Infant School,161,17610,10273,7337
933,Somerset,9332166,Catcott Primary School,135,17350,10121,7229
933,Somerset,9332169,East Huntspill School,60,16600,9683,6917
933,Somerset,9332175,North Newton Community Primary School,82,16820,9812,7008
933,Somerset,9332182,Somerset Bridge Primary School,391,19910,11614,8296
933,Somerset,9332184,West Huntspill Community Primary School,72,16720,9753,6967
933,Somerset,9332185,Westonzoyland Community Primary School,131,17310,10098,7212
933,Somerset,9332200,Bishops Hull Primary School,195,17950,10471,7479
933,Somerset,9332203,Churchstanton Primary School,53,16530,9643,6887
933,Somerset,9332205,Lydeard St Lawrence Community Primary School,83,16830,9818,7012
933,Somerset,9332206,Milverton Community Primary School,175,17750,10354,7396
933,Somerset,9332211,Sampford Arundel Community Primary School,39,16390,9561,6829
933,Somerset,9332212,Stawley Primary School,53,16530,9643,6887
933,Somerset,9332221,Wellsprings Primary School,271,18710,10914,7796
933,Somerset,9332224,Beech Grove Primary School,278,18780,10955,7825
933,Somerset,9332227,Wiveliscombe Primary School,202,18020,10512,7508
933,Somerset,9332228,Parkfield Primary School,359,19590,11428,8162
933,Somerset,9332229,Lyngford Park Primary School,242,18420,10745,7675
933,Somerset,9332255,Cheddar First School,228,18280,10663,7617
933,Somerset,9332300,Barwick and Stoford Community Primary School,61,16610,9689,6921
933,Somerset,9332302,East Coker Community Primary School,227,18270,10658,7612
933,Somerset,9332306,South Petherton Junior School,130,17300,10092,7208
933,Somerset,9332310,Milford Junior School,416,20160,11760,8400
933,Somerset,9332311,Milford Infants School,198,17980,10488,7492
933,Somerset,9332314,Reckleford Community School and Childrens Centre,48,16480,9613,6867
933,Somerset,9332320,Birchfield Community Primary School,347,19470,11358,8112
933,Somerset,9332327,Ilchester Community School,223,18230,10634,7596
933,Somerset,9332331,Kingsmoor Primary School,144,17440,10173,7267
933,Somerset,9332332,Holway Park Community Primary School,264,18640,10873,7767
933,Somerset,9332333,Stoberry Park School,267,18670,10891,7779
933,Somerset,9332334,Cotford St Luke Primary School,245,18450,10763,7687
933,Somerset,9332335,North Petherton Primary School,347,19470,11358,8112
933,Somerset,9333001,Baltonsborough Church of England Voluntary Controlled Primary School,68,16680,9730,6950
933,Somerset,9333003,St Mary and St Peters Church of England Primary School,28,16280,9497,6783
933,Somerset,9333008,Beckington Church of England First School,67,16670,9724,6946
933,Somerset,9333009,Berkley Church of England First School,75,16750,9771,6979
933,Somerset,9333017,Butleigh Church of England Primary School,72,16720,9753,6967
933,Somerset,9333020,Charlton Mackrell CofE Primary School,69,16690,9736,6954
933,Somerset,9333029,Bishop Henderson Church of England Primary School,138,17380,10138,7242
933,Somerset,9333035,Ashlands Church of England First School,107,17070,9958,7112
933,Somerset,9333037,St Bartholomews Church of England First School,145,17450,10179,7271
933,Somerset,9333039,Curry Mallet Church of England Primary School,59,16590,9678,6912
933,Somerset,9333040,Curry Rivel Church of England VC Primary School,127,17270,10074,7196
933,Somerset,9333041,St Aldhelms Church of England Primary School,170,17700,10325,7375
933,Somerset,9333042,All Saints CofE VC Infants School,31,16310,9514,6796
933,Somerset,9333047,Evercreech Church of England Primary School,125,17250,10063,7187
933,Somerset,9333048,Exford Church of England First School,20,16200,9450,6750
933,Somerset,9333057,Christ Church CofE First School,126,17260,10068,7192
933,Somerset,9333058,Trinity Church of England First School,236,18360,10710,7650
933,Somerset,9333060,St Johns Church of England Voluntary Controlled Infants School,92,16920,9870,7050
933,Somerset,9333061,St Nicholas CofE Primary School Henstridge,89,16890,9853,7037
933,Somerset,9333062,High Ham Church of England Primary School,140,17400,10150,7250
933,Somerset,9333064,Hinton St George Church of England School,38,16380,9555,6825
933,Somerset,9333066,Greenfylde Church of England First School,277,18770,10949,7821
933,Somerset,9333076,Lovington Church of England Primary School,29,16290,9503,6787
933,Somerset,9333078,Mells Church of England First School,47,16470,9608,6862
933,Somerset,9333080,Misterton Church of England First School,37,16370,9549,6821
933,Somerset,9333098,Shepton Beauchamp Church of England Primary School,31,16310,9514,6796
933,Somerset,9333101,Stogumber CofE Primary School,44,16440,9590,6850
933,Somerset,9333105,Abbas and Templecombe Church of England Primary School,107,17070,9958,7112
933,Somerset,9333110,Walton Church of England Voluntary Controlled Primary School,116,17160,10010,7150
933,Somerset,9333114,St Cuthberts CofE Junior School,200,18000,10500,7500
933,Somerset,9333119,St Lawrences CofE Primary School,54,16540,9648,6892
933,Somerset,9333121,West Pennard Church of England Primary School,177,17770,10366,7404
933,Somerset,9333129,Upton Noble CofE VC Primary School,143,17430,10168,7262
933,Somerset,9333132,St Pauls Church of England VC Junior School,301,19010,11089,7921
933,Somerset,9333151,St Marys Voluntary Controlled Church of England Primary School,366,19660,11468,8192
933,Somerset,9333152,St Andrews Church of England Voluntary Controlled Junior School,330,19300,11258,8042
933,Somerset,9333154,Cannington Church of England Primary School,161,17610,10273,7337
933,Somerset,9333158,Nether Stowey Church of England Primary School,147,17470,10191,7279
933,Somerset,9333159,Spaxton CofE Primary School,72,16720,9753,6967
933,Somerset,9333178,Creech St Michael Church of England Primary School,229,18290,10669,7621
933,Somerset,9333180,Kingston St Mary Church of England Primary School,96,16960,9893,7067
933,Somerset,9333181,Langford Budville Church of England Primary School,36,16360,9543,6817
933,Somerset,9333186,Rockwell Green Church of England Primary School,169,17690,10319,7371
933,Somerset,9333190,Stoke St Gregory Church of England Primary School,83,16830,9818,7012
933,Somerset,9333226,Berrow Church of England Primary School,180,17800,10383,7417
933,Somerset,9333238,Shipham Church of England First School,44,16440,9590,6850
933,Somerset,9333276,Ash Church of England Primary School,143,17430,10168,7262
933,Somerset,9333277,Chilthorne Domer Church School,134,17340,10115,7225
933,Somerset,9333278,Haselbury Plucknett Church of England First School,37,16370,9549,6821
933,Somerset,9333281,Norton-sub-Hamdon Church of England Primary School,102,17020,9928,7092
933,Somerset,9333284,West Chinnock Church of England Primary School,47,16470,9608,6862
933,Somerset,9333285,West Coker CofE VC Primary School,65,16650,9713,6937
933,Somerset,9333287,Rode Methodist VC First School,83,16830,9818,7012
933,Somerset,9333290,Oake Bradford and Nynehead VC Primary,88,16880,9847,7033
933,Somerset,9333305,Chewton Mendip Church of England VA Primary School,124,17240,10057,7183
933,Somerset,9333307,Combe St Nicholas Church of England VA Primary School,107,17070,9958,7112
933,Somerset,9333311,Croscombe Church of England Primary School,64,16640,9707,6933
933,Somerset,9333313,Crowcombe CofE VA Primary School,47,16470,9608,6862
933,Somerset,9333314,Cutcombe Church of England First School,24,16240,9473,6767
933,Somerset,9333317,Draycott and Rodney Stoke Church of England First School,58,16580,9672,6908
933,Somerset,9333322,St Benedicts Church of England Voluntary Aided Junior School,218,18180,10605,7575
933,Somerset,9333329,Kilmersdon Church of England Primary School,155,17550,10238,7312
933,Somerset,9333331,Long Sutton CofE Primary School,81,16810,9806,7004
933,Somerset,9333342,Norton St Philip Church of England First School,33,16330,9526,6804
933,Somerset,9333344,St Dubricius Church of England VA School,61,16610,9689,6921
933,Somerset,9333356,Stogursey Church of England Primary School,63,16630,9701,6929
933,Somerset,9333358,St Benedicts Catholic Primary School,161,17610,10273,7337
933,Somerset,9333359,Timberscombe Church of England First School,34,16340,9532,6808
933,Somerset,9333361,St Joseph and St Teresa Catholic Primary School,139,17390,10144,7246
933,Somerset,9333369,St Johns Church of England Voluntary Aided First School Frome,217,18170,10599,7571
933,Somerset,9333371,St Louis Catholic Primary School Frome,183,17830,10401,7429
933,Somerset,9333401,St Josephs Catholic Primary School Bridgwater,207,18070,10541,7529
933,Somerset,9333402,St Josephs Catholic Primary and Nursery School,198,17980,10488,7492
933,Somerset,9333436,Thurlbear Church of England Primary School,183,17830,10401,7429
933,Somerset,9333437,Trull Church of England VA Primary School,221,18210,10623,7587
933,Somerset,9333438,St Georges Catholic School,193,17930,10459,7471
933,Somerset,9333439,Bishop Henderson Church of England Primary School Taunton,368,19680,11480,8200
933,Somerset,9333484,South Petherton Church of England Infants School,74,16740,9765,6975
933,Somerset,9333485,St Margarets School Tintinhull,92,16920,9870,7050
933,Somerset,9333486,Martock Church of England VA Primary School,182,17820,10395,7425
933,Somerset,9333487,St Gildas Catholic Primary School,185,17850,10413,7437
933,Somerset,9333488,Our Lady of Mount Carmel Catholic Primary School Wincanton,117,17170,10016,7154
933,Somerset,9333490,Knights Templar Church of England/Methodist Community School,143,17430,10168,7262
933,Somerset,9333494,Oaklands Primary School,367,19670,11474,8196
933,Somerset,9334277,Dulverton Junior School,95,16950,9888,7062
933,Somerset,9334288,Swanmead Community School,169,17690,10319,7371
933,Somerset,9334410,Fairlands Middle School,230,18300,10675,7625
933,Somerset,9335200,Bruton Primary School,204,18040,10523,7517
933,Somerset,9335201,St Johns Church of England Primary School,156,17560,10243,7317
933,Somerset,9335202,Charlton Horethorne Church of England Primary School,53,16530,9643,6887
933,Somerset,9337006,Sky College,1,1000,583,417
933,Somerset,9337007,Fairmead School,22,16220,9462,6758
933,Somerset,9337013,Penrose School,39,16390,9561,6829
933,Somerset,9337016,Fiveways Special School,34,16340,9532,6808
933,Somerset,9337019,Critchill School,15,15000,8750,6250
935,Suffolk,9351105,First Base,2,2000,1167,833
935,Suffolk,9351109,Harbour,3,3000,1750,1250
935,Suffolk,9351113,The Attic,3,3000,1750,1250
935,Suffolk,9352002,Bildeston Primary School,84,16840,9823,7017
935,Suffolk,9352007,Elmswell Community Primary School,229,18290,10669,7621
935,Suffolk,9352009,Pot Kiln Primary School,245,18450,10763,7687
935,Suffolk,9352011,New Cangle Community Primary School,196,17960,10477,7483
935,Suffolk,9352012,Hundon Community Primary School,79,16790,9794,6996
935,Suffolk,9352013,Lakenheath Community Primary School,246,18460,10768,7692
935,Suffolk,9352015,Lavenham Community Primary School,89,16890,9853,7037
935,Suffolk,9352016,Trinity Church of England Voluntary Aided Primary School,67,16670,9724,6946
935,Suffolk,9352020,Nayland Primary School,177,17770,10366,7404
935,Suffolk,9352021,Exning Primary School,173,17730,10343,7387
935,Suffolk,9352026,Stanton Community Primary School,175,17750,10354,7396
935,Suffolk,9352032,Guildhall Feoffment Community Primary School,314,19140,11165,7975
935,Suffolk,9352034,Westgate Community Primary School,267,18670,10891,7779
935,Suffolk,9352035,Sextons Manor Community Primary School,145,17450,10179,7271
935,Suffolk,9352042,Hadleigh Community Primary School,459,20590,12011,8579
935,Suffolk,9352045,Hardwick Primary School,244,18440,10757,7683
935,Suffolk,9352055,Paddocks Primary School,171,17710,10331,7379
935,Suffolk,9352066,Bucklesham Primary School,85,16850,9829,7021
935,Suffolk,9352068,Carlton Colville Primary School,360,19600,11433,8167
935,Suffolk,9352070,Combs Ford Primary School,339,19390,11311,8079
935,Suffolk,9352071,Copdock Primary School,68,16680,9730,6950
935,Suffolk,9352072,Earl Soham Community Primary School,56,16560,9660,6900
935,Suffolk,9352074,Causton Junior School,204,18040,10523,7517
935,Suffolk,9352075,Maidstone Infant School,83,16830,9818,7012
935,Suffolk,9352076,Fairfield Infant School,180,17800,10383,7417
935,Suffolk,9352079,Grundisburgh Primary School,153,17530,10226,7304
935,Suffolk,9352084,Holbrook Primary School,146,17460,10185,7275
935,Suffolk,9352085,Hollesley Primary School,70,16700,9742,6958
935,Suffolk,9352089,Heath Primary School Kesgrave,501,21010,12256,8754
935,Suffolk,9352092,Bealings School,88,16880,9847,7033
935,Suffolk,9352095,Melton Primary School,138,17380,10138,7242
935,Suffolk,9352101,Otley Primary School,54,16540,9648,6892
935,Suffolk,9352105,Ringshall School,96,16960,9893,7067
935,Suffolk,9352108,Snape Community Primary School,42,16420,9578,6842
935,Suffolk,9352110,Somersham Primary School,85,16850,9829,7021
935,Suffolk,9352114,Freeman Community Primary School,171,17710,10331,7379
935,Suffolk,9352117,Trimley St Mary Primary School,334,19340,11282,8058
935,Suffolk,9352118,Trimley St Martin Primary School,181,17810,10389,7421
935,Suffolk,9352121,Waldringfield Primary School,89,16890,9853,7037
935,Suffolk,9352124,Witnesham Primary School,89,16890,9853,7037
935,Suffolk,9352125,Woodbridge Primary School,179,17790,10378,7412
935,Suffolk,9352129,Chilton Community Primary School,139,17390,10144,7246
935,Suffolk,9352131,Colneis Junior School,356,19560,11410,8150
935,Suffolk,9352132,Gorseland Primary School,380,19800,11550,8250
935,Suffolk,9352134,Kingsfleet Primary School,176,17760,10360,7400
935,Suffolk,9352135,Kyson Primary School,345,19450,11346,8104
935,Suffolk,9352138,Abbots Hall Community Primary School,352,19520,11387,8133
935,Suffolk,9352157,Ranelagh Primary School,220,18200,10617,7583
935,Suffolk,9352162,Ravenswood Community Primary School,338,19380,11305,8075
935,Suffolk,9352166,Clifford Road Primary School,347,19470,11358,8112
935,Suffolk,9352176,Whitehouse Community Primary School,461,20610,12023,8587
935,Suffolk,9352184,Dale Hall Community Primary School,351,19510,11381,8129
935,Suffolk,9352916,Bosmere Community Primary School,273,18730,10926,7804
935,Suffolk,9352918,Stratford St Mary Primary School,79,16790,9794,6996
935,Suffolk,9352919,Oulton Broad Primary School,213,18130,10576,7554
935,Suffolk,9352921,Ickworth Park Primary School,185,17850,10413,7437
935,Suffolk,9352922,Rushmere Hall Primary School,520,21200,12367,8833
935,Suffolk,9352923,Wood Ley Community Primary School,259,18590,10844,7746
935,Suffolk,9352924,Birchwood Primary School,182,17820,10395,7425
935,Suffolk,9352925,Sebert Wood Community Primary School,355,19550,11404,8146
935,Suffolk,9352928,Sandlings Primary School,83,16830,9818,7012
935,Suffolk,9352929,Cedarwood Primary School,361,19610,11439,8171
935,Suffolk,9352931,Beaumont Community Primary School,60,16600,9683,6917
935,Suffolk,9353000,Acton Church of England Voluntary Controlled Primary School,149,17490,10203,7287
935,Suffolk,9353003,Barnham Church of England Voluntary Controlled Primary School,139,17390,10144,7246
935,Suffolk,9353004,Barningham Church of England Voluntary Controlled Primary School,67,16670,9724,6946
935,Suffolk,9353005,Barrow Church of England Voluntary Controlled Primary School,118,17180,10022,7158
935,Suffolk,9353006,Boxford Church of England Voluntary Controlled Primary School,180,17800,10383,7417
935,Suffolk,9353009,Bures Church of England Voluntary Controlled Primary School,169,17690,10319,7371
935,Suffolk,9353010,Cavendish Church of England Primary School,68,16680,9730,6950
935,Suffolk,9353013,Cockfield Church of England Voluntary Controlled Primary School,61,16610,9689,6921
935,Suffolk,9353020,Elmsett Church of England VC Primary School,64,16640,9707,6933
935,Suffolk,9353026,Thurlow Voluntary Controlled Primary School,89,16890,9853,7037
935,Suffolk,9353027,Great Waldingfield Church of England Voluntary Controlled Primary School,146,17460,10185,7275
935,Suffolk,9353028,Great Whelnetham Church of England Voluntary Controlled Primary School,128,17280,10080,7200
935,Suffolk,9353036,Honington Church of England Voluntary Controlled Primary School,138,17380,10138,7242
935,Suffolk,9353037,Hopton Church of England Voluntary Controlled Primary School,82,16820,9812,7008
935,Suffolk,9353042,Kersey Church of England Voluntary Controlled Primary School,62,16620,9695,6925
935,Suffolk,9353043,All Saints Church of England Voluntary Controlled Primary School Lawshall,154,17540,10232,7308
935,Suffolk,9353048,Moulton Church of England Voluntary Controlled Primary School,147,17470,10191,7279
935,Suffolk,9353049,Norton CEVC Primary School,171,17710,10331,7379
935,Suffolk,9353056,Risby Church of England Voluntary Controlled Primary School,150,17500,10208,7292
935,Suffolk,9353064,Walsham-le-Willows Church of England Voluntary Controlled Primary School,118,17180,10022,7158
935,Suffolk,9353066,Whatfield Church of England Voluntary Controlled Primary School,33,16330,9526,6804
935,Suffolk,9353074,Bawdsey Church of England Voluntary Controlled Primary School,40,16400,9567,6833
935,Suffolk,9353075,Bedfield Church of England Voluntary Controlled Primary School,42,16420,9578,6842
935,Suffolk,9353076,Benhall St Marys Church of England Voluntary Controlled Primary School,75,16750,9771,6979
935,Suffolk,9353078,Bramford Church of England Voluntary Controlled Primary School,183,17830,10401,7429
935,Suffolk,9353083,Corton Church of England Voluntary Aided Primary School,96,16960,9893,7067
935,Suffolk,9353085,East Bergholt Church of England Voluntary Controlled Primary School,162,17620,10278,7342
935,Suffolk,9353090,Great Finborough Church of England Voluntary Controlled Primary School,121,17210,10039,7171
935,Suffolk,9353093,Kelsale Church of England Voluntary Controlled Primary School,129,17290,10086,7204
935,Suffolk,9353104,Tattingstone Church of England Voluntary Controlled Primary School,76,16760,9777,6983
935,Suffolk,9353105,Thorndon Church of England Voluntary Controlled Primary School,72,16720,9753,6967
935,Suffolk,9353108,Wetheringsett Church of England Voluntary Controlled Primary School,50,16500,9625,6875
935,Suffolk,9353109,Wilby Church of England Voluntary Controlled Primary School,51,16510,9631,6879
935,Suffolk,9353111,Worlingham Church of England Voluntary Controlled Primary School,285,18850,10996,7854
935,Suffolk,9353112,Capel St Mary Church of England Voluntary Controlled Primary School,239,18390,10728,7662
935,Suffolk,9353113,Worlingworth Church of England Voluntary Controlled Primary School,48,16480,9613,6867
935,Suffolk,9353114,Blundeston Church of England Voluntary Controlled Primary School,176,17760,10360,7400
935,Suffolk,9353117,Bentley Church of England Voluntary Controlled Primary School,52,16520,9637,6883
935,Suffolk,9353124,St Gregory Church of England Voluntary Controlled Primary School,192,17920,10453,7467
935,Suffolk,9353125,St Botolphs Church of England Voluntary Controlled Primary School,160,17600,10267,7333
935,Suffolk,9353308,St Edmundsbury Church of England Voluntary Aided Primary School,229,18290,10669,7621
935,Suffolk,9353310,St Josephs Roman Catholic Primary School,129,17290,10086,7204
935,Suffolk,9353311,St Edmunds Catholic Primary School,330,19300,11258,8042
935,Suffolk,9353322,Creeting St Mary Church of England Voluntary Aided Primary School,80,16800,9800,7000
935,Suffolk,9353327,Stonham Aspal Church of England Voluntary Aided Primary School,156,17560,10243,7317
935,Suffolk,9353329,Sir Robert Hitcham Church of England Voluntary Aided School,160,17600,10267,7333
935,Suffolk,9353330,Sir Robert Hitchams Church of England Voluntary Aided Primary School,272,18720,10920,7800
935,Suffolk,9353332,Orford Church of England Voluntary Aided Primary School,53,16530,9643,6887
935,Suffolk,9353337,St Johns Church of England Voluntary Aided Primary School Ipswich,181,17810,10389,7421
935,Suffolk,9353338,St Margarets Church of England Voluntary Aided Primary School Ipswich,298,18980,11072,7908
935,Suffolk,9353342,St Marks Catholic Primary School Ipswich,186,17860,10418,7442
935,Suffolk,9357002,Hillside Special School,40,16400,9567,6833
935,Suffolk,9357008,The Bridge School,74,16740,9765,6975
936,Surrey,9361100,Fordway Centre,4,4000,2333,1667
936,Surrey,9361107,Wey Valley College,2,2000,1167,833
936,Surrey,9361120,The Surrey Teaching Centre,1,1000,583,417
936,Surrey,9361127,Reigate Valley College,2,2000,1167,833
936,Surrey,9362001,Pewley Down Infant School,120,17200,10033,7167
936,Surrey,9362008,Kingswood Primary School,176,17760,10360,7400
936,Surrey,9362012,Walton-on-the-Hill Primary School,180,17800,10383,7417
936,Surrey,9362013,Woodmansterne Primary School,319,19190,11194,7996
936,Surrey,9362030,Trinity Oaks Church of England Primary School,90,16900,9858,7042
936,Surrey,9362056,Charlwood Village Primary School,57,16570,9666,6904
936,Surrey,9362072,North Downs Primary School,365,19650,11463,8187
936,Surrey,9362078,Trumps Green Infant School,112,17120,9987,7133
936,Surrey,9362079,Manorcroft Primary School,346,19460,11352,8108
936,Surrey,9362083,Ewell Grove Primary and Nursery School,187,17870,10424,7446
936,Surrey,9362085,Epsom Primary and Nursery School,442,20420,11912,8508
936,Surrey,9362091,The Mead Infant School,182,17820,10395,7425
936,Surrey,9362099,The Orchard Infant School,166,17660,10302,7358
936,Surrey,9362100,Hinchley Wood Primary School,533,21330,12443,8887
936,Surrey,9362101,Long Ditton Infant and Nursery School,116,17160,10010,7150
936,Surrey,9362102,Thames Ditton Junior School,405,20050,11696,8354
936,Surrey,9362103,Thames Ditton Infant School,207,18070,10541,7529
936,Surrey,9362124,Felbridge Primary School,184,17840,10407,7433
936,Surrey,9362136,Beacon Hill Community Primary School,225,18250,10646,7604
936,Surrey,9362137,Shottermill Junior School,278,18780,10955,7825
936,Surrey,9362138,Shottermill Infant School,149,17490,10203,7287
936,Surrey,9362140,Horley Infant School,200,18000,10500,7500
936,Surrey,9362149,Barnett Wood Infant School,103,17030,9934,7096
936,Surrey,9362150,Fetcham Village Infant School,116,17160,10010,7150
936,Surrey,9362156,Dormansland Primary School,179,17790,10378,7412
936,Surrey,9362209,Earlswood Infant and Nursery School,237,18370,10716,7654
936,Surrey,9362229,Shalford Infant School,49,16490,9619,6871
936,Surrey,9362257,Oatlands School,180,17800,10383,7417
936,Surrey,9362268,Bagshot Infant School,109,17090,9969,7121
936,Surrey,9362271,Byfleet Primary School,219,18190,10611,7579
936,Surrey,9362274,Knaphill School,342,19420,11328,8092
936,Surrey,9362275,Maybury Primary School,176,17760,10360,7400
936,Surrey,9362279,West Byfleet Infant School,178,17780,10372,7408
936,Surrey,9362286,Wood Street Infant School,53,16530,9643,6887
936,Surrey,9362288,Shawley Community Primary School,256,18560,10827,7733
936,Surrey,9362297,The Greville Primary School,566,21660,12635,9025
936,Surrey,9362302,Hurst Green Infant School,52,16520,9637,6883
936,Surrey,9362311,Meath Green Junior School,353,19530,11393,8137
936,Surrey,9362315,Milford School,110,17100,9975,7125
936,Surrey,9362329,Heather Ridge Infant School,120,17200,10033,7167
936,Surrey,9362335,Oakfield Junior School,248,18480,10780,7700
936,Surrey,9362343,Banstead Community Junior School,352,19520,11387,8133
936,Surrey,9362349,Worplesdon Primary School,395,19950,11638,8312
936,Surrey,9362350,West Ashtead Primary School,317,19170,11183,7987
936,Surrey,9362359,Prior Heath Infant School,120,17200,10033,7167
936,Surrey,9362361,Shawfield Primary School,170,17700,10325,7375
936,Surrey,9362375,Darley Dene Primary School,180,17800,10383,7417
936,Surrey,9362384,The Grange Community Infant School,180,17800,10383,7417
936,Surrey,9362385,Hurst Park Primary School,324,19240,11223,8017
936,Surrey,9362394,Ongar Place Primary School,178,17780,10372,7408
936,Surrey,9362400,Godalming Junior School,234,18340,10698,7642
936,Surrey,9362406,The Knaphill Lower School,176,17760,10360,7400
936,Surrey,9362408,Folly Hill Infant School,58,16580,9672,6908
936,Surrey,9362409,Moss Lane School,116,17160,10010,7150
936,Surrey,9362415,Badshot Lea Village Infant School,94,16940,9882,7058
936,Surrey,9362417,Polesden Lacey Infant School,59,16590,9678,6912
936,Surrey,9362427,Burhill Primary School,511,21110,12314,8796
936,Surrey,9362428,Grovelands Primary School,370,19700,11492,8208
936,Surrey,9362430,Bell Farm Primary School,396,19960,11643,8317
936,Surrey,9362435,Audley Primary School,185,17850,10413,7437
936,Surrey,9362445,Meadowcroft Community Infant School,52,16520,9637,6883
936,Surrey,9362446,Stamford Green Primary School,451,20510,11964,8546
936,Surrey,9362448,Onslow Infant School,174,17740,10348,7392
936,Surrey,9362453,Earlswood Junior School,461,20610,12023,8587
936,Surrey,9362454,Holland Junior School,212,18120,10570,7550
936,Surrey,9362457,Reigate Priory Community Junior School,626,22260,12985,9275
936,Surrey,9362467,Thorpe Lea Primary School,171,17710,10331,7379
936,Surrey,9362468,St Anns Heath Junior School,292,18920,11037,7883
936,Surrey,9362472,Manby Lodge Infant School,177,17770,10366,7404
936,Surrey,9362478,William Cobbett Primary School,478,20780,12122,8658
936,Surrey,9362484,Tillingbourne Junior School,356,19560,11410,8150
936,Surrey,9362491,West Byfleet Junior School,265,18650,10879,7771
936,Surrey,9362493,Meath Green Infant School,177,17770,10366,7404
936,Surrey,9362873,Clarendon Primary School,210,18100,10558,7542
936,Surrey,9362907,Chennestone Primary School,333,19330,11276,8054
936,Surrey,9362912,Beauclerc Infant and Nursery School,76,16760,9777,6983
936,Surrey,9362917,Busbridge Infant School,119,17190,10028,7162
936,Surrey,9362921,Englefield Green Infant School and Nurseries,112,17120,9987,7133
936,Surrey,9362925,Langshott Primary School,350,19500,11375,8125
936,Surrey,9362928,Hythe Primary School,276,18760,10943,7817
936,Surrey,9362929,Claygate Primary School,374,19740,11515,8225
936,Surrey,9362933,Kingfield Primary School,179,17790,10378,7412
936,Surrey,9362937,Ashford Park Primary School,406,20060,11702,8358
936,Surrey,9362940,Ash Grange Primary School,183,17830,10401,7429
936,Surrey,9362946,Stepgates Community School,172,17720,10337,7383
936,Surrey,9362948,Lingfield Primary School,351,19510,11381,8129
936,Surrey,9362949,Chandlers Field Primary School,281,18810,10973,7837
936,Surrey,9362950,Town Farm Primary School & Nursery,434,20340,11865,8475
936,Surrey,9362951,Epsom Downs Primary School and Childrens Centre,349,19490,11369,8121
936,Surrey,9362954,Furzefield Primary School,413,20130,11743,8387
936,Surrey,9362957,Hale School,292,18920,11037,7883
936,Surrey,9362959,The Dawnay School,232,18320,10687,7633
936,Surrey,9362960,Cranmere Primary School,353,19530,11393,8137
936,Surrey,9362964,Southfield Park Primary School,360,19600,11433,8167
936,Surrey,9363002,Walsh Memorial CofE Controlled Infant School,117,17170,10016,7154
936,Surrey,9363015,Valley End CofE Infant School,118,17180,10022,7158
936,Surrey,9363016,St Martins CofE Controlled Primary School Dorking,330,19300,11258,8042
936,Surrey,9363019,St Martins CofE (Aided) Junior School,355,19550,11404,8146
936,Surrey,9363022,The Royal Kent CofE Primary School,181,17810,10389,7421
936,Surrey,9363026,Farncombe Church of England Infant School,99,16990,9911,7079
936,Surrey,9363033,St Pauls CofE Infant School and Surestart Childrens Centre Tongham,57,16570,9666,6904
936,Surrey,9363035,St Marys CofE Voluntary Controlled Infant School,55,16550,9654,6896
936,Surrey,9363042,St Marys CofE Controlled Primary School Byfleet,337,19370,11299,8071
936,Surrey,9363044,Powell Corderoy Primary School,167,17670,10308,7362
936,Surrey,9363049,Frimley CofE Junior School,327,19270,11241,8029
936,Surrey,9363050,Bisley CofE Primary School,231,18310,10681,7629
936,Surrey,9363054,Walsh CofE Junior School,262,18620,10862,7758
936,Surrey,9363055,St Martins CofE Aided Infant School Epsom,180,17800,10383,7417
936,Surrey,9363060,Witley CofE Controlled Infant School,60,16600,9683,6917
936,Surrey,9363061,Merrow CofE Controlled Infant School,143,17430,10168,7262
936,Surrey,9363064,St James CofE Primary School,388,19880,11597,8283
936,Surrey,9363065,Riverview CofE Primary and Nursery School VA,168,17680,10313,7367
936,Surrey,9363313,St Johns CofE Aided Primary School,419,20190,11778,8412
936,Surrey,9363314,St Peter and St Paul CofE Infant School,57,16570,9666,6904
936,Surrey,9363317,Chilworth CofE (Aided) Infant School,56,16560,9660,6900
936,Surrey,9363318,St Lawrence CofE (Aided) Primary School,175,17750,10354,7396
936,Surrey,9363324,St Michaels CofE Aided Infant School,44,16440,9590,6850
936,Surrey,9363327,St Pauls CofE (Aided) Primary School,360,19600,11433,8167
936,Surrey,9363331,St Judes Church of England Junior School (VA),291,18910,11031,7879
936,Surrey,9363333,Thorpe CofE Aided Primary School,155,17550,10238,7312
936,Surrey,9363334,Christ Church CofE Aided Infant School Virginia Water,49,16490,9619,6871
936,Surrey,9363335,St James CofE Aided Primary School,173,17730,10343,7387
936,Surrey,9363340,St Matthews CofE Aided Infant School Cobham,41,16410,9573,6837
936,Surrey,9363341,St Lawrence CofE Aided Junior School East Molesey,303,19030,11101,7929
936,Surrey,9363343,Long Ditton St Marys CofE (Aided) Junior School,241,18410,10739,7671
936,Surrey,9363344,Ewhurst CofE Aided Infant School,47,16470,9608,6862
936,Surrey,9363345,St Peters CofE Primary School,373,19730,11509,8221
936,Surrey,9363346,St Marys CofE Aided Infant School Frensham,59,16590,9678,6912
936,Surrey,9363347,St Johns CofE Aided Infant School,57,16570,9666,6904
936,Surrey,9363350,Busbridge CofE Aided Junior School,240,18400,10733,7667
936,Surrey,9363357,St Nicolas CofE Aided Infant School,71,16710,9748,6962
936,Surrey,9363369,St Giles CofE (Aided) Infant School,68,16680,9730,6950
936,Surrey,9363370,Limpsfield CofE Infant School,121,17210,10039,7171
936,Surrey,9363375,Newdigate CofE Endowed Aided Infant School,54,16540,9648,6892
936,Surrey,9363376,Nutfield Church CofE Primary School,169,17690,10319,7371
936,Surrey,9363380,St Marys CofE Primary School,474,20740,12098,8642
936,Surrey,9363381,Puttenham CofE Infant School,70,16700,9742,6958
936,Surrey,9363387,Reigate Parish Church Primary School,224,18240,10640,7600
936,Surrey,9363405,St Peters CofE Infant School,57,16570,9666,6904
936,Surrey,9363407,All Saints CofE Aided Infant School,60,16600,9683,6917
936,Surrey,9363408,Clandon CofE Aided Primary School,58,16580,9672,6908
936,Surrey,9363415,The Chandler CofE Aided Junior School,358,19580,11422,8158
936,Surrey,9363416,Horsell CofE Aided Junior School,358,19580,11422,8158
936,Surrey,9363417,Wonersh and Shamley Green CofE Aided Primary School,182,17820,10395,7425
936,Surrey,9363421,St Francis Catholic Primary School,344,19440,11340,8100
936,Surrey,9363422,St Josephs Catholic Primary School,161,17610,10273,7337
936,Surrey,9363423,St Josephs Catholic Primary School,365,19650,11463,8187
936,Surrey,9363424,St Polycarps Catholic Primary School Farnham,368,19680,11480,8200
936,Surrey,9363439,St Cuthberts Catholic Primary School Englefield Green,173,17730,10343,7387
936,Surrey,9363443,St Peters Catholic Primary School,276,18760,10943,7817
936,Surrey,9363446,St Pauls Catholic Primary School Thames Ditton,330,19300,11258,8042
936,Surrey,9363459,St Ignatius RC Primary School,349,19490,11369,8121
936,Surrey,9363461,Our Lady of the Rosary RC Primary School,176,17760,10360,7400
936,Surrey,9363462,St Edmunds Catholic Primary School,179,17790,10378,7412
936,Surrey,9363468,Send CofE Primary School,341,19410,11323,8087
936,Surrey,9363469,St Annes Catholic Primary School,361,19610,11439,8171
936,Surrey,9363470,St Clements Catholic Primary School,182,17820,10395,7425
936,Surrey,9363580,Ashford CofE Primary School,359,19590,11428,8162
936,Surrey,9363581,Laleham CofE VA Primary School,359,19590,11428,8162
936,Surrey,9363583,St Nicholas CofE Primary School,495,20950,12221,8729
936,Surrey,9363585,Littleton CofE Infant School,60,16600,9683,6917
936,Surrey,9363915,St Michael Catholic Primary School,359,19590,11428,8162
936,Surrey,9363916,St Josephs Catholic Primary School Redhill,383,19830,11568,8262
936,Surrey,9363920,St Dunstans Catholic Primary School Woking,510,21100,12308,8792
936,Surrey,9363923,Scott Broadwood CofE Infant School,31,16310,9514,6796
936,Surrey,9363924,St Bartholomews CofE Aided Primary School,349,19490,11369,8121
936,Surrey,9363925,Bramley CofE Aided Infant School and Nursery,50,16500,9625,6875
936,Surrey,9363927,Grayswood Church of England (Aided) Primary School,157,17570,10249,7321
936,Surrey,9363928,Shere CofE Aided Infant School,41,16410,9573,6837
936,Surrey,9363931,Lyne and Longcross CofE Aided Primary School,143,17430,10168,7262
936,Surrey,9363932,St Josephs Catholic Primary School,537,21370,12466,8904
936,Surrey,9363937,Manorfield Primary and Nursery School,222,18220,10628,7592
936,Surrey,9363940,Leatherhead Trinity School and Childrens Centre,292,18920,11037,7883
936,Surrey,9363941,Buckland Primary School,349,19490,11369,8121
936,Surrey,9363944,Cranleigh Church of England Primary School,260,18600,10850,7750
936,Surrey,9364623,Royal Alexandra and Albert School,151,17510,10214,7296
936,Surrey,9365202,Hawkedale Primary School,85,16850,9829,7021
936,Surrey,9365206,Holy Trinity Guildford CofE Aided Junior School,381,19810,11556,8254
936,Surrey,9365207,Yattendon School,379,19790,11544,8246
936,Surrey,9365209,St Thomas of Canterbury Catholic Primary School,360,19600,11433,8167
936,Surrey,9365210,Burstow Primary School,358,19580,11422,8158
936,Surrey,9365211,Park Mead Primary,349,19490,11369,8121
936,Surrey,9365214,Tadworth Primary School,356,19560,11410,8150
936,Surrey,9365216,Wallace Fields Junior School,270,18700,10908,7792
936,Surrey,9365217,Burpham Foundation Primary School,337,19370,11299,8071
936,Surrey,9365218,Godstone Village School,178,17780,10372,7408
936,Surrey,9365220,Bushy Hill Junior School,235,18350,10704,7646
936,Surrey,9367003,Gosden House School,57,16570,9666,6904
936,Surrey,9367035,Wey House School,51,16510,9631,6879
936,Surrey,9367048,Woodlands School,32,16320,9520,6800
936,Surrey,9367051,Brooklands School,68,16680,9730,6950
936,Surrey,9367053,Manor Mead School,69,16690,9736,6954
936,Surrey,9367056,Portesbery School,49,16490,9619,6871
936,Surrey,9367062,Freemantles School,78,16780,9788,6992
937,Warwickshire,9372001,Nursery Hill Primary School,119,17190,10028,7162
937,Warwickshire,9372012,Arley Primary School,177,17770,10366,7404
937,Warwickshire,9372017,Claverdon Primary School,158,17580,10255,7325
937,Warwickshire,9372021,Wheelwright Lane Primary School,185,17850,10413,7437
937,Warwickshire,9372024,Great Alne Primary School,84,16840,9823,7017
937,Warwickshire,9372028,Michael Drayton Junior School,502,21020,12262,8758
937,Warwickshire,9372029,Nathaniel Newton Infant School,178,17780,10372,7408
937,Warwickshire,9372032,Hurley Primary School,167,17670,10308,7362
937,Warwickshire,9372043,Quinton Primary School,169,17690,10319,7371
937,Warwickshire,9372046,Snitterfield Primary School,89,16890,9853,7037
937,Warwickshire,9372052,Thomas Jolyffe Primary School,323,19230,11218,8012
937,Warwickshire,9372053,Bridgetown Primary School,356,19560,11410,8150
937,Warwickshire,9372055,Studley Community Infants School,105,17050,9946,7104
937,Warwickshire,9372058,Welford-on-Avon Primary School,191,17910,10448,7462
937,Warwickshire,9372064,Lighthorne Heath Primary School,32,16320,9520,6800
937,Warwickshire,9372083,Outwoods Primary School,333,19330,11276,8054
937,Warwickshire,9372103,Chilvers Coton Community Infant School,135,17350,10121,7229
937,Warwickshire,9372107,Galley Common Infant School,97,16970,9899,7071
937,Warwickshire,9372121,Stockingford Primary School,606,22060,12868,9192
937,Warwickshire,9372123,Whitestone Infant School,180,17800,10383,7417
937,Warwickshire,9372307,Thorns Community Infant School,114,17140,9998,7142
937,Warwickshire,9372308,Clinton Primary School,179,17790,10378,7412
937,Warwickshire,9372309,Park Hill Junior School,251,18510,10798,7712
937,Warwickshire,9372312,Clapham Terrace Community Primary School and Nursery,177,17770,10366,7404
937,Warwickshire,9372315,Telford Junior School,351,19510,11381,8129
937,Warwickshire,9372322,Westgate Primary School,161,17610,10273,7337
937,Warwickshire,9372324,Whitnash Primary School,178,17780,10372,7408
937,Warwickshire,9372325,Newburgh Primary School,379,19790,11544,8246
937,Warwickshire,9372326,Telford Infant School,178,17780,10372,7408
937,Warwickshire,9372327,Briar Hill Infant School,174,17740,10348,7392
937,Warwickshire,9372330,Brookhurst Primary School,353,19530,11393,8137
937,Warwickshire,9372332,Emscote Infant School,122,17220,10045,7175
937,Warwickshire,9372405,Long Lawford Primary School,353,19530,11393,8137
937,Warwickshire,9372410,Abbots Farm Infant School,120,17200,10033,7167
937,Warwickshire,9372415,Eastlands Primary School,210,18100,10558,7542
937,Warwickshire,9372417,Northlands Primary School,204,18040,10523,7517
937,Warwickshire,9372420,Bilton Infant School,117,17170,10016,7154
937,Warwickshire,9372421,Abbots Farm Junior School,265,18650,10879,7771
937,Warwickshire,9372423,Bawnmore Community Infant School,116,17160,10010,7150
937,Warwickshire,9372569,High Meadow Infant School,60,16600,9683,6917
937,Warwickshire,9372571,St Giles Junior School,191,17910,10448,7462
937,Warwickshire,9372581,Chetwynd Junior School,353,19530,11393,8137
937,Warwickshire,9372585,Glendale Infant School,172,17720,10337,7383
937,Warwickshire,9372590,Boughton Leigh Junior School,473,20730,12093,8637
937,Warwickshire,9372598,Boughton Leigh Infant School,158,17580,10255,7325
937,Warwickshire,9372601,Croft Junior School,327,19270,11241,8029
937,Warwickshire,9372603,Bishopton Primary School,183,17830,10401,7429
937,Warwickshire,9372605,Priors Field Primary School,177,17770,10366,7404
937,Warwickshire,9372606,Milverton Primary School,272,18720,10920,7800
937,Warwickshire,9372614,Race Leys Infant School,127,17270,10074,7196
937,Warwickshire,9372616,Brownsover Community Infant School,91,16910,9864,7046
937,Warwickshire,9372618,Water Orton Primary School,275,18750,10938,7812
937,Warwickshire,9372620,St Johns Primary School,241,18410,10739,7671
937,Warwickshire,9372621,Lillington Primary School,241,18410,10739,7671
937,Warwickshire,9372622,Sydenham Primary School,322,19220,11212,8008
937,Warwickshire,9372623,Coten End Primary School,496,20960,12227,8733
937,Warwickshire,9372625,Paddox Primary School,435,20350,11871,8479
937,Warwickshire,9372626,Binley Woods Primary School,174,17740,10348,7392
937,Warwickshire,9372628,Hillmorton Primary School,212,18120,10570,7550
937,Warwickshire,9372629,Wembrook Primary School,537,21370,12466,8904
937,Warwickshire,9372630,Arden Forest Infant School,119,17190,10028,7162
937,Warwickshire,9372631,Milby Primary School,369,19690,11486,8204
937,Warwickshire,9372632,Weddington Primary School,353,19530,11393,8137
937,Warwickshire,9372633,Newdigate Primary and Nursery School,270,18700,10908,7792
937,Warwickshire,9372634,Goodyers End Primary School,325,19250,11229,8021
937,Warwickshire,9372635,Exhall Cedars Infant School,108,17080,9963,7117
937,Warwickshire,9372637,Shrubland Street Community Primary School,167,17670,10308,7362
937,Warwickshire,9372638,Kingsway Community Primary School,157,17570,10249,7321
937,Warwickshire,9372640,Camp Hill Primary School,340,19400,11317,8083
937,Warwickshire,9373002,Alveston CofE Primary School,167,17670,10308,7362
937,Warwickshire,9373011,Bidford-on-Avon CofE Primary School,268,18680,10897,7783
937,Warwickshire,9373014,Brailes CofE Primary School,51,16510,9631,6879
937,Warwickshire,9373024,Ettington CofE Primary School,156,17560,10243,7317
937,Warwickshire,9373031,Hampton Lucy CofE Primary School,75,16750,9771,6979
937,Warwickshire,9373032,Harbury CofE Primary School,164,17640,10290,7350
937,Warwickshire,9373035,Ilmington CofE Primary School,98,16980,9905,7075
937,Warwickshire,9373040,Loxley CofE Community Primary School,31,16310,9514,6796
937,Warwickshire,9373041,Mappleborough Green CofE Primary School,103,17030,9934,7096
937,Warwickshire,9373057,Shottery St Andrews CofE Primary School,83,16830,9818,7012
937,Warwickshire,9373068,Tysoe CofE Primary School,105,17050,9946,7104
937,Warwickshire,9373073,Wellesbourne CofE Primary School,322,19220,11212,8008
937,Warwickshire,9373074,Wootton Wawen CofE Primary School,116,17160,10010,7150
937,Warwickshire,9373101,All Saints CofE Primary School and Nursery Nuneaton,191,17910,10448,7462
937,Warwickshire,9373103,Abbey CofE Infant School,107,17070,9958,7112
937,Warwickshire,9373106,St Pauls CofE Primary School Nuneaton,379,19790,11544,8246
937,Warwickshire,9373141,Bishops Tachbrook CofE Primary School,179,17790,10378,7412
937,Warwickshire,9373144,Cubbington CofE Primary School,177,17770,10366,7404
937,Warwickshire,9373146,St Nicholas CofE Primary School,348,19480,11363,8117
937,Warwickshire,9373147,Lapworth CofE Primary School,147,17470,10191,7279
937,Warwickshire,9373152,Radford Semele CofE Primary School,183,17830,10401,7429
937,Warwickshire,9373154,All Saints CofE Junior School,210,18100,10558,7542
937,Warwickshire,9373157,St. Margarets CofE Junior School,359,19590,11428,8162
937,Warwickshire,9373177,Clifton-upon-Dunsmore CofE Primary School,198,17980,10488,7492
937,Warwickshire,9373192,Wolston St Margarets CofE Primary School,164,17640,10290,7350
937,Warwickshire,9373193,Wolvey CofE Primary School,153,17530,10226,7304
937,Warwickshire,9373204,The Willows CofE Primary School,344,19440,11340,8100
937,Warwickshire,9373205,Bilton CofE Junior School,416,20160,11760,8400
937,Warwickshire,9373207,Shustoke CofE Primary School,155,17550,10238,7312
937,Warwickshire,9373210,The Ferncumbe CofE Primary School,159,17590,10261,7329
937,Warwickshire,9373212,Provost Williams CofE Primary School,161,17610,10273,7337
937,Warwickshire,9373213,St Matthews Bloxam CofE Primary School,180,17800,10383,7417
937,Warwickshire,9373214,Newbold and Tredington CofE Primary School,64,16640,9707,6933
937,Warwickshire,9373215,Bournebrook CofE Primary School,117,17170,10016,7154
937,Warwickshire,9373216,The Dassett CofE Primary School,128,17280,10080,7200
937,Warwickshire,9373301,All Saints Bedworth C/E Primary School & Nursery,139,17390,10144,7246
937,Warwickshire,9373302,The Canons C of E Primary School,528,21280,12413,8867
937,Warwickshire,9373308,Kineton CofE (VA) Primary School,157,17570,10249,7321
937,Warwickshire,9373313,Wilmcote CofE (Voluntary Aided) Primary School,54,16540,9648,6892
937,Warwickshire,9373371,St Pauls CofE Primary School Leamington Spa,258,18580,10838,7742
937,Warwickshire,9373391,Dunchurch Boughton CofE (Voluntary Aided) Junior School,268,18680,10897,7783
937,Warwickshire,9373503,St Edwards Catholic Primary School,178,17780,10372,7408
937,Warwickshire,9373505,St Marys Catholic Primary School Southam,71,16710,9748,6962
937,Warwickshire,9373507,St Marys Catholic Primary School,196,17960,10477,7483
937,Warwickshire,9373541,St Augustines Catholic Primary School,174,17740,10348,7392
937,Warwickshire,9373542,St Peters Catholic Primary School,90,16900,9858,7042
937,Warwickshire,9373543,St Patricks Catholic Primary School,160,17600,10267,7333
937,Warwickshire,9373544,St Anthonys Catholic Primary School,180,17800,10383,7417
937,Warwickshire,9373545,St Mary Immaculate Catholic Primary School,85,16850,9829,7021
937,Warwickshire,9373546,Our Lady and St Teresas Catholic Primary School,157,17570,10249,7321
937,Warwickshire,9373547,St Josephs Catholic Primary School,176,17760,10360,7400
937,Warwickshire,9373561,Our Ladys Catholic Primary School Princethorpe,103,17030,9934,7096
937,Warwickshire,9373564,English Martyrs Catholic Primary School,191,17910,10448,7462
937,Warwickshire,9373587,Barford St Peters CofE Primary School,132,17320,10103,7217
937,Warwickshire,9373589,St Lawrence CofE (Voluntary Aided) Primary School,171,17710,10331,7379
937,Warwickshire,9373590,Knightlow CofE Primary School,185,17850,10413,7437
937,Warwickshire,9373591,St Andrews Benn CofE (Voluntary Aided) Primary School,265,18650,10879,7771
937,Warwickshire,9373593,The Revel CofE (Aided) Primary School,268,18680,10897,7783
937,Warwickshire,9373596,Kingsbury Primary School,258,18580,10838,7742
937,Warwickshire,9373598,St Maries Catholic Primary School and Nursery,358,19580,11422,8158
937,Warwickshire,9375201,Wolverton Primary School,79,16790,9794,6996
937,Warwickshire,9375202,Middlemarch School,211,18110,10564,7546
937,Warwickshire,9375203,Dunnington CofE Primary School,85,16850,9829,7021
937,Warwickshire,9375204,Dunchurch Infant School,120,17200,10033,7167
937,Warwickshire,9375205,Moreton Morrell CofE Primary School,83,16830,9818,7012
937,Warwickshire,9377000,Exhall Grange School and Science College,38,16380,9555,6825
937,Warwickshire,9377028,Ridgeway School,100,17000,9917,7083
938,West Sussex,9381110,West Sussex Alternative Provision College,18,16180,9438,6742
938,West Sussex,9382000,Aldingbourne Primary School,183,17830,10401,7429
938,West Sussex,9382009,Bosham Primary School,177,17770,10366,7404
938,West Sussex,9382010,Shelley Primary School,271,18710,10914,7796
938,West Sussex,9382011,Camelsdale Primary School,189,17890,10436,7454
938,West Sussex,9382012,Lancastrian Infants School,58,16580,9672,6908
938,West Sussex,9382015,Colgate Primary School,113,17130,9993,7137
938,West Sussex,9382018,West Green Primary School,177,17770,10366,7404
938,West Sussex,9382025,East Wittering Community Primary School,230,18300,10675,7625
938,West Sussex,9382028,Funtington Primary School,74,16740,9765,6975
938,West Sussex,9382029,Graffham CofE Infant School,32,16320,9520,6800
938,West Sussex,9382030,Hollycombe Primary School,86,16860,9835,7025
938,West Sussex,9382035,Trafalgar Community Infant School,169,17690,10319,7371
938,West Sussex,9382036,Northolmes Junior School Horsham,154,17540,10232,7308
938,West Sussex,9382037,Littlehaven Infant School,81,16810,9806,7004
938,West Sussex,9382038,Barns Green Primary School,110,17100,9975,7125
938,West Sussex,9382042,North Lancing Primary School,353,19530,11393,8137
938,West Sussex,9382046,Loxwood Primary School,144,17440,10173,7267
938,West Sussex,9382048,Northchapel Community Primary School,71,16710,9748,6962
938,West Sussex,9382049,North Mundham Primary School,184,17840,10407,7433
938,West Sussex,9382050,Plaistow and Kirdford Primary School,152,17520,10220,7300
938,West Sussex,9382051,Rudgwick Primary School,178,17780,10372,7408
938,West Sussex,9382052,Rusper Primary School,86,16860,9835,7025
938,West Sussex,9382058,Sidlesham Primary School,117,17170,10016,7154
938,West Sussex,9382066,Stedham Primary School,62,16620,9695,6925
938,West Sussex,9382069,Thakeham Primary School,86,16860,9835,7025
938,West Sussex,9382070,Upper Beeding Primary School,289,18890,11019,7871
938,West Sussex,9382071,Westbourne Primary School,181,17810,10389,7421
938,West Sussex,9382072,West Chiltington Community Primary School,177,17770,10366,7404
938,West Sussex,9382073,Wisborough Green Primary School,167,17670,10308,7362
938,West Sussex,9382075,Whytemead Primary School,263,18630,10868,7762
938,West Sussex,9382076,Durrington Infant School,146,17460,10185,7275
938,West Sussex,9382077,Elm Grove Primary School Worthing,238,18380,10722,7658
938,West Sussex,9382080,Field Place Infant School,199,17990,10494,7496
938,West Sussex,9382082,Vale School Worthing,561,21610,12606,9004
938,West Sussex,9382093,Thorney Island Community Primary School,186,17860,10418,7442
938,West Sussex,9382101,Bersted Green Primary School Bognor Regis,243,18430,10751,7679
938,West Sussex,9382102,Storrington Primary School,348,19480,11363,8117
938,West Sussex,9382105,Southbourne Infant School,118,17180,10022,7158
938,West Sussex,9382110,Southbourne Junior School,230,18300,10675,7625
938,West Sussex,9382112,Jessie Younghusband Primary School,183,17830,10401,7429
938,West Sussex,9382124,Arunside School Horsham,268,18680,10897,7783
938,West Sussex,9382131,Shoreham Beach Primary School,179,17790,10378,7412
938,West Sussex,9382133,Heron Way Primary School,337,19370,11299,8071
938,West Sussex,9382153,Three Bridges Primary School,491,20910,12198,8712
938,West Sussex,9382161,Pound Hill Junior School Crawley,387,19870,11591,8279
938,West Sussex,9382172,Glebe Primary School,412,20120,11737,8383
938,West Sussex,9382173,Swiss Gardens Primary School,373,19730,11509,8221
938,West Sussex,9382176,Milton Mount Primary School,538,21380,12472,8908
938,West Sussex,9382182,Leechpool Primary School,358,19580,11422,8158
938,West Sussex,9382183,East Preston Infant School,167,17670,10308,7362
938,West Sussex,9382185,Parklands Community Primary School,348,19480,11363,8117
938,West Sussex,9382186,Bartons Primary School Bognor Regis,208,18080,10547,7533
938,West Sussex,9382198,Lyminster Primary School,185,17850,10413,7437
938,West Sussex,9382199,Rose Green Infant School,176,17760,10360,7400
938,West Sussex,9382200,Ashurst Wood Primary School,109,17090,9969,7121
938,West Sussex,9382201,Manor Field Primary School,427,20270,11824,8446
938,West Sussex,9382202,London Meed Community Primary School,337,19370,11299,8071
938,West Sussex,9382205,Handcross Primary School,207,18070,10541,7529
938,West Sussex,9382206,Hassocks Infant School,197,17970,10483,7487
938,West Sussex,9382209,Warninglid Primary School,43,16430,9584,6846
938,West Sussex,9382213,The Windmills Junior School,349,19490,11369,8121
938,West Sussex,9382214,The Gattons Infant School,172,17720,10337,7383
938,West Sussex,9382215,Southway Junior School,354,19540,11398,8142
938,West Sussex,9382218,Fairway Infant School Copthorne,111,17110,9981,7129
938,West Sussex,9382219,Birchwood Grove Community Primary School Burgess Hill,325,19250,11229,8021
938,West Sussex,9382220,Estcots Primary School,358,19580,11422,8158
938,West Sussex,9382225,North Heath Community Primary School,350,19500,11375,8125
938,West Sussex,9382227,Hawthorns Primary School Durrington,166,17660,10302,7358
938,West Sussex,9382229,Durrington Junior School,309,19090,11136,7954
938,West Sussex,9382231,Thomas A Becket Infant School,359,19590,11428,8162
938,West Sussex,9382232,Thomas A Becket Junior School,695,22950,13388,9562
938,West Sussex,9382235,Sheddingdean Community Primary School,130,17300,10092,7208
938,West Sussex,9382237,Georgian Gardens Community Primary School,352,19520,11387,8133
938,West Sussex,9382238,Lyndhurst Infant School,218,18180,10605,7575
938,West Sussex,9382239,Chesswood Junior School,577,21770,12699,9071
938,West Sussex,9382240,Maidenbower Infant School,176,17760,10360,7400
938,West Sussex,9382241,Blackwell Primary School,303,19030,11101,7929
938,West Sussex,9382242,The Meads Primary School,274,18740,10932,7808
938,West Sussex,9382243,Holbrook Primary School,359,19590,11428,8162
938,West Sussex,9382245,Springfield Infant School,112,17120,9987,7133
938,West Sussex,9382246,Bramber Primary School,239,18390,10728,7662
938,West Sussex,9382249,Castlewood Primary School,163,17630,10284,7346
938,West Sussex,9382252,Summerlea Community Primary School,418,20180,11772,8408
938,West Sussex,9382254,The Brook School,118,17180,10022,7158
938,West Sussex,9382255,Maidenbower Junior School,593,21930,12793,9137
938,West Sussex,9382259,All Saints CofE Primary School Horsham,181,17810,10389,7421
938,West Sussex,9383000,Amberley CofE Primary School,58,16580,9672,6908
938,West Sussex,9383001,Ashington CofE Primary School,173,17730,10343,7387
938,West Sussex,9383002,Birdham CE Primary School,124,17240,10057,7183
938,West Sussex,9383003,South Bersted CofE Primary School,176,17760,10360,7400
938,West Sussex,9383004,Boxgrove CofE Primary School,63,16630,9701,6929
938,West Sussex,9383005,Rumboldswhyke CofE Infants School,60,16600,9683,6917
938,West Sussex,9383006,Chidham Parochial Primary School,163,17630,10284,7346
938,West Sussex,9383007,Clapham and Patching CofE Primary School,45,16450,9596,6854
938,West Sussex,9383009,St James CofE Primary School Coldwaltham,47,16470,9608,6862
938,West Sussex,9383010,Compton and Up Marden CofE Primary School,71,16710,9748,6962
938,West Sussex,9383013,Duncton CofE Junior School,65,16650,9713,6937
938,West Sussex,9383014,Eastergate CofE Primary School,117,17170,10016,7154
938,West Sussex,9383016,Ferring CofE Primary School,163,17630,10284,7346
938,West Sussex,9383017,Fishbourne CofE Primary School,182,17820,10395,7425
938,West Sussex,9383018,Fittleworth CofE Village School,104,17040,9940,7100
938,West Sussex,9383020,Jolesfield CofE Primary School,143,17430,10168,7262
938,West Sussex,9383021,Lavant CofE Primary School,92,16920,9870,7050
938,West Sussex,9383022,Holy Trinity CofE Primary School Lower Beeding,74,16740,9765,6975
938,West Sussex,9383023,Midhurst CofE Primary School,210,18100,10558,7542
938,West Sussex,9383024,Rake CofE Primary School,94,16940,9882,7058
938,West Sussex,9383026,Petworth Cof E Primary School,176,17760,10360,7400
938,West Sussex,9383027,Rogate CofE Primary School,57,16570,9666,6904
938,West Sussex,9383028,Shipley CofE Primary School,59,16590,9678,6912
938,West Sussex,9383029,Singleton CofE Primary School,54,16540,9648,6892
938,West Sussex,9383030,Slindon CofE Primary School,61,16610,9689,6921
938,West Sussex,9383031,Slinfold CofE Primary School,126,17260,10068,7192
938,West Sussex,9383033,Steyning CofE Primary School,362,19620,11445,8175
938,West Sussex,9383036,Walberton and Binsted CofE Primary School,176,17760,10360,7400
938,West Sussex,9383037,Warnham CofE Primary School,171,17710,10331,7379
938,West Sussex,9383038,St Marys CofE Primary School,83,16830,9818,7012
938,West Sussex,9383039,West Wittering Parochial Church of England School,92,16920,9870,7050
938,West Sussex,9383040,Yapton CE Primary School,237,18370,10716,7654
938,West Sussex,9383042,William Penn School,76,16760,9777,6983
938,West Sussex,9383043,Easebourne CofE Primary School,177,17770,10366,7404
938,West Sussex,9383045,West Dean CofE Primary School,81,16810,9806,7004
938,West Sussex,9383050,St Peters CofE Primary School,89,16890,9853,7037
938,West Sussex,9383051,Balcombe CofE Controlled Primary School,115,17150,10004,7146
938,West Sussex,9383052,Bolney CofE Primary School,86,16860,9835,7025
938,West Sussex,9383055,St Augustines CofE Primary School,88,16880,9847,7033
938,West Sussex,9383056,Turners Hill CofE Primary School,117,17170,10016,7154
938,West Sussex,9383057,Twineham CofE Primary School,80,16800,9800,7000
938,West Sussex,9383058,West Hoathly CofE Primary School,113,17130,9993,7137
938,West Sussex,9383059,Copthorne CofE Junior School,237,18370,10716,7654
938,West Sussex,9383060,Albourne CofE Primary School,166,17660,10302,7358
938,West Sussex,9383061,St Marks CofE Primary School,80,16800,9800,7000
938,West Sussex,9383062,West Park CofE Primary (Controlled) School,617,22170,12933,9237
938,West Sussex,9383063,Harting CofE Primary School,90,16900,9858,7042
938,West Sussex,9383300,St Margarets CofE Primary School,421,20210,11789,8421
938,West Sussex,9383301,Arundel CofE Primary School,177,17770,10366,7404
938,West Sussex,9383302,Ashurst CofE Primary School,59,16590,9678,6912
938,West Sussex,9383303,Nyewood CofE Junior School,332,19320,11270,8050
938,West Sussex,9383304,Bury CofE Primary School,42,16420,9578,6842
938,West Sussex,9383308,St Marys CofE Primary School,88,16880,9847,7033
938,West Sussex,9383309,St Peters CofE (Aided) Primary School,104,17040,9940,7100
938,West Sussex,9383313,St John the Baptist CofE Primary School,120,17200,10033,7167
938,West Sussex,9383314,St Peters CofE Primary School,322,19220,11212,8008
938,West Sussex,9383315,St Marys CofE (Aided) Primary School,178,17780,10372,7408
938,West Sussex,9383317,St Andrews CofE Primary School,114,17140,9998,7142
938,West Sussex,9383324,Broadwater CofE Primary School,370,19700,11492,8208
938,West Sussex,9383326,Heene CofE Primary School,344,19440,11340,8100
938,West Sussex,9383327,St Wilfrids Catholic Primary School,133,17330,10109,7221
938,West Sussex,9383328,St Philips Catholic Primary School Arundel,161,17610,10273,7337
938,West Sussex,9383329,St Marys Catholic Primary School,253,18530,10809,7721
938,West Sussex,9383330,St Richards Catholic Primary School,260,18600,10850,7750
938,West Sussex,9383331,St Johns Catholic Primary School,167,17670,10308,7362
938,West Sussex,9383332,St Catherines Catholic Primary School Littlehampton,210,18100,10558,7542
938,West Sussex,9383333,St Peters Catholic Primary School Shoreham-by-Sea,178,17780,10372,7408
938,West Sussex,9383335,St Margarets CofE Primary School,360,19600,11433,8167
938,West Sussex,9383338,Our Lady Queen of Heaven Catholic Primary School Crawley,287,18870,11008,7862
938,West Sussex,9383339,Goring-By-Sea CofE (Aided) Primary School,361,19610,11439,8171
938,West Sussex,9383340,St Francis of Assisi Catholic Primary School Crawley,356,19560,11410,8150
938,West Sussex,9383341,St Andrews CofE Primary School,178,17780,10372,7408
938,West Sussex,9383342,St Marys Church of England Primary School,309,19090,11136,7954
938,West Sussex,9383343,St Nicolas & St Mary CofE(Aided) Primary School,324,19240,11223,8017
938,West Sussex,9383344,Bishop Tufnell CofE Primary School Felpham,535,37350,21788,15562
938,West Sussex,9383345,English Martyrs Catholic Primary School Worthing,177,17770,10366,7404
938,West Sussex,9383348,Nyewood CofE Infant School Bognor Regis,170,17700,10325,7375
938,West Sussex,9383349,St Robert Southwell Catholic Primary School Horsham,149,17490,10203,7287
938,West Sussex,9383350,Holy Trinity CofE Primary School Cuckfield,309,19090,11136,7954
938,West Sussex,9383351,St Marys CofE Primary School East Grinstead,180,17800,10383,7417
938,West Sussex,9383352,St Wilfrids CofE Primary School Haywards Heath,354,19540,11398,8142
938,West Sussex,9383353,St Giles CofE Primary School,89,16890,9853,7037
938,West Sussex,9383355,St Josephs Catholic Primary School Haywards Heath,359,19590,11428,8162
938,West Sussex,9383356,St Peters Catholic Primary School,176,17760,10360,7400
938,West Sussex,9383357,St Wilfrids Catholic Primary School Burgess Hill,361,19610,11439,8171
938,West Sussex,9383358,Langley Green Primary,354,19540,11398,8142
938,West Sussex,9383364,Northgate Primary School,441,20410,11906,8504
938,West Sussex,9383365,Kingslea Primary School,367,19670,11474,8196
938,West Sussex,9383366,Crawley Down Village CofE,301,19010,11089,7921
938,West Sussex,9383368,Sompting Village Primary School,385,19850,11579,8271
938,West Sussex,9383370,Buckingham Park Primary School,441,20410,11906,8504
938,West Sussex,9383372,Bolnore Village Primary School,332,19320,11270,8050
938,West Sussex,9383376,Billingshurst Primary School,537,21370,12466,8904
938,West Sussex,9387004,St Anthonys School,80,16800,9800,7000
938,West Sussex,9387008,Palatine Primary School,114,17140,9998,7142
938,West Sussex,9387009,Queen Elizabeth II Silver Jubilee School Horsham,29,16290,9503,6787
938,West Sussex,9387011,Manor Green Primary School,164,17640,10290,7350
938,West Sussex,9387012,Fordwater School Chichester,44,16440,9590,6850
938,West Sussex,9387013,Woodlands Meed,84,16840,9823,7017
938,West Sussex,9387021,Herons Dale School,84,16840,9823,7017
938,West Sussex,9387022,Cornfield School Littlehampton,7,7000,4083,2917
